År,Måned,Dag,Fra_time,Volum til SNTR,Volum til DNP,Volum totalt
2020,1,1,0,58,59,117
2020,1,1,1,44,48,92
2020,1,1,2,36,42,78
2020,1,1,3,34,21,55
2020,1,1,4,28,19,47
2020,1,1,5,27,24,51
2020,1,1,6,17,17,34
2020,1,1,7,8,18,26
2020,1,1,8,20,10,30
2020,1,1,9,25,23,48
2020,1,1,10,34,23,57
2020,1,1,11,57,41,98
2020,1,1,12,74,63,137
2020,1,1,13,97,102,199
2020,1,1,14,122,106,228
2020,1,1,15,97,120,217
2020,1,1,16,112,111,223
2020,1,1,17,100,102,202
2020,1,1,18,80,71,151
2020,1,1,19,80,77,157
2020,1,1,20,61,63,124
2020,1,1,21,35,54,89
2020,1,1,22,31,48,79
2020,1,1,23,9,18,27
2020,1,2,0,8,16,24
2020,1,2,1,9,8,17
2020,1,2,2,8,6,14
2020,1,2,3,9,5,14
2020,1,2,4,13,7,20
2020,1,2,5,86,35,121
2020,1,2,6,184,84,268
2020,1,2,7,269,135,404
2020,1,2,8,181,116,297
2020,1,2,9,160,113,273
2020,1,2,10,134,111,245
2020,1,2,11,176,145,321
2020,1,2,12,174,187,361
2020,1,2,13,175,208,383
2020,1,2,14,191,275,466
2020,1,2,15,153,210,363
2020,1,2,16,92,137,229
2020,1,2,17,89,116,205
2020,1,2,18,101,93,194
2020,1,2,19,61,76,137
2020,1,2,20,55,71,126
2020,1,2,21,52,56,108
2020,1,2,22,31,33,64
2020,1,2,23,16,15,31
2020,1,3,0,5,11,16
2020,1,3,1,10,8,18
2020,1,3,2,10,5,15
2020,1,3,3,9,2,11
2020,1,3,4,18,2,20
2020,1,3,5,96,38,134
2020,1,3,6,285,121,406
2020,1,3,7,521,177,698
2020,1,3,8,230,135,365
2020,1,3,9,176,139,315
2020,1,3,10,179,147,326
2020,1,3,11,172,168,340
2020,1,3,12,193,159,352
2020,1,3,13,209,211,420
2020,1,3,14,216,292,508
2020,1,3,15,153,247,400
2020,1,3,16,121,130,251
2020,1,3,17,120,118,238
2020,1,3,18,107,90,197
2020,1,3,19,92,94,186
2020,1,3,20,62,59,121
2020,1,3,21,46,55,101
2020,1,3,22,33,43,76
2020,1,3,23,27,32,59
2020,1,4,0,19,18,37
2020,1,4,1,20,23,43
2020,1,4,2,7,30,37
2020,1,4,3,9,14,23
2020,1,4,4,9,7,16
2020,1,4,5,23,12,35
2020,1,4,6,28,17,45
2020,1,4,7,26,19,45
2020,1,4,8,42,31,73
2020,1,4,9,75,61,136
2020,1,4,10,95,71,166
2020,1,4,11,112,101,213
2020,1,4,12,130,120,250
2020,1,4,13,143,157,300
2020,1,4,14,151,153,304
2020,1,4,15,130,127,257
2020,1,4,16,113,113,226
2020,1,4,17,114,132,246
2020,1,4,18,79,90,169
2020,1,4,19,80,76,156
2020,1,4,20,50,68,118
2020,1,4,21,45,66,111
2020,1,4,22,36,48,84
2020,1,4,23,35,46,81
2020,1,5,0,18,27,45
2020,1,5,1,21,23,44
2020,1,5,2,17,23,40
2020,1,5,3,19,26,45
2020,1,5,4,11,8,19
2020,1,5,5,18,11,29
2020,1,5,6,10,14,24
2020,1,5,7,26,17,43
2020,1,5,8,48,20,68
2020,1,5,9,83,39,122
2020,1,5,10,86,58,144
2020,1,5,11,129,114,243
2020,1,5,12,125,125,250
2020,1,5,13,153,163,316
2020,1,5,14,143,185,328
2020,1,5,15,139,169,308
2020,1,5,16,120,155,275
2020,1,5,17,125,101,226
2020,1,5,18,115,127,242
2020,1,5,19,106,110,216
2020,1,5,20,72,80,152
2020,1,5,21,40,43,83
2020,1,5,22,22,29,51
2020,1,5,23,17,18,35
2020,1,6,0,12,7,19
2020,1,6,1,11,5,16
2020,1,6,2,4,10,14
2020,1,6,3,8,2,10
2020,1,6,4,22,8,30
2020,1,6,5,122,44,166
2020,1,6,6,221,142,363
2020,1,6,7,390,197,587
2020,1,6,8,230,147,377
2020,1,6,9,182,115,297
2020,1,6,10,188,135,323
2020,1,6,11,178,144,322
2020,1,6,12,193,191,384
2020,1,6,13,192,257,449
2020,1,6,14,247,307,554
2020,1,6,15,206,279,485
2020,1,6,16,150,142,292
2020,1,6,17,126,117,243
2020,1,6,18,86,113,199
2020,1,6,19,83,87,170
2020,1,6,20,84,96,180
2020,1,6,21,50,58,108
2020,1,6,22,21,29,50
2020,1,6,23,13,13,26
2020,1,7,0,9,16,25
2020,1,7,1,8,7,15
2020,1,7,2,8,16,24
2020,1,7,3,11,7,18
2020,1,7,4,22,5,27
2020,1,7,5,109,49,158
2020,1,7,6,226,112,338
2020,1,7,7,357,186,543
2020,1,7,8,240,124,364
2020,1,7,9,189,168,357
2020,1,7,10,196,161,357
2020,1,7,11,225,175,400
2020,1,7,12,206,211,417
2020,1,7,13,217,205,422
2020,1,7,14,267,324,591
2020,1,7,15,203,279,482
2020,1,7,16,179,160,339
2020,1,7,17,151,134,285
2020,1,7,18,114,122,236
2020,1,7,19,95,96,191
2020,1,7,20,76,106,182
2020,1,7,21,51,75,126
2020,1,7,22,42,49,91
2020,1,7,23,6,18,24
2020,1,8,0,8,7,15
2020,1,8,1,3,4,7
2020,1,8,2,5,10,15
2020,1,8,3,7,5,12
2020,1,8,4,19,4,23
2020,1,8,5,99,39,138
2020,1,8,6,228,122,350
2020,1,8,7,361,181,542
2020,1,8,8,246,158,404
2020,1,8,9,216,160,376
2020,1,8,10,231,161,392
2020,1,8,11,174,167,341
2020,1,8,12,177,224,401
2020,1,8,13,216,224,440
2020,1,8,14,232,375,607
2020,1,8,15,183,274,457
2020,1,8,16,154,169,323
2020,1,8,17,143,124,267
2020,1,8,18,111,119,230
2020,1,8,19,96,90,186
2020,1,8,20,80,87,167
2020,1,8,21,51,68,119
2020,1,8,22,30,26,56
2020,1,8,23,22,18,40
2020,1,9,0,10,9,19
2020,1,9,1,15,4,19
2020,1,9,2,18,7,25
2020,1,9,3,10,4,14
2020,1,9,4,20,2,22
2020,1,9,5,96,42,138
2020,1,9,6,222,113,335
2020,1,9,7,380,209,589
2020,1,9,8,244,145,389
2020,1,9,9,197,145,342
2020,1,9,10,227,163,390
2020,1,9,11,204,181,385
2020,1,9,12,210,178,388
2020,1,9,13,189,209,398
2020,1,9,14,244,322,566
2020,1,9,15,214,272,486
2020,1,9,16,135,165,300
2020,1,9,17,136,142,278
2020,1,9,18,123,104,227
2020,1,9,19,87,96,183
2020,1,9,20,63,106,169
2020,1,9,21,73,63,136
2020,1,9,22,32,28,60
2020,1,9,23,24,20,44
2020,1,10,0,12,17,29
2020,1,10,1,11,13,24
2020,1,10,2,15,19,34
2020,1,10,3,12,4,16
2020,1,10,4,17,5,22
2020,1,10,5,93,37,130
2020,1,10,6,230,121,351
2020,1,10,7,370,173,543
2020,1,10,8,243,137,380
2020,1,10,9,175,133,308
2020,1,10,10,210,178,388
2020,1,10,11,212,186,398
2020,1,10,12,236,226,462
2020,1,10,13,234,249,483
2020,1,10,14,238,311,549
2020,1,10,15,178,256,434
2020,1,10,16,134,150,284
2020,1,10,17,130,115,245
2020,1,10,18,107,107,214
2020,1,10,19,91,80,171
2020,1,10,20,70,71,141
2020,1,10,21,52,53,105
2020,1,10,22,46,68,114
2020,1,10,23,25,36,61
2020,1,11,0,20,18,38
2020,1,11,1,29,22,51
2020,1,11,2,15,25,40
2020,1,11,3,9,14,23
2020,1,11,4,14,7,21
2020,1,11,5,26,13,39
2020,1,11,6,38,20,58
2020,1,11,7,40,24,64
2020,1,11,8,58,42,100
2020,1,11,9,88,58,146
2020,1,11,10,144,92,236
2020,1,11,11,159,103,262
2020,1,11,12,151,168,319
2020,1,11,13,188,135,323
2020,1,11,14,170,168,338
2020,1,11,15,159,163,322
2020,1,11,16,115,143,258
2020,1,11,17,132,124,256
2020,1,11,18,123,126,249
2020,1,11,19,72,70,142
2020,1,11,20,53,54,107
2020,1,11,21,47,76,123
2020,1,11,22,41,42,83
2020,1,11,23,23,41,64
2020,1,12,0,35,30,65
2020,1,12,1,23,42,65
2020,1,12,2,26,37,63
2020,1,12,3,13,25,38
2020,1,12,4,7,17,24
2020,1,12,5,19,12,31
2020,1,12,6,19,16,35
2020,1,12,7,31,16,47
2020,1,12,8,43,28,71
2020,1,12,9,88,41,129
2020,1,12,10,96,64,160
2020,1,12,11,117,124,241
2020,1,12,12,147,128,275
2020,1,12,13,178,163,341
2020,1,12,14,161,192,353
2020,1,12,15,141,191,332
2020,1,12,16,146,145,291
2020,1,12,17,116,130,246
2020,1,12,18,107,117,224
2020,1,12,19,92,114,206
2020,1,12,20,60,91,151
2020,1,12,21,52,59,111
2020,1,12,22,25,29,54
2020,1,12,23,13,17,30
2020,1,13,0,12,15,27
2020,1,13,1,8,12,20
2020,1,13,2,11,10,21
2020,1,13,3,9,9,18
2020,1,13,4,24,8,32
2020,1,13,5,113,53,166
2020,1,13,6,223,133,356
2020,1,13,7,352,214,566
2020,1,13,8,256,142,398
2020,1,13,9,184,149,333
2020,1,13,10,244,156,400
2020,1,13,11,217,169,386
2020,1,13,12,198,212,410
2020,1,13,13,193,222,415
2020,1,13,14,244,332,576
2020,1,13,15,205,294,499
2020,1,13,16,168,160,328
2020,1,13,17,157,157,314
2020,1,13,18,114,108,222
2020,1,13,19,91,94,185
2020,1,13,20,81,123,204
2020,1,13,21,64,55,119
2020,1,13,22,29,29,58
2020,1,13,23,17,19,36
2020,1,14,0,9,9,18
2020,1,14,1,4,12,16
2020,1,14,2,12,13,25
2020,1,14,3,7,4,11
2020,1,14,4,21,8,29
2020,1,14,5,111,50,161
2020,1,14,6,243,125,368
2020,1,14,7,379,202,581
2020,1,14,8,269,156,425
2020,1,14,9,226,169,395
2020,1,14,10,211,183,394
2020,1,14,11,192,176,368
2020,1,14,12,244,207,451
2020,1,14,13,235,235,470
2020,1,14,14,247,309,556
2020,1,14,15,205,285,490
2020,1,14,16,184,172,356
2020,1,14,17,174,152,326
2020,1,14,18,130,135,265
2020,1,14,19,83,122,205
2020,1,14,20,76,121,197
2020,1,14,21,48,310,358
2020,1,14,22,29,190,219
2020,1,14,23,17,45,62
2020,1,15,0,8,28,36
2020,1,15,1,7,26,33
2020,1,15,2,8,14,22
2020,1,15,3,5,21,26
2020,1,15,4,24,12,36
2020,1,15,5,97,45,142
2020,1,15,6,210,124,334
2020,1,15,7,390,216,606
2020,1,15,8,231,141,372
2020,1,15,9,230,164,394
2020,1,15,10,202,162,364
2020,1,15,11,205,175,380
2020,1,15,12,218,216,434
2020,1,15,13,212,223,435
2020,1,15,14,229,297,526
2020,1,15,15,211,284,495
2020,1,15,16,186,193,379
2020,1,15,17,176,140,316
2020,1,15,18,110,136,246
2020,1,15,19,110,105,215
2020,1,15,20,79,76,155
2020,1,15,21,61,131,192
2020,1,15,22,25,80,105
2020,1,15,23,18,24,42
2020,1,16,0,10,8,18
2020,1,16,1,2,8,10
2020,1,16,2,12,7,19
2020,1,16,3,10,4,14
2020,1,16,4,18,6,24
2020,1,16,5,122,36,158
2020,1,16,6,226,132,358
2020,1,16,7,348,194,542
2020,1,16,8,295,132,427
2020,1,16,9,207,153,360
2020,1,16,10,200,182,382
2020,1,16,11,229,179,408
2020,1,16,12,184,165,349
2020,1,16,13,202,227,429
2020,1,16,14,236,324,560
2020,1,16,15,221,280,501
2020,1,16,16,164,195,359
2020,1,16,17,174,159,333
2020,1,16,18,126,133,259
2020,1,16,19,97,92,189
2020,1,16,20,63,103,166
2020,1,16,21,70,86,156
2020,1,16,22,38,31,69
2020,1,16,23,17,20,37
2020,1,17,0,20,15,35
2020,1,17,1,10,41,51
2020,1,17,2,10,47,57
2020,1,17,3,8,12,20
2020,1,17,4,20,13,33
2020,1,17,5,120,45,165
2020,1,17,6,200,132,332
2020,1,17,7,383,179,562
2020,1,17,8,254,151,405
2020,1,17,9,180,136,316
2020,1,17,10,197,151,348
2020,1,17,11,220,164,384
2020,1,17,12,215,199,414
2020,1,17,13,233,245,478
2020,1,17,14,272,330,602
2020,1,17,15,209,270,479
2020,1,17,16,142,160,302
2020,1,17,17,147,106,253
2020,1,17,18,102,95,197
2020,1,17,19,88,101,189
2020,1,17,20,60,68,128
2020,1,17,21,58,66,124
2020,1,17,22,39,69,108
2020,1,17,23,39,46,85
2020,1,18,0,26,21,47
2020,1,18,1,9,22,31
2020,1,18,2,9,32,41
2020,1,18,3,11,22,33
2020,1,18,4,8,12,20
2020,1,18,5,15,9,24
2020,1,18,6,18,10,28
2020,1,18,7,33,20,53
2020,1,18,8,55,38,93
2020,1,18,9,116,66,182
2020,1,18,10,130,92,222
2020,1,18,11,154,108,262
2020,1,18,12,151,127,278
2020,1,18,13,166,137,303
2020,1,18,14,155,170,325
2020,1,18,15,149,154,303
2020,1,18,16,138,137,275
2020,1,18,17,144,156,300
2020,1,18,18,98,118,216
2020,1,18,19,77,94,171
2020,1,18,20,67,76,143
2020,1,18,21,40,65,105
2020,1,18,22,53,55,108
2020,1,18,23,38,43,81
2020,1,19,0,37,39,76
2020,1,19,1,30,44,74
2020,1,19,2,29,33,62
2020,1,19,3,16,27,43
2020,1,19,4,12,9,21
2020,1,19,5,9,13,22
2020,1,19,6,15,17,32
2020,1,19,7,25,11,36
2020,1,19,8,49,27,76
2020,1,19,9,100,58,158
2020,1,19,10,100,78,178
2020,1,19,11,164,144,308
2020,1,19,12,159,136,295
2020,1,19,13,163,200,363
2020,1,19,14,161,202,363
2020,1,19,15,132,192,324
2020,1,19,16,148,151,299
2020,1,19,17,115,99,214
2020,1,19,18,112,110,222
2020,1,19,19,107,98,205
2020,1,19,20,83,95,178
2020,1,19,21,47,76,123
2020,1,19,22,23,29,52
2020,1,19,23,17,19,36
2020,1,20,0,10,15,25
2020,1,20,1,8,8,16
2020,1,20,2,5,9,14
2020,1,20,3,7,10,17
2020,1,20,4,30,7,37
2020,1,20,5,129,50,179
2020,1,20,6,233,146,379
2020,1,20,7,383,201,584
2020,1,20,8,324,153,477
2020,1,20,9,244,142,386
2020,1,20,10,208,165,373
2020,1,20,11,227,176,403
2020,1,20,12,194,188,382
2020,1,20,13,208,259,467
2020,1,20,14,263,332,595
2020,1,20,15,252,301,553
2020,1,20,16,187,197,384
2020,1,20,17,182,153,335
2020,1,20,18,128,118,246
2020,1,20,19,112,114,226
2020,1,20,20,91,113,204
2020,1,20,21,70,66,136
2020,1,20,22,34,41,75
2020,1,20,23,15,10,25
2020,1,21,0,15,6,21
2020,1,21,1,10,7,17
2020,1,21,2,16,9,25
2020,1,21,3,18,4,22
2020,1,21,4,31,10,41
2020,1,21,5,138,46,184
2020,1,21,6,292,128,420
2020,1,21,7,433,198,631
2020,1,21,8,276,179,455
2020,1,21,9,242,181,423
2020,1,21,10,227,168,395
2020,1,21,11,192,188,380
2020,1,21,12,223,190,413
2020,1,21,13,245,291,536
2020,1,21,14,264,296,560
2020,1,21,15,236,299,535
2020,1,21,16,178,176,354
2020,1,21,17,217,153,370
2020,1,21,18,122,139,261
2020,1,21,19,90,126,216
2020,1,21,20,69,113,182
2020,1,21,21,52,213,265
2020,1,21,22,33,170,203
2020,1,21,23,12,39,51
2020,1,22,0,8,28,36
2020,1,22,1,7,26,33
2020,1,22,2,9,21,30
2020,1,22,3,13,19,32
2020,1,22,4,16,6,22
2020,1,22,5,126,42,168
2020,1,22,6,254,140,394
2020,1,22,7,396,214,610
2020,1,22,8,302,136,438
2020,1,22,9,217,165,382
2020,1,22,10,215,284,499
2020,1,22,11,208,179,387
2020,1,22,12,216,210,426
2020,1,22,13,229,216,445
2020,1,22,14,278,295,573
2020,1,22,15,243,297,540
2020,1,22,16,180,192,372
2020,1,22,17,162,124,286
2020,1,22,18,115,117,232
2020,1,22,19,101,140,241
2020,1,22,20,80,90,170
2020,1,22,21,66,52,118
2020,1,22,22,24,29,53
2020,1,22,23,23,15,38
2020,1,23,0,12,16,28
2020,1,23,1,5,8,13
2020,1,23,2,8,9,17
2020,1,23,3,11,7,18
2020,1,23,4,21,8,29
2020,1,23,5,125,46,171
2020,1,23,6,243,131,374
2020,1,23,7,418,186,604
2020,1,23,8,272,167,439
2020,1,23,9,203,163,366
2020,1,23,10,253,164,417
2020,1,23,11,200,190,390
2020,1,23,12,242,193,435
2020,1,23,13,212,227,439
2020,1,23,14,296,275,571
2020,1,23,15,236,311,547
2020,1,23,16,160,170,330
2020,1,23,17,172,146,318
2020,1,23,18,123,123,246
2020,1,23,19,93,115,208
2020,1,23,20,74,112,186
2020,1,23,21,63,68,131
2020,1,23,22,36,38,74
2020,1,23,23,21,15,36
2020,1,24,0,11,17,28
2020,1,24,1,12,17,29
2020,1,24,2,15,13,28
2020,1,24,3,11,10,21
2020,1,24,4,25,12,37
2020,1,24,5,125,53,178
2020,1,24,6,273,138,411
2020,1,24,7,404,172,576
2020,1,24,8,267,155,422
2020,1,24,9,250,169,419
2020,1,24,10,235,164,399
2020,1,24,11,223,169,392
2020,1,24,12,231,243,474
2020,1,24,13,257,261,518
2020,1,24,14,267,339,606
2020,1,24,15,200,284,484
2020,1,24,16,155,170,325
2020,1,24,17,135,119,254
2020,1,24,18,100,103,203
2020,1,24,19,92,86,178
2020,1,24,20,56,68,124
2020,1,24,21,59,58,117
2020,1,24,22,54,58,112
2020,1,24,23,26,43,69
2020,1,25,0,29,19,48
2020,1,25,1,18,18,36
2020,1,25,2,14,22,36
2020,1,25,3,14,17,31
2020,1,25,4,7,5,12
2020,1,25,5,23,22,45
2020,1,25,6,21,19,40
2020,1,25,7,48,28,76
2020,1,25,8,46,36,82
2020,1,25,9,90,58,148
2020,1,25,10,134,84,218
2020,1,25,11,150,112,262
2020,1,25,12,169,138,307
2020,1,25,13,156,172,328
2020,1,25,14,160,183,343
2020,1,25,15,140,172,312
2020,1,25,16,138,144,282
2020,1,25,17,134,120,254
2020,1,25,18,105,85,190
2020,1,25,19,93,100,193
2020,1,25,20,56,58,114
2020,1,25,21,52,61,113
2020,1,25,22,40,69,109
2020,1,25,23,36,49,85
2020,1,26,0,28,34,62
2020,1,26,1,22,29,51
2020,1,26,2,22,29,51
2020,1,26,3,24,28,52
2020,1,26,4,11,15,26
2020,1,26,5,14,10,24
2020,1,26,6,15,14,29
2020,1,26,7,36,19,55
2020,1,26,8,45,24,69
2020,1,26,9,114,57,171
2020,1,26,10,91,83,174
2020,1,26,11,158,109,267
2020,1,26,12,140,160,300
2020,1,26,13,161,173,334
2020,1,26,14,175,204,379
2020,1,26,15,148,191,339
2020,1,26,16,154,154,308
2020,1,26,17,129,130,259
2020,1,26,18,118,132,250
2020,1,26,19,124,121,245
2020,1,26,20,72,73,145
2020,1,26,21,54,64,118
2020,1,26,22,28,41,69
2020,1,26,23,15,12,27
2020,1,27,0,10,12,22
2020,1,27,1,6,6,12
2020,1,27,2,9,9,18
2020,1,27,3,11,5,16
2020,1,27,4,21,7,28
2020,1,27,5,142,54,196
2020,1,27,6,242,127,369
2020,1,27,7,445,191,636
2020,1,27,8,263,156,419
2020,1,27,9,202,141,343
2020,1,27,10,210,160,370
2020,1,27,11,196,191,387
2020,1,27,12,197,205,402
2020,1,27,13,201,226,427
2020,1,27,14,272,300,572
2020,1,27,15,228,305,533
2020,1,27,16,187,178,365
2020,1,27,17,165,140,305
2020,1,27,18,134,129,263
2020,1,27,19,100,103,203
2020,1,27,20,87,106,193
2020,1,27,21,60,59,119
2020,1,27,22,26,27,53
2020,1,27,23,9,15,24
2020,1,28,0,11,11,22
2020,1,28,1,13,7,20
2020,1,28,2,6,9,15
2020,1,28,3,12,4,16
2020,1,28,4,21,5,26
2020,1,28,5,136,47,183
2020,1,28,6,261,119,380
2020,1,28,7,412,190,602
2020,1,28,8,260,157,417
2020,1,28,9,227,161,388
2020,1,28,10,257,152,409
2020,1,28,11,211,169,380
2020,1,28,12,212,197,409
2020,1,28,13,253,229,482
2020,1,28,14,232,295,527
2020,1,28,15,193,278,471
2020,1,28,16,214,172,386
2020,1,28,17,183,156,339
2020,1,28,18,127,137,264
2020,1,28,19,116,127,243
2020,1,28,20,96,105,201
2020,1,28,21,50,76,126
2020,1,28,22,26,78,104
2020,1,28,23,15,18,33
2020,1,29,0,12,16,28
2020,1,29,1,9,6,15
2020,1,29,2,10,4,14
2020,1,29,3,6,6,12
2020,1,29,4,18,10,28
2020,1,29,5,129,54,183
2020,1,29,6,272,131,403
2020,1,29,7,369,169,538
2020,1,29,8,262,152,414
2020,1,29,9,251,143,394
2020,1,29,10,214,171,385
2020,1,29,11,211,172,383
2020,1,29,12,221,173,394
2020,1,29,13,214,230,444
2020,1,29,14,250,303,553
2020,1,29,15,224,270,494
2020,1,29,16,176,210,386
2020,1,29,17,166,161,327
2020,1,29,18,134,139,273
2020,1,29,19,130,99,229
2020,1,29,20,87,89,176
2020,1,29,21,67,93,160
2020,1,29,22,31,39,70
2020,1,29,23,27,18,45
2020,1,30,0,10,8,18
2020,1,30,1,4,3,7
2020,1,30,2,10,9,19
2020,1,30,3,8,7,15
2020,1,30,4,26,9,35
2020,1,30,5,120,51,171
2020,1,30,6,263,121,384
2020,1,30,7,411,205,616
2020,1,30,8,290,153,443
2020,1,30,9,216,159,375
2020,1,30,10,238,172,410
2020,1,30,11,216,203,419
2020,1,30,12,241,310,551
2020,1,30,13,244,208,452
2020,1,30,14,265,347,612
2020,1,30,15,421,455,876
2020,1,30,16,240,287,527
2020,1,30,17,163,154,317
2020,1,30,18,137,125,262
2020,1,30,19,95,109,204
2020,1,30,20,74,108,182
2020,1,30,21,58,85,143
2020,1,30,22,39,65,104
2020,1,30,23,21,32,53
2020,1,31,0,19,20,39
2020,1,31,1,14,9,23
2020,1,31,2,12,12,24
2020,1,31,3,9,13,22
2020,1,31,4,21,5,26
2020,1,31,5,134,45,179
2020,1,31,6,264,132,396
2020,1,31,7,299,161,460
2020,1,31,8,236,137,373
2020,1,31,9,220,157,377
2020,1,31,10,255,167,422
2020,1,31,11,219,189,408
2020,1,31,12,224,220,444
2020,1,31,13,257,245,502
2020,1,31,14,263,278,541
2020,1,31,15,189,268,457
2020,1,31,16,146,178,324
2020,1,31,17,140,117,257
2020,1,31,18,113,131,244
2020,1,31,19,83,72,155
2020,1,31,20,64,72,136
2020,1,31,21,58,59,117
2020,1,31,22,49,50,99
2020,1,31,23,33,45,78
2020,2,1,0,22,27,49
2020,2,1,1,13,25,38
2020,2,1,2,15,23,38
2020,2,1,3,12,13,25
2020,2,1,4,6,6,12
2020,2,1,5,19,9,28
2020,2,1,6,28,19,47
2020,2,1,7,24,20,44
2020,2,1,8,76,45,121
2020,2,1,9,110,72,182
2020,2,1,10,135,92,227
2020,2,1,11,147,118,265
2020,2,1,12,167,156,323
2020,2,1,13,173,153,326
2020,2,1,14,137,179,316
2020,2,1,15,139,147,286
2020,2,1,16,126,136,262
2020,2,1,17,116,122,238
2020,2,1,18,77,103,180
2020,2,1,19,67,68,135
2020,2,1,20,57,64,121
2020,2,1,21,44,57,101
2020,2,1,22,45,63,108
2020,2,1,23,39,43,82
2020,2,2,0,33,43,76
2020,2,2,1,18,33,51
2020,2,2,2,33,44,77
2020,2,2,3,19,24,43
2020,2,2,4,14,18,32
2020,2,2,5,21,9,30
2020,2,2,6,17,17,34
2020,2,2,7,23,20,43
2020,2,2,8,40,24,64
2020,2,2,9,83,44,127
2020,2,2,10,99,63,162
2020,2,2,11,132,113,245
2020,2,2,12,142,162,304
2020,2,2,13,171,163,334
2020,2,2,14,169,158,327
2020,2,2,15,111,170,281
2020,2,2,16,142,123,265
2020,2,2,17,130,125,255
2020,2,2,18,138,119,257
2020,2,2,19,114,117,231
2020,2,2,20,76,83,159
2020,2,2,21,45,62,107
2020,2,2,22,26,30,56
2020,2,2,23,21,25,46
2020,2,3,0,8,11,19
2020,2,3,1,12,9,21
2020,2,3,2,7,8,15
2020,2,3,3,11,12,23
2020,2,3,4,29,11,40
2020,2,3,5,111,44,155
2020,2,3,6,228,124,352
2020,2,3,7,411,209,620
2020,2,3,8,262,168,430
2020,2,3,9,188,152,340
2020,2,3,10,219,168,387
2020,2,3,11,222,200,422
2020,2,3,12,202,182,384
2020,2,3,13,204,215,419
2020,2,3,14,242,295,537
2020,2,3,15,211,313,524
2020,2,3,16,185,162,347
2020,2,3,17,144,154,298
2020,2,3,18,112,100,212
2020,2,3,19,80,95,175
2020,2,3,20,95,92,187
2020,2,3,21,44,57,101
2020,2,3,22,24,33,57
2020,2,3,23,17,20,37
2020,2,4,0,14,14,28
2020,2,4,1,6,5,11
2020,2,4,2,7,6,13
2020,2,4,3,11,3,14
2020,2,4,4,28,20,48
2020,2,4,5,139,46,185
2020,2,4,6,250,155,405
2020,2,4,7,373,165,538
2020,2,4,8,265,149,414
2020,2,4,9,231,139,370
2020,2,4,10,219,149,368
2020,2,4,11,213,172,385
2020,2,4,12,203,177,380
2020,2,4,13,213,212,425
2020,2,4,14,277,297,574
2020,2,4,15,207,305,512
2020,2,4,16,185,180,365
2020,2,4,17,180,150,330
2020,2,4,18,133,147,280
2020,2,4,19,103,110,213
2020,2,4,20,83,121,204
2020,2,4,21,50,59,109
2020,2,4,22,34,28,62
2020,2,4,23,20,17,37
2020,2,5,0,10,9,19
2020,2,5,1,10,9,19
2020,2,5,2,7,3,10
2020,2,5,3,12,9,21
2020,2,5,4,23,20,43
2020,2,5,5,117,57,174
2020,2,5,6,271,133,404
2020,2,5,7,411,205,616
2020,2,5,8,286,153,439
2020,2,5,9,237,163,400
2020,2,5,10,233,166,399
2020,2,5,11,212,174,386
2020,2,5,12,199,221,420
2020,2,5,13,225,220,445
2020,2,5,14,270,308,578
2020,2,5,15,238,304,542
2020,2,5,16,192,188,380
2020,2,5,17,151,142,293
2020,2,5,18,147,130,277
2020,2,5,19,121,99,220
2020,2,5,20,82,96,178
2020,2,5,21,58,72,130
2020,2,5,22,31,47,78
2020,2,5,23,16,18,34
2020,2,6,0,7,11,18
2020,2,6,1,6,5,11
2020,2,6,2,8,9,17
2020,2,6,3,6,5,11
2020,2,6,4,25,6,31
2020,2,6,5,127,53,180
2020,2,6,6,255,131,386
2020,2,6,7,388,195,583
2020,2,6,8,286,144,430
2020,2,6,9,232,159,391
2020,2,6,10,221,167,388
2020,2,6,11,227,199,426
2020,2,6,12,213,193,406
2020,2,6,13,225,222,447
2020,2,6,14,255,276,531
2020,2,6,15,224,294,518
2020,2,6,16,199,171,370
2020,2,6,17,183,143,326
2020,2,6,18,145,148,293
2020,2,6,19,94,108,202
2020,2,6,20,93,106,199
2020,2,6,21,58,79,137
2020,2,6,22,38,71,109
2020,2,6,23,20,26,46
2020,2,7,0,13,13,26
2020,2,7,1,10,18,28
2020,2,7,2,16,26,42
2020,2,7,3,13,7,20
2020,2,7,4,21,9,30
2020,2,7,5,134,36,170
2020,2,7,6,244,135,379
2020,2,7,7,414,191,605
2020,2,7,8,237,127,364
2020,2,7,9,244,171,415
2020,2,7,10,232,186,418
2020,2,7,11,213,189,402
2020,2,7,12,226,182,408
2020,2,7,13,259,273,532
2020,2,7,14,261,292,553
2020,2,7,15,211,287,498
2020,2,7,16,160,196,356
2020,2,7,17,165,139,304
2020,2,7,18,100,100,200
2020,2,7,19,95,98,193
2020,2,7,20,62,86,148
2020,2,7,21,45,67,112
2020,2,7,22,41,60,101
2020,2,7,23,35,48,83
2020,2,8,0,20,26,46
2020,2,8,1,21,22,43
2020,2,8,2,20,27,47
2020,2,8,3,8,15,23
2020,2,8,4,18,8,26
2020,2,8,5,22,10,32
2020,2,8,6,32,25,57
2020,2,8,7,54,27,81
2020,2,8,8,143,61,204
2020,2,8,9,128,70,198
2020,2,8,10,175,108,283
2020,2,8,11,196,119,315
2020,2,8,12,188,185,373
2020,2,8,13,186,166,352
2020,2,8,14,167,195,362
2020,2,8,15,187,158,345
2020,2,8,16,165,137,302
2020,2,8,17,175,135,310
2020,2,8,18,124,105,229
2020,2,8,19,88,89,177
2020,2,8,20,54,66,120
2020,2,8,21,57,62,119
2020,2,8,22,51,59,110
2020,2,8,23,34,63,97
2020,2,9,0,20,25,45
2020,2,9,1,26,30,56
2020,2,9,2,19,26,45
2020,2,9,3,17,26,43
2020,2,9,4,9,10,19
2020,2,9,5,14,9,23
2020,2,9,6,19,13,32
2020,2,9,7,34,16,50
2020,2,9,8,64,33,97
2020,2,9,9,96,40,136
2020,2,9,10,109,57,166
2020,2,9,11,149,127,276
2020,2,9,12,145,155,300
2020,2,9,13,158,175,333
2020,2,9,14,183,160,343
2020,2,9,15,159,201,360
2020,2,9,16,191,142,333
2020,2,9,17,155,142,297
2020,2,9,18,168,148,316
2020,2,9,19,100,128,228
2020,2,9,20,88,70,158
2020,2,9,21,49,54,103
2020,2,9,22,27,44,71
2020,2,9,23,14,20,34
2020,2,10,0,9,4,13
2020,2,10,1,5,5,10
2020,2,10,2,5,5,10
2020,2,10,3,8,2,10
2020,2,10,4,22,5,27
2020,2,10,5,133,54,187
2020,2,10,6,229,124,353
2020,2,10,7,399,210,609
2020,2,10,8,275,133,408
2020,2,10,9,218,168,386
2020,2,10,10,218,149,367
2020,2,10,11,208,181,389
2020,2,10,12,219,168,387
2020,2,10,13,221,257,478
2020,2,10,14,271,344,615
2020,2,10,15,228,313,541
2020,2,10,16,185,186,371
2020,2,10,17,147,135,282
2020,2,10,18,130,141,271
2020,2,10,19,101,101,202
2020,2,10,20,93,93,186
2020,2,10,21,48,53,101
2020,2,10,22,37,33,70
2020,2,10,23,20,32,52
2020,2,11,0,12,16,28
2020,2,11,1,10,7,17
2020,2,11,2,8,8,16
2020,2,11,3,6,4,10
2020,2,11,4,20,13,33
2020,2,11,5,121,47,168
2020,2,11,6,243,119,362
2020,2,11,7,406,215,621
2020,2,11,8,274,159,433
2020,2,11,9,276,204,480
2020,2,11,10,243,182,425
2020,2,11,11,248,174,422
2020,2,11,12,228,185,413
2020,2,11,13,227,247,474
2020,2,11,14,247,317,564
2020,2,11,15,215,276,491
2020,2,11,16,182,151,333
2020,2,11,17,192,175,367
2020,2,11,18,121,115,236
2020,2,11,19,95,113,208
2020,2,11,20,103,103,206
2020,2,11,21,53,87,140
2020,2,11,22,34,33,67
2020,2,11,23,10,14,24
2020,2,12,0,12,9,21
2020,2,12,1,16,12,28
2020,2,12,2,7,6,13
2020,2,12,3,10,12,22
2020,2,12,4,18,6,24
2020,2,12,5,117,45,162
2020,2,12,6,238,129,367
2020,2,12,7,401,180,581
2020,2,12,8,260,149,409
2020,2,12,9,240,139,379
2020,2,12,10,233,178,411
2020,2,12,11,220,190,410
2020,2,12,12,213,175,388
2020,2,12,13,235,219,454
2020,2,12,14,232,308,540
2020,2,12,15,231,273,504
2020,2,12,16,200,195,395
2020,2,12,17,163,131,294
2020,2,12,18,116,132,248
2020,2,12,19,108,109,217
2020,2,12,20,86,103,189
2020,2,12,21,64,67,131
2020,2,12,22,31,27,58
2020,2,12,23,17,19,36
2020,2,13,0,9,9,18
2020,2,13,1,9,9,18
2020,2,13,2,9,4,13
2020,2,13,3,11,8,19
2020,2,13,4,21,9,30
2020,2,13,5,134,50,184
2020,2,13,6,252,122,374
2020,2,13,7,401,209,610
2020,2,13,8,275,145,420
2020,2,13,9,232,132,364
2020,2,13,10,204,162,366
2020,2,13,11,228,160,388
2020,2,13,12,220,197,417
2020,2,13,13,226,207,433
2020,2,13,14,262,344,606
2020,2,13,15,218,284,502
2020,2,13,16,198,190,388
2020,2,13,17,173,146,319
2020,2,13,18,153,131,284
2020,2,13,19,89,96,185
2020,2,13,20,105,92,197
2020,2,13,21,56,180,236
2020,2,13,22,43,51,94
2020,2,13,23,28,24,52
2020,2,14,0,12,14,26
2020,2,14,1,14,9,23
2020,2,14,2,13,14,27
2020,2,14,3,11,9,20
2020,2,14,4,27,11,38
2020,2,14,5,114,56,170
2020,2,14,6,257,119,376
2020,2,14,7,423,177,600
2020,2,14,8,265,136,401
2020,2,14,9,218,163,381
2020,2,14,10,253,177,430
2020,2,14,11,237,178,415
2020,2,14,12,249,198,447
2020,2,14,13,271,278,549
2020,2,14,14,291,379,670
2020,2,14,15,197,277,474
2020,2,14,16,154,174,328
2020,2,14,17,152,127,279
2020,2,14,18,103,113,216
2020,2,14,19,103,108,211
2020,2,14,20,65,75,140
2020,2,14,21,61,78,139
2020,2,14,22,47,61,108
2020,2,14,23,38,50,88
2020,2,15,0,26,32,58
2020,2,15,1,21,19,40
2020,2,15,2,21,24,45
2020,2,15,3,6,14,20
2020,2,15,4,17,5,22
2020,2,15,5,19,16,35
2020,2,15,6,24,26,50
2020,2,15,7,63,43,106
2020,2,15,8,72,43,115
2020,2,15,9,107,73,180
2020,2,15,10,118,91,209
2020,2,15,11,160,130,290
2020,2,15,12,169,166,335
2020,2,15,13,167,155,322
2020,2,15,14,153,174,327
2020,2,15,15,126,155,281
2020,2,15,16,136,156,292
2020,2,15,17,153,137,290
2020,2,15,18,112,122,234
2020,2,15,19,66,69,135
2020,2,15,20,69,87,156
2020,2,15,21,57,47,104
2020,2,15,22,49,59,108
2020,2,15,23,39,51,90
2020,2,16,0,24,43,67
2020,2,16,1,31,26,57
2020,2,16,2,20,28,48
2020,2,16,3,15,32,47
2020,2,16,4,11,10,21
2020,2,16,5,26,14,40
2020,2,16,6,15,12,27
2020,2,16,7,27,16,43
2020,2,16,8,58,41,99
2020,2,16,9,150,68,218
2020,2,16,10,121,88,209
2020,2,16,11,156,128,284
2020,2,16,12,151,188,339
2020,2,16,13,174,177,351
2020,2,16,14,141,203,344
2020,2,16,15,134,174,308
2020,2,16,16,194,160,354
2020,2,16,17,138,138,276
2020,2,16,18,129,140,269
2020,2,16,19,110,121,231
2020,2,16,20,78,81,159
2020,2,16,21,60,52,112
2020,2,16,22,22,31,53
2020,2,16,23,22,17,39
2020,2,17,0,15,9,24
2020,2,17,1,7,8,15
2020,2,17,2,7,10,17
2020,2,17,3,6,6,12
2020,2,17,4,28,9,37
2020,2,17,5,129,54,183
2020,2,17,6,256,135,391
2020,2,17,7,408,198,606
2020,2,17,8,287,172,459
2020,2,17,9,230,144,374
2020,2,17,10,242,174,416
2020,2,17,11,204,172,376
2020,2,17,12,230,205,435
2020,2,17,13,212,242,454
2020,2,17,14,257,308,565
2020,2,17,15,218,323,541
2020,2,17,16,194,164,358
2020,2,17,17,178,318,496
2020,2,17,18,116,112,228
2020,2,17,19,101,119,220
2020,2,17,20,95,99,194
2020,2,17,21,52,83,135
2020,2,17,22,28,40,68
2020,2,17,23,15,27,42
2020,2,18,0,10,10,20
2020,2,18,1,4,7,11
2020,2,18,2,11,10,21
2020,2,18,3,10,5,15
2020,2,18,4,23,13,36
2020,2,18,5,136,48,184
2020,2,18,6,272,154,426
2020,2,18,7,391,205,596
2020,2,18,8,324,156,480
2020,2,18,9,263,157,420
2020,2,18,10,267,160,427
2020,2,18,11,199,171,370
2020,2,18,12,209,195,404
2020,2,18,13,206,257,463
2020,2,18,14,254,306,560
2020,2,18,15,225,316,541
2020,2,18,16,250,173,423
2020,2,18,17,176,166,342
2020,2,18,18,153,150,303
2020,2,18,19,111,125,236
2020,2,18,20,86,105,191
2020,2,18,21,63,69,132
2020,2,18,22,36,42,78
2020,2,18,23,15,16,31
2020,2,19,0,9,7,16
2020,2,19,1,8,12,20
2020,2,19,2,11,5,16
2020,2,19,3,7,5,12
2020,2,19,4,19,6,25
2020,2,19,5,130,57,187
2020,2,19,6,251,139,390
2020,2,19,7,429,200,629
2020,2,19,8,270,139,409
2020,2,19,9,257,181,438
2020,2,19,10,217,180,397
2020,2,19,11,203,204,407
2020,2,19,12,222,205,427
2020,2,19,13,241,239,480
2020,2,19,14,275,333,608
2020,2,19,15,250,309,559
2020,2,19,16,207,200,407
2020,2,19,17,206,160,366
2020,2,19,18,148,170,318
2020,2,19,19,115,129,244
2020,2,19,20,82,101,183
2020,2,19,21,62,64,126
2020,2,19,22,38,49,87
2020,2,19,23,22,17,39
2020,2,20,0,11,6,17
2020,2,20,1,13,8,21
2020,2,20,2,8,2,10
2020,2,20,3,7,8,15
2020,2,20,4,26,11,37
2020,2,20,5,136,46,182
2020,2,20,6,237,123,360
2020,2,20,7,420,211,631
2020,2,20,8,299,160,459
2020,2,20,9,266,171,437
2020,2,20,10,243,174,417
2020,2,20,11,213,193,406
2020,2,20,12,263,209,472
2020,2,20,13,225,243,468
2020,2,20,14,280,342,622
2020,2,20,15,257,304,561
2020,2,20,16,218,161,379
2020,2,20,17,194,160,354
2020,2,20,18,137,144,281
2020,2,20,19,109,119,228
2020,2,20,20,90,123,213
2020,2,20,21,65,352,417
2020,2,20,22,35,234,269
2020,2,20,23,12,146,158
2020,2,21,0,12,59,71
2020,2,21,1,11,42,53
2020,2,21,2,11,37,48
2020,2,21,3,7,42,49
2020,2,21,4,26,42,68
2020,2,21,5,137,40,177
2020,2,21,6,272,143,415
2020,2,21,7,394,195,589
2020,2,21,8,273,149,422
2020,2,21,9,230,169,399
2020,2,21,10,258,197,455
2020,2,21,11,259,199,458
2020,2,21,12,238,216,454
2020,2,21,13,271,254,525
2020,2,21,14,283,352,635
2020,2,21,15,243,277,520
2020,2,21,16,165,166,331
2020,2,21,17,124,143,267
2020,2,21,18,119,124,243
2020,2,21,19,88,93,181
2020,2,21,20,82,85,167
2020,2,21,21,58,56,114
2020,2,21,22,40,49,89
2020,2,21,23,29,34,63
2020,2,22,0,18,22,40
2020,2,22,1,15,14,29
2020,2,22,2,16,25,41
2020,2,22,3,4,18,22
2020,2,22,4,14,17,31
2020,2,22,5,29,9,38
2020,2,22,6,34,26,60
2020,2,22,7,29,16,45
2020,2,22,8,53,44,97
2020,2,22,9,121,61,182
2020,2,22,10,121,73,194
2020,2,22,11,141,121,262
2020,2,22,12,150,130,280
2020,2,22,13,154,159,313
2020,2,22,14,123,142,265
2020,2,22,15,127,146,273
2020,2,22,16,126,116,242
2020,2,22,17,137,137,274
2020,2,22,18,103,123,226
2020,2,22,19,93,85,178
2020,2,22,20,50,77,127
2020,2,22,21,48,52,100
2020,2,22,22,40,54,94
2020,2,22,23,40,57,97
2020,2,23,0,28,38,66
2020,2,23,1,26,27,53
2020,2,23,2,25,37,62
2020,2,23,3,11,24,35
2020,2,23,4,16,12,28
2020,2,23,5,19,16,35
2020,2,23,6,15,13,28
2020,2,23,7,39,15,54
2020,2,23,8,47,32,79
2020,2,23,9,86,56,142
2020,2,23,10,103,88,191
2020,2,23,11,124,105,229
2020,2,23,12,138,127,265
2020,2,23,13,150,162,312
2020,2,23,14,140,158,298
2020,2,23,15,114,156,270
2020,2,23,16,137,135,272
2020,2,23,17,139,120,259
2020,2,23,18,113,115,228
2020,2,23,19,103,118,221
2020,2,23,20,81,79,160
2020,2,23,21,53,63,116
2020,2,23,22,21,42,63
2020,2,23,23,19,23,42
2020,2,24,0,7,15,22
2020,2,24,1,11,3,14
2020,2,24,2,13,10,23
2020,2,24,3,8,5,13
2020,2,24,4,25,13,38
2020,2,24,5,133,56,189
2020,2,24,6,255,110,365
2020,2,24,7,281,134,415
2020,2,24,8,240,135,375
2020,2,24,9,246,159,405
2020,2,24,10,208,154,362
2020,2,24,11,213,168,381
2020,2,24,12,204,183,387
2020,2,24,13,198,227,425
2020,2,24,14,234,277,511
2020,2,24,15,197,240,437
2020,2,24,16,168,172,340
2020,2,24,17,126,124,250
2020,2,24,18,130,111,241
2020,2,24,19,106,119,225
2020,2,24,20,71,85,156
2020,2,24,21,49,206,255
2020,2,24,22,34,175,209
2020,2,24,23,17,65,82
2020,2,25,0,7,28,35
2020,2,25,1,8,23,31
2020,2,25,2,8,27,35
2020,2,25,3,5,32,37
2020,2,25,4,25,28,53
2020,2,25,5,136,59,195
2020,2,25,6,240,104,344
2020,2,25,7,304,143,447
2020,2,25,8,239,151,390
2020,2,25,9,212,142,354
2020,2,25,10,221,170,391
2020,2,25,11,208,159,367
2020,2,25,12,195,202,397
2020,2,25,13,211,239,450
2020,2,25,14,224,272,496
2020,2,25,15,181,235,416
2020,2,25,16,150,161,311
2020,2,25,17,146,110,256
2020,2,25,18,121,106,227
2020,2,25,19,87,104,191
2020,2,25,20,66,86,152
2020,2,25,21,39,221,260
2020,2,25,22,30,112,142
2020,2,25,23,14,43,57
2020,2,26,0,5,24,29
2020,2,26,1,4,9,13
2020,2,26,2,5,13,18
2020,2,26,3,11,25,36
2020,2,26,4,15,34,49
2020,2,26,5,124,50,174
2020,2,26,6,225,101,326
2020,2,26,7,279,136,415
2020,2,26,8,226,130,356
2020,2,26,9,228,135,363
2020,2,26,10,189,156,345
2020,2,26,11,188,189,377
2020,2,26,12,218,194,412
2020,2,26,13,202,232,434
2020,2,26,14,254,261,515
2020,2,26,15,207,254,461
2020,2,26,16,174,176,350
2020,2,26,17,130,124,254
2020,2,26,18,107,131,238
2020,2,26,19,91,106,197
2020,2,26,20,76,77,153
2020,2,26,21,58,65,123
2020,2,26,22,49,28,77
2020,2,26,23,25,19,44
2020,2,27,0,22,12,34
2020,2,27,1,8,14,22
2020,2,27,2,18,9,27
2020,2,27,3,19,10,29
2020,2,27,4,31,10,41
2020,2,27,5,113,60,173
2020,2,27,6,211,105,316
2020,2,27,7,259,151,410
2020,2,27,8,189,120,309
2020,2,27,9,192,142,334
2020,2,27,10,178,149,327
2020,2,27,11,188,167,355
2020,2,27,12,194,153,347
2020,2,27,13,228,217,445
2020,2,27,14,229,242,471
2020,2,27,15,184,235,419
2020,2,27,16,156,152,308
2020,2,27,17,137,109,246
2020,2,27,18,111,125,236
2020,2,27,19,90,90,180
2020,2,27,20,82,83,165
2020,2,27,21,60,68,128
2020,2,27,22,25,44,69
2020,2,27,23,23,26,49
2020,2,28,0,17,9,26
2020,2,28,1,25,19,44
2020,2,28,2,15,15,30
2020,2,28,3,9,10,19
2020,2,28,4,24,15,39
2020,2,28,5,114,51,165
2020,2,28,6,217,130,347
2020,2,28,7,254,126,380
2020,2,28,8,187,126,313
2020,2,28,9,201,135,336
2020,2,28,10,222,151,373
2020,2,28,11,193,180,373
2020,2,28,12,222,193,415
2020,2,28,13,246,213,459
2020,2,28,14,232,247,479
2020,2,28,15,156,206,362
2020,2,28,16,144,133,277
2020,2,28,17,112,107,219
2020,2,28,18,101,108,209
2020,2,28,19,102,73,175
2020,2,28,20,73,61,134
2020,2,28,21,58,63,121
2020,2,28,22,37,42,79
2020,2,28,23,29,47,76
2020,2,29,0,25,26,51
2020,2,29,1,16,22,38
2020,2,29,2,22,17,39
2020,2,29,3,10,11,21
2020,2,29,4,13,8,21
2020,2,29,5,27,19,46
2020,2,29,6,28,18,46
2020,2,29,7,44,28,72
2020,2,29,8,56,36,92
2020,2,29,9,78,55,133
2020,2,29,10,119,81,200
2020,2,29,11,135,92,227
2020,2,29,12,118,123,241
2020,2,29,13,158,134,292
2020,2,29,14,118,170,288
2020,2,29,15,110,149,259
2020,2,29,16,132,140,272
2020,2,29,17,114,104,218
2020,2,29,18,99,92,191
2020,2,29,19,81,74,155
2020,2,29,20,62,67,129
2020,2,29,21,54,74,128
2020,2,29,22,47,70,117
2020,2,29,23,36,45,81
2020,3,1,0,31,23,54
2020,3,1,1,24,28,52
2020,3,1,2,20,36,56
2020,3,1,3,7,17,24
2020,3,1,4,14,10,24
2020,3,1,5,21,17,38
2020,3,1,6,12,16,28
2020,3,1,7,34,13,47
2020,3,1,8,40,20,60
2020,3,1,9,94,57,151
2020,3,1,10,101,84,185
2020,3,1,11,135,129,264
2020,3,1,12,169,142,311
2020,3,1,13,157,158,315
2020,3,1,14,127,156,283
2020,3,1,15,127,153,280
2020,3,1,16,134,137,271
2020,3,1,17,160,118,278
2020,3,1,18,130,116,246
2020,3,1,19,107,112,219
2020,3,1,20,69,81,150
2020,3,1,21,38,42,80
2020,3,1,22,32,25,57
2020,3,1,23,15,19,34
2020,3,2,0,11,5,16
2020,3,2,1,2,1,3
2020,3,2,2,4,7,11
2020,3,2,3,10,5,15
2020,3,2,4,18,6,24
2020,3,2,5,142,57,199
2020,3,2,6,283,146,429
2020,3,2,7,404,197,601
2020,3,2,8,284,149,433
2020,3,2,9,237,145,382
2020,3,2,10,215,161,376
2020,3,2,11,231,198,429
2020,3,2,12,241,217,458
2020,3,2,13,224,238,462
2020,3,2,14,257,321,578
2020,3,2,15,187,304,491
2020,3,2,16,173,186,359
2020,3,2,17,160,154,314
2020,3,2,18,133,111,244
2020,3,2,19,114,99,213
2020,3,2,20,81,116,197
2020,3,2,21,34,62,96
2020,3,2,22,19,45,64
2020,3,2,23,14,17,31
2020,3,3,0,5,5,10
2020,3,3,1,5,8,13
2020,3,3,2,9,2,11
2020,3,3,3,12,4,16
2020,3,3,4,23,9,32
2020,3,3,5,132,50,182
2020,3,3,6,294,142,436
2020,3,3,7,426,180,606
2020,3,3,8,283,177,460
2020,3,3,9,236,161,397
2020,3,3,10,227,169,396
2020,3,3,11,214,194,408
2020,3,3,12,212,182,394
2020,3,3,13,220,241,461
2020,3,3,14,252,293,545
2020,3,3,15,237,299,536
2020,3,3,16,204,189,393
2020,3,3,17,181,145,326
2020,3,3,18,139,138,277
2020,3,3,19,92,122,214
2020,3,3,20,87,103,190
2020,3,3,21,69,81,150
2020,3,3,22,41,30,71
2020,3,3,23,21,17,38
2020,3,4,0,16,15,31
2020,3,4,1,17,8,25
2020,3,4,2,21,9,30
2020,3,4,3,22,5,27
2020,3,4,4,23,9,32
2020,3,4,5,141,56,197
2020,3,4,6,280,132,412
2020,3,4,7,411,191,602
2020,3,4,8,241,139,380
2020,3,4,9,224,156,380
2020,3,4,10,215,158,373
2020,3,4,11,219,161,380
2020,3,4,12,244,197,441
2020,3,4,13,235,256,491
2020,3,4,14,248,280,528
2020,3,4,15,229,276,505
2020,3,4,16,218,167,385
2020,3,4,17,143,138,281
2020,3,4,18,145,163,308
2020,3,4,19,120,117,237
2020,3,4,20,76,119,195
2020,3,4,21,65,247,312
2020,3,4,22,40,134,174
2020,3,4,23,22,51,73
2020,3,5,0,7,32,39
2020,3,5,1,7,21,28
2020,3,5,2,5,14,19
2020,3,5,3,15,18,33
2020,3,5,4,16,28,44
2020,3,5,5,121,42,163
2020,3,5,6,257,137,394
2020,3,5,7,419,198,617
2020,3,5,8,287,155,442
2020,3,5,9,229,162,391
2020,3,5,10,228,194,422
2020,3,5,11,224,184,408
2020,3,5,12,240,177,417
2020,3,5,13,229,244,473
2020,3,5,14,296,319,615
2020,3,5,15,237,285,522
2020,3,5,16,187,186,373
2020,3,5,17,183,144,327
2020,3,5,18,163,147,310
2020,3,5,19,102,112,214
2020,3,5,20,78,94,172
2020,3,5,21,49,72,121
2020,3,5,22,24,37,61
2020,3,5,23,25,22,47
2020,3,6,0,12,14,26
2020,3,6,1,10,10,20
2020,3,6,2,6,5,11
2020,3,6,3,14,12,26
2020,3,6,4,12,7,19
2020,3,6,5,119,44,163
2020,3,6,6,266,138,404
2020,3,6,7,388,188,576
2020,3,6,8,256,149,405
2020,3,6,9,218,180,398
2020,3,6,10,248,146,394
2020,3,6,11,218,199,417
2020,3,6,12,253,211,464
2020,3,6,13,259,238,497
2020,3,6,14,297,307,604
2020,3,6,15,197,263,460
2020,3,6,16,197,176,373
2020,3,6,17,143,122,265
2020,3,6,18,116,114,230
2020,3,6,19,95,113,208
2020,3,6,20,74,73,147
2020,3,6,21,52,63,115
2020,3,6,22,48,40,88
2020,3,6,23,23,41,64
2020,3,7,0,19,15,34
2020,3,7,1,18,17,35
2020,3,7,2,18,15,33
2020,3,7,3,5,10,15
2020,3,7,4,6,9,15
2020,3,7,5,17,13,30
2020,3,7,6,36,22,58
2020,3,7,7,43,32,75
2020,3,7,8,65,51,116
2020,3,7,9,116,74,190
2020,3,7,10,132,94,226
2020,3,7,11,153,143,296
2020,3,7,12,140,126,266
2020,3,7,13,159,134,293
2020,3,7,14,159,186,345
2020,3,7,15,131,152,283
2020,3,7,16,132,137,269
2020,3,7,17,146,105,251
2020,3,7,18,107,110,217
2020,3,7,19,88,78,166
2020,3,7,20,60,80,140
2020,3,7,21,52,57,109
2020,3,7,22,33,50,83
2020,3,7,23,38,44,82
2020,3,8,0,28,27,55
2020,3,8,1,15,19,34
2020,3,8,2,21,31,52
2020,3,8,3,14,21,35
2020,3,8,4,9,13,22
2020,3,8,5,18,8,26
2020,3,8,6,20,15,35
2020,3,8,7,32,18,50
2020,3,8,8,45,27,72
2020,3,8,9,126,46,172
2020,3,8,10,123,80,203
2020,3,8,11,152,138,290
2020,3,8,12,157,148,305
2020,3,8,13,175,185,360
2020,3,8,14,169,147,316
2020,3,8,15,157,168,325
2020,3,8,16,173,156,329
2020,3,8,17,142,145,287
2020,3,8,18,129,124,253
2020,3,8,19,82,115,197
2020,3,8,20,74,89,163
2020,3,8,21,47,48,95
2020,3,8,22,24,36,60
2020,3,8,23,19,24,43
2020,3,9,0,7,10,17
2020,3,9,1,7,9,16
2020,3,9,2,4,7,11
2020,3,9,3,10,3,13
2020,3,9,4,19,7,26
2020,3,9,5,134,49,183
2020,3,9,6,274,138,412
2020,3,9,7,423,190,613
2020,3,9,8,264,133,397
2020,3,9,9,240,152,392
2020,3,9,10,226,177,403
2020,3,9,11,195,181,376
2020,3,9,12,216,167,383
2020,3,9,13,208,255,463
2020,3,9,14,254,311,565
2020,3,9,15,224,317,541
2020,3,9,16,182,196,378
2020,3,9,17,149,142,291
2020,3,9,18,118,119,237
2020,3,9,19,107,114,221
2020,3,9,20,83,84,167
2020,3,9,21,51,69,120
2020,3,9,22,29,30,59
2020,3,9,23,20,13,33
2020,3,10,0,12,8,20
2020,3,10,1,6,3,9
2020,3,10,2,16,8,24
2020,3,10,3,16,4,20
2020,3,10,4,15,10,25
2020,3,10,5,153,46,199
2020,3,10,6,271,130,401
2020,3,10,7,458,187,645
2020,3,10,8,292,163,455
2020,3,10,9,219,161,380
2020,3,10,10,232,192,424
2020,3,10,11,236,187,423
2020,3,10,12,224,205,429
2020,3,10,13,256,253,509
2020,3,10,14,259,297,556
2020,3,10,15,275,314,589
2020,3,10,16,191,197,388
2020,3,10,17,173,135,308
2020,3,10,18,114,122,236
2020,3,10,19,85,109,194
2020,3,10,20,71,117,188
2020,3,10,21,56,168,224
2020,3,10,22,33,70,103
2020,3,10,23,10,8,18
2020,3,11,0,10,7,17
2020,3,11,1,5,7,12
2020,3,11,2,9,6,15
2020,3,11,3,3,5,8
2020,3,11,4,19,10,29
2020,3,11,5,121,46,167
2020,3,11,6,300,140,440
2020,3,11,7,406,195,601
2020,3,11,8,270,170,440
2020,3,11,9,220,177,397
2020,3,11,10,219,172,391
2020,3,11,11,231,216,447
2020,3,11,12,239,185,424
2020,3,11,13,236,231,467
2020,3,11,14,270,288,558
2020,3,11,15,227,323,550
2020,3,11,16,206,189,395
2020,3,11,17,152,154,306
2020,3,11,18,110,121,231
2020,3,11,19,114,133,247
2020,3,11,20,78,72,150
2020,3,11,21,45,41,86
2020,3,11,22,42,29,71
2020,3,11,23,16,17,33
2020,3,12,0,19,16,35
2020,3,12,1,10,4,14
2020,3,12,2,16,5,21
2020,3,12,3,17,3,20
2020,3,12,4,30,13,43
2020,3,12,5,128,56,184
2020,3,12,6,284,121,405
2020,3,12,7,357,186,543
2020,3,12,8,253,160,413
2020,3,12,9,221,152,373
2020,3,12,10,198,168,366
2020,3,12,11,227,220,447
2020,3,12,12,251,186,437
2020,3,12,13,280,243,523
2020,3,12,14,293,306,599
2020,3,12,15,286,311,597
2020,3,12,16,203,183,386
2020,3,12,17,196,175,371
2020,3,12,18,126,132,258
2020,3,12,19,100,99,199
2020,3,12,20,87,95,182
2020,3,12,21,46,47,93
2020,3,12,22,32,33,65
2020,3,12,23,15,18,33
2020,3,13,0,17,25,42
2020,3,13,1,4,9,13
2020,3,13,2,10,7,17
2020,3,13,3,11,9,20
2020,3,13,4,15,8,23
2020,3,13,5,115,44,159
2020,3,13,6,186,114,300
2020,3,13,7,222,108,330
2020,3,13,8,195,121,316
2020,3,13,9,187,136,323
2020,3,13,10,163,163,326
2020,3,13,11,182,171,353
2020,3,13,12,188,189,377
2020,3,13,13,213,225,438
2020,3,13,14,196,200,396
2020,3,13,15,187,201,388
2020,3,13,16,149,159,308
2020,3,13,17,112,133,245
2020,3,13,18,87,92,179
2020,3,13,19,73,71,144
2020,3,13,20,48,66,114
2020,3,13,21,32,33,65
2020,3,13,22,23,30,53
2020,3,13,23,18,24,42
2020,3,14,0,4,14,18
2020,3,14,1,11,10,21
2020,3,14,2,11,11,22
2020,3,14,3,10,6,16
2020,3,14,4,8,3,11
2020,3,14,5,19,8,27
2020,3,14,6,29,25,54
2020,3,14,7,29,27,56
2020,3,14,8,39,31,70
2020,3,14,9,59,58,117
2020,3,14,10,89,88,177
2020,3,14,11,100,88,188
2020,3,14,12,98,122,220
2020,3,14,13,125,113,238
2020,3,14,14,145,127,272
2020,3,14,15,115,137,252
2020,3,14,16,77,117,194
2020,3,14,17,105,81,186
2020,3,14,18,82,103,185
2020,3,14,19,55,59,114
2020,3,14,20,49,58,107
2020,3,14,21,42,37,79
2020,3,14,22,32,31,63
2020,3,14,23,28,26,54
2020,3,15,0,16,17,33
2020,3,15,1,7,6,13
2020,3,15,2,6,3,9
2020,3,15,3,12,7,19
2020,3,15,4,11,9,20
2020,3,15,5,20,5,25
2020,3,15,6,17,15,32
2020,3,15,7,18,7,25
2020,3,15,8,29,22,51
2020,3,15,9,43,29,72
2020,3,15,10,74,49,123
2020,3,15,11,79,85,164
2020,3,15,12,99,100,199
2020,3,15,13,121,119,240
2020,3,15,14,106,140,246
2020,3,15,15,114,116,230
2020,3,15,16,103,94,197
2020,3,15,17,98,118,216
2020,3,15,18,104,105,209
2020,3,15,19,63,60,123
2020,3,15,20,59,66,125
2020,3,15,21,40,37,77
2020,3,15,22,13,18,31
2020,3,15,23,15,15,30
2020,3,16,0,7,10,17
2020,3,16,1,5,8,13
2020,3,16,2,3,2,5
2020,3,16,3,6,1,7
2020,3,16,4,22,5,27
2020,3,16,5,103,44,147
2020,3,16,6,176,86,262
2020,3,16,7,170,93,263
2020,3,16,8,132,85,217
2020,3,16,9,149,112,261
2020,3,16,10,139,130,269
2020,3,16,11,141,130,271
2020,3,16,12,158,151,309
2020,3,16,13,166,189,355
2020,3,16,14,155,161,316
2020,3,16,15,128,149,277
2020,3,16,16,140,116,256
2020,3,16,17,107,122,229
2020,3,16,18,89,73,162
2020,3,16,19,75,68,143
2020,3,16,20,50,61,111
2020,3,16,21,37,36,73
2020,3,16,22,18,17,35
2020,3,16,23,8,12,20
2020,3,17,0,8,5,13
2020,3,17,1,4,3,7
2020,3,17,2,3,1,4
2020,3,17,3,6,3,9
2020,3,17,4,8,5,13
2020,3,17,5,93,36,129
2020,3,17,6,155,87,242
2020,3,17,7,139,70,209
2020,3,17,8,129,81,210
2020,3,17,9,120,98,218
2020,3,17,10,146,105,251
2020,3,17,11,135,123,258
2020,3,17,12,149,136,285
2020,3,17,13,150,151,301
2020,3,17,14,154,156,310
2020,3,17,15,127,173,300
2020,3,17,16,120,109,229
2020,3,17,17,104,107,211
2020,3,17,18,83,93,176
2020,3,17,19,68,74,142
2020,3,17,20,50,59,109
2020,3,17,21,33,23,56
2020,3,17,22,20,15,35
2020,3,17,23,9,10,19
2020,3,18,0,7,3,10
2020,3,18,1,1,4,5
2020,3,18,2,7,6,13
2020,3,18,3,4,2,6
2020,3,18,4,9,7,16
2020,3,18,5,88,41,129
2020,3,18,6,144,78,222
2020,3,18,7,118,74,192
2020,3,18,8,123,91,214
2020,3,18,9,126,93,219
2020,3,18,10,131,105,236
2020,3,18,11,100,119,219
2020,3,18,12,139,109,248
2020,3,18,13,133,146,279
2020,3,18,14,132,150,282
2020,3,18,15,123,142,265
2020,3,18,16,103,102,205
2020,3,18,17,86,103,189
2020,3,18,18,77,101,178
2020,3,18,19,74,75,149
2020,3,18,20,41,50,91
2020,3,18,21,40,28,68
2020,3,18,22,19,13,32
2020,3,18,23,7,7,14
2020,3,19,0,7,5,12
2020,3,19,1,9,6,15
2020,3,19,2,13,4,17
2020,3,19,3,7,17,24
2020,3,19,4,15,5,20
2020,3,19,5,82,37,119
2020,3,19,6,145,71,216
2020,3,19,7,141,78,219
2020,3,19,8,108,80,188
2020,3,19,9,118,82,200
2020,3,19,10,107,102,209
2020,3,19,11,106,113,219
2020,3,19,12,154,148,302
2020,3,19,13,151,175,326
2020,3,19,14,139,176,315
2020,3,19,15,127,143,270
2020,3,19,16,109,111,220
2020,3,19,17,112,135,247
2020,3,19,18,86,95,181
2020,3,19,19,61,65,126
2020,3,19,20,45,46,91
2020,3,19,21,35,31,66
2020,3,19,22,22,27,49
2020,3,19,23,9,11,20
2020,3,20,0,9,11,20
2020,3,20,1,6,3,9
2020,3,20,2,12,7,19
2020,3,20,3,7,6,13
2020,3,20,4,14,4,18
2020,3,20,5,85,42,127
2020,3,20,6,139,67,206
2020,3,20,7,140,76,216
2020,3,20,8,114,81,195
2020,3,20,9,126,100,226
2020,3,20,10,138,121,259
2020,3,20,11,143,136,279
2020,3,20,12,136,139,275
2020,3,20,13,157,172,329
2020,3,20,14,191,161,352
2020,3,20,15,134,145,279
2020,3,20,16,110,119,229
2020,3,20,17,103,117,220
2020,3,20,18,74,102,176
2020,3,20,19,65,57,122
2020,3,20,20,45,66,111
2020,3,20,21,34,36,70
2020,3,20,22,29,20,49
2020,3,20,23,13,12,25
2020,3,21,0,15,14,29
2020,3,21,1,6,3,9
2020,3,21,2,4,3,7
2020,3,21,3,5,3,8
2020,3,21,4,6,4,10
2020,3,21,5,15,8,23
2020,3,21,6,27,16,43
2020,3,21,7,32,19,51
2020,3,21,8,38,41,79
2020,3,21,9,52,42,94
2020,3,21,10,60,82,142
2020,3,21,11,103,107,210
2020,3,21,12,109,133,242
2020,3,21,13,133,127,260
2020,3,21,14,112,119,231
2020,3,21,15,111,130,241
2020,3,21,16,102,109,211
2020,3,21,17,95,101,196
2020,3,21,18,61,72,133
2020,3,21,19,44,76,120
2020,3,21,20,51,55,106
2020,3,21,21,32,32,64
2020,3,21,22,22,28,50
2020,3,21,23,14,14,28
2020,3,22,0,18,21,39
2020,3,22,1,16,6,22
2020,3,22,2,9,9,18
2020,3,22,3,3,7,10
2020,3,22,4,7,7,14
2020,3,22,5,15,7,22
2020,3,22,6,10,15,25
2020,3,22,7,9,9,18
2020,3,22,8,16,14,30
2020,3,22,9,32,33,65
2020,3,22,10,45,50,95
2020,3,22,11,69,75,144
2020,3,22,12,88,120,208
2020,3,22,13,102,106,208
2020,3,22,14,95,127,222
2020,3,22,15,93,112,205
2020,3,22,16,107,103,210
2020,3,22,17,75,96,171
2020,3,22,18,77,88,165
2020,3,22,19,68,59,127
2020,3,22,20,45,60,105
2020,3,22,21,28,39,67
2020,3,22,22,10,25,35
2020,3,22,23,5,11,16
2020,3,23,0,8,5,13
2020,3,23,1,6,5,11
2020,3,23,2,7,0,7
2020,3,23,3,3,1,4
2020,3,23,4,7,4,11
2020,3,23,5,86,41,127
2020,3,23,6,135,72,207
2020,3,23,7,139,67,206
2020,3,23,8,117,77,194
2020,3,23,9,133,95,228
2020,3,23,10,119,112,231
2020,3,23,11,131,113,244
2020,3,23,12,130,121,251
2020,3,23,13,154,158,312
2020,3,23,14,164,155,319
2020,3,23,15,115,119,234
2020,3,23,16,102,109,211
2020,3,23,17,103,83,186
2020,3,23,18,76,96,172
2020,3,23,19,68,68,136
2020,3,23,20,53,56,109
2020,3,23,21,39,108,147
2020,3,23,22,22,54,76
2020,3,23,23,12,30,42
2020,3,24,0,6,15,21
2020,3,24,1,4,8,12
2020,3,24,2,4,9,13
2020,3,24,3,4,17,21
2020,3,24,4,10,20,30
2020,3,24,5,92,35,127
2020,3,24,6,156,82,238
2020,3,24,7,133,68,201
2020,3,24,8,116,64,180
2020,3,24,9,116,102,218
2020,3,24,10,129,116,245
2020,3,24,11,124,118,242
2020,3,24,12,120,145,265
2020,3,24,13,175,145,320
2020,3,24,14,165,162,327
2020,3,24,15,117,158,275
2020,3,24,16,108,91,199
2020,3,24,17,76,97,173
2020,3,24,18,75,66,141
2020,3,24,19,54,61,115
2020,3,24,20,48,53,101
2020,3,24,21,44,31,75
2020,3,24,22,19,20,39
2020,3,24,23,5,10,15
2020,3,25,0,10,4,14
2020,3,25,1,7,5,12
2020,3,25,2,20,3,23
2020,3,25,3,9,2,11
2020,3,25,4,19,2,21
2020,3,25,5,81,35,116
2020,3,25,6,165,75,240
2020,3,25,7,145,81,226
2020,3,25,8,104,92,196
2020,3,25,9,125,89,214
2020,3,25,10,113,94,207
2020,3,25,11,115,103,218
2020,3,25,12,140,112,252
2020,3,25,13,140,131,271
2020,3,25,14,151,161,312
2020,3,25,15,104,144,248
2020,3,25,16,124,109,233
2020,3,25,17,88,96,184
2020,3,25,18,93,77,170
2020,3,25,19,59,62,121
2020,3,25,20,47,54,101
2020,3,25,21,44,78,122
2020,3,25,22,19,55,74
2020,3,25,23,12,21,33
2020,3,26,0,9,16,25
2020,3,26,1,6,11,17
2020,3,26,2,8,13,21
2020,3,26,3,9,10,19
2020,3,26,4,12,13,25
2020,3,26,5,80,39,119
2020,3,26,6,146,79,225
2020,3,26,7,136,84,220
2020,3,26,8,120,77,197
2020,3,26,9,119,100,219
2020,3,26,10,132,119,251
2020,3,26,11,139,111,250
2020,3,26,12,141,125,266
2020,3,26,13,173,149,322
2020,3,26,14,167,169,336
2020,3,26,15,137,145,282
2020,3,26,16,109,130,239
2020,3,26,17,107,99,206
2020,3,26,18,85,84,169
2020,3,26,19,67,61,128
2020,3,26,20,38,56,94
2020,3,26,21,38,30,68
2020,3,26,22,23,22,45
2020,3,26,23,13,14,27
2020,3,27,0,7,14,21
2020,3,27,1,9,4,13
2020,3,27,2,3,2,5
2020,3,27,3,8,1,9
2020,3,27,4,8,8,16
2020,3,27,5,82,38,120
2020,3,27,6,152,87,239
2020,3,27,7,133,77,210
2020,3,27,8,136,92,228
2020,3,27,9,111,85,196
2020,3,27,10,127,114,241
2020,3,27,11,145,134,279
2020,3,27,12,144,150,294
2020,3,27,13,175,164,339
2020,3,27,14,186,162,348
2020,3,27,15,152,169,321
2020,3,27,16,117,112,229
2020,3,27,17,111,109,220
2020,3,27,18,79,98,177
2020,3,27,19,69,61,130
2020,3,27,20,48,67,115
2020,3,27,21,33,37,70
2020,3,27,22,27,31,58
2020,3,27,23,16,23,39
2020,3,28,0,4,10,14
2020,3,28,1,11,11,22
2020,3,28,2,9,7,16
2020,3,28,3,5,7,12
2020,3,28,4,8,6,14
2020,3,28,5,21,20,41
2020,3,28,6,33,21,54
2020,3,28,7,29,30,59
2020,3,28,8,30,36,66
2020,3,28,9,65,44,109
2020,3,28,10,85,79,164
2020,3,28,11,97,108,205
2020,3,28,12,96,129,225
2020,3,28,13,121,155,276
2020,3,28,14,135,150,285
2020,3,28,15,122,134,256
2020,3,28,16,133,121,254
2020,3,28,17,105,81,186
2020,3,28,18,85,86,171
2020,3,28,19,57,59,116
2020,3,28,20,47,42,89
2020,3,28,21,36,40,76
2020,3,28,22,24,26,50
2020,3,28,23,18,17,35
2020,3,29,0,11,12,23
2020,3,29,1,6,6,12
2020,3,29,2,8,3,11
2020,3,29,3,7,9,16
2020,3,29,4,20,10,30
2020,3,29,5,8,12,20
2020,3,29,6,12,9,21
2020,3,29,7,16,15,31
2020,3,29,8,26,26,52
2020,3,29,9,38,31,69
2020,3,29,10,66,62,128
2020,3,29,11,72,64,136
2020,3,29,12,80,84,164
2020,3,29,13,92,105,197
2020,3,29,14,98,106,204
2020,3,29,15,88,108,196
2020,3,29,16,85,91,176
2020,3,29,17,89,69,158
2020,3,29,18,71,74,145
2020,3,29,19,66,63,129
2020,3,29,20,30,35,65
2020,3,29,21,22,23,45
2020,3,29,22,12,12,24
2020,3,29,23,6,10,16
2020,3,30,0,13,10,23
2020,3,30,1,7,4,11
2020,3,30,2,7,3,10
2020,3,30,3,14,7,21
2020,3,30,4,73,37,110
2020,3,30,5,146,90,236
2020,3,30,6,164,80,244
2020,3,30,7,135,94,229
2020,3,30,8,132,104,236
2020,3,30,9,159,135,294
2020,3,30,10,155,141,296
2020,3,30,11,143,143,286
2020,3,30,12,165,153,318
2020,3,30,13,193,203,396
2020,3,30,14,159,170,329
2020,3,30,15,116,122,238
2020,3,30,16,128,111,239
2020,3,30,17,93,108,201
2020,3,30,18,80,93,173
2020,3,30,19,61,60,121
2020,3,30,20,47,58,105
2020,3,30,21,11,22,33
2020,3,30,22,12,12,24
2020,3,30,23,9,7,16
2020,3,31,0,4,6,10
2020,3,31,1,5,3,8
2020,3,31,2,5,3,8
2020,3,31,3,14,3,17
2020,3,31,4,83,34,117
2020,3,31,5,165,83,248
2020,3,31,6,158,86,244
2020,3,31,7,122,93,215
2020,3,31,8,124,94,218
2020,3,31,9,130,111,241
2020,3,31,10,152,113,265
2020,3,31,11,135,140,275
2020,3,31,12,172,172,344
2020,3,31,13,166,179,345
2020,3,31,14,124,162,286
2020,3,31,15,90,99,189
2020,3,31,16,110,91,201
2020,3,31,17,94,105,199
2020,3,31,18,62,67,129
2020,3,31,19,55,58,113
2020,3,31,20,37,34,71
2020,3,31,21,20,22,42
2020,3,31,22,10,20,30
2020,3,31,23,10,4,14
2020,4,1,0,5,5,10
2020,4,1,1,10,5,15
2020,4,1,2,3,3,6
2020,4,1,3,8,7,15
2020,4,1,4,90,36,126
2020,4,1,5,148,93,241
2020,4,1,6,132,94,226
2020,4,1,7,130,89,219
2020,4,1,8,120,89,209
2020,4,1,9,137,110,247
2020,4,1,10,139,112,251
2020,4,1,11,150,142,292
2020,4,1,12,151,156,307
2020,4,1,13,194,169,363
2020,4,1,14,131,151,282
2020,4,1,15,108,109,217
2020,4,1,16,114,118,232
2020,4,1,17,88,98,186
2020,4,1,18,78,82,160
2020,4,1,19,46,55,101
2020,4,1,20,45,37,82
2020,4,1,21,21,18,39
2020,4,1,22,14,13,27
2020,4,1,23,10,16,26
2020,4,2,0,4,4,8
2020,4,2,1,5,3,8
2020,4,2,2,6,4,10
2020,4,2,3,10,5,15
2020,4,2,4,91,42,133
2020,4,2,5,146,85,231
2020,4,2,6,151,93,244
2020,4,2,7,119,81,200
2020,4,2,8,134,94,228
2020,4,2,9,119,122,241
2020,4,2,10,121,103,224
2020,4,2,11,143,138,281
2020,4,2,12,170,158,328
2020,4,2,13,195,190,385
2020,4,2,14,132,138,270
2020,4,2,15,107,119,226
2020,4,2,16,93,103,196
2020,4,2,17,97,96,193
2020,4,2,18,60,76,136
2020,4,2,19,62,62,124
2020,4,2,20,46,115,161
2020,4,2,21,24,77,101
2020,4,2,22,13,48,61
2020,4,2,23,10,21,31
2020,4,3,0,15,6,21
2020,4,3,1,23,5,28
2020,4,3,2,11,6,17
2020,4,3,3,20,5,25
2020,4,3,4,90,42,132
2020,4,3,5,174,74,248
2020,4,3,6,139,90,229
2020,4,3,7,124,95,219
2020,4,3,8,115,87,202
2020,4,3,9,144,102,246
2020,4,3,10,156,153,309
2020,4,3,11,165,161,326
2020,4,3,12,155,176,331
2020,4,3,13,200,187,387
2020,4,3,14,122,175,297
2020,4,3,15,107,106,213
2020,4,3,16,111,107,218
2020,4,3,17,92,99,191
2020,4,3,18,70,75,145
2020,4,3,19,55,66,121
2020,4,3,20,41,45,86
2020,4,3,21,24,23,47
2020,4,3,22,13,15,28
2020,4,3,23,21,16,37
2020,4,4,0,11,8,19
2020,4,4,1,10,6,16
2020,4,4,2,14,5,19
2020,4,4,3,5,3,8
2020,4,4,4,27,15,42
2020,4,4,5,22,16,38
2020,4,4,6,25,27,52
2020,4,4,7,28,31,59
2020,4,4,8,64,45,109
2020,4,4,9,77,67,144
2020,4,4,10,116,111,227
2020,4,4,11,105,125,230
2020,4,4,12,136,156,292
2020,4,4,13,117,131,248
2020,4,4,14,102,119,221
2020,4,4,15,91,118,209
2020,4,4,16,116,100,216
2020,4,4,17,69,85,154
2020,4,4,18,57,58,115
2020,4,4,19,48,42,90
2020,4,4,20,39,33,72
2020,4,4,21,26,43,69
2020,4,4,22,16,14,30
2020,4,4,23,14,14,28
2020,4,5,0,14,7,21
2020,4,5,1,3,10,13
2020,4,5,2,3,5,8
2020,4,5,3,6,5,11
2020,4,5,4,17,5,22
2020,4,5,5,12,15,27
2020,4,5,6,20,13,33
2020,4,5,7,18,18,36
2020,4,5,8,33,16,49
2020,4,5,9,56,58,114
2020,4,5,10,75,68,143
2020,4,5,11,119,121,240
2020,4,5,12,115,117,232
2020,4,5,13,124,110,234
2020,4,5,14,104,149,253
2020,4,5,15,95,127,222
2020,4,5,16,117,114,231
2020,4,5,17,113,129,242
2020,4,5,18,85,114,199
2020,4,5,19,80,90,170
2020,4,5,20,36,49,85
2020,4,5,21,21,30,51
2020,4,5,22,9,10,19
2020,4,5,23,7,7,14
2020,4,6,0,4,5,9
2020,4,6,1,11,7,18
2020,4,6,2,7,4,11
2020,4,6,3,16,7,23
2020,4,6,4,84,31,115
2020,4,6,5,145,83,228
2020,4,6,6,131,76,207
2020,4,6,7,121,85,206
2020,4,6,8,142,124,266
2020,4,6,9,137,154,291
2020,4,6,10,184,144,328
2020,4,6,11,173,188,361
2020,4,6,12,183,212,395
2020,4,6,13,184,190,374
2020,4,6,14,132,140,272
2020,4,6,15,107,113,220
2020,4,6,16,95,91,186
2020,4,6,17,67,73,140
2020,4,6,18,62,69,131
2020,4,6,19,56,58,114
2020,4,6,20,43,40,83
2020,4,6,21,21,28,49
2020,4,6,22,7,12,19
2020,4,6,23,5,13,18
2020,4,7,0,7,5,12
2020,4,7,1,8,4,12
2020,4,7,2,5,4,9
2020,4,7,3,12,7,19
2020,4,7,4,82,34,116
2020,4,7,5,132,75,207
2020,4,7,6,124,77,201
2020,4,7,7,126,100,226
2020,4,7,8,157,107,264
2020,4,7,9,146,118,264
2020,4,7,10,164,154,318
2020,4,7,11,185,154,339
2020,4,7,12,168,200,368
2020,4,7,13,217,175,392
2020,4,7,14,146,200,346
2020,4,7,15,118,143,261
2020,4,7,16,119,120,239
2020,4,7,17,106,112,218
2020,4,7,18,86,76,162
2020,4,7,19,64,73,137
2020,4,7,20,53,42,95
2020,4,7,21,19,34,53
2020,4,7,22,13,16,29
2020,4,7,23,9,13,22
2020,4,8,0,11,6,17
2020,4,8,1,10,5,15
2020,4,8,2,6,4,10
2020,4,8,3,13,5,18
2020,4,8,4,73,31,104
2020,4,8,5,114,54,168
2020,4,8,6,96,73,169
2020,4,8,7,106,75,181
2020,4,8,8,124,88,212
2020,4,8,9,156,143,299
2020,4,8,10,183,159,342
2020,4,8,11,167,181,348
2020,4,8,12,167,174,341
2020,4,8,13,165,152,317
2020,4,8,14,122,128,250
2020,4,8,15,116,106,222
2020,4,8,16,112,114,226
2020,4,8,17,101,82,183
2020,4,8,18,76,80,156
2020,4,8,19,61,57,118
2020,4,8,20,44,38,82
2020,4,8,21,27,23,50
2020,4,8,22,14,18,32
2020,4,8,23,9,11,20
2020,4,9,0,6,8,14
2020,4,9,1,7,2,9
2020,4,9,2,1,4,5
2020,4,9,3,5,2,7
2020,4,9,4,19,9,28
2020,4,9,5,16,18,34
2020,4,9,6,24,19,43
2020,4,9,7,29,19,48
2020,4,9,8,43,31,74
2020,4,9,9,70,59,129
2020,4,9,10,83,93,176
2020,4,9,11,95,109,204
2020,4,9,12,107,131,238
2020,4,9,13,108,144,252
2020,4,9,14,110,128,238
2020,4,9,15,82,106,188
2020,4,9,16,83,90,173
2020,4,9,17,97,77,174
2020,4,9,18,82,71,153
2020,4,9,19,50,70,120
2020,4,9,20,42,43,85
2020,4,9,21,20,33,53
2020,4,9,22,15,16,31
2020,4,9,23,8,9,17
2020,4,10,0,7,10,17
2020,4,10,1,5,3,8
2020,4,10,2,4,3,7
2020,4,10,3,3,5,8
2020,4,10,4,15,5,20
2020,4,10,5,12,26,38
2020,4,10,6,16,16,32
2020,4,10,7,33,41,74
2020,4,10,8,54,41,95
2020,4,10,9,62,65,127
2020,4,10,10,95,85,180
2020,4,10,11,109,115,224
2020,4,10,12,115,143,258
2020,4,10,13,124,148,272
2020,4,10,14,117,140,257
2020,4,10,15,111,118,229
2020,4,10,16,112,117,229
2020,4,10,17,98,97,195
2020,4,10,18,71,79,150
2020,4,10,19,52,63,115
2020,4,10,20,27,34,61
2020,4,10,21,26,25,51
2020,4,10,22,21,20,41
2020,4,10,23,12,14,26
2020,4,11,0,4,4,8
2020,4,11,1,6,3,9
2020,4,11,2,6,3,9
2020,4,11,3,4,12,16
2020,4,11,4,27,13,40
2020,4,11,5,16,23,39
2020,4,11,6,17,19,36
2020,4,11,7,29,22,51
2020,4,11,8,48,48,96
2020,4,11,9,87,70,157
2020,4,11,10,116,111,227
2020,4,11,11,125,140,265
2020,4,11,12,122,116,238
2020,4,11,13,114,132,246
2020,4,11,14,117,118,235
2020,4,11,15,85,109,194
2020,4,11,16,78,77,155
2020,4,11,17,69,65,134
2020,4,11,18,51,53,104
2020,4,11,19,53,56,109
2020,4,11,20,38,42,80
2020,4,11,21,32,33,65
2020,4,11,22,21,26,47
2020,4,11,23,20,12,32
2020,4,12,0,2,9,11
2020,4,12,1,13,8,21
2020,4,12,2,10,5,15
2020,4,12,3,2,3,5
2020,4,12,4,22,7,29
2020,4,12,5,22,14,36
2020,4,12,6,14,16,30
2020,4,12,7,15,14,29
2020,4,12,8,25,20,45
2020,4,12,9,46,29,75
2020,4,12,10,46,62,108
2020,4,12,11,86,86,172
2020,4,12,12,106,140,246
2020,4,12,13,114,134,248
2020,4,12,14,106,140,246
2020,4,12,15,91,132,223
2020,4,12,16,107,104,211
2020,4,12,17,85,90,175
2020,4,12,18,77,94,171
2020,4,12,19,69,66,135
2020,4,12,20,37,48,85
2020,4,12,21,18,28,46
2020,4,12,22,16,19,35
2020,4,12,23,10,11,21
2020,4,13,0,9,8,17
2020,4,13,1,7,7,14
2020,4,13,2,5,8,13
2020,4,13,3,7,3,10
2020,4,13,4,15,3,18
2020,4,13,5,18,16,34
2020,4,13,6,14,7,21
2020,4,13,7,25,21,46
2020,4,13,8,40,42,82
2020,4,13,9,54,57,111
2020,4,13,10,90,80,170
2020,4,13,11,102,117,219
2020,4,13,12,126,134,260
2020,4,13,13,124,141,265
2020,4,13,14,124,122,246
2020,4,13,15,99,119,218
2020,4,13,16,116,118,234
2020,4,13,17,92,139,231
2020,4,13,18,99,88,187
2020,4,13,19,69,79,148
2020,4,13,20,44,47,91
2020,4,13,21,23,25,48
2020,4,13,22,7,17,24
2020,4,13,23,13,8,21
2020,4,14,0,6,6,12
2020,4,14,1,7,5,12
2020,4,14,2,5,1,6
2020,4,14,3,11,9,20
2020,4,14,4,99,40,139
2020,4,14,5,160,102,262
2020,4,14,6,149,89,238
2020,4,14,7,131,97,228
2020,4,14,8,125,89,214
2020,4,14,9,117,92,209
2020,4,14,10,144,134,278
2020,4,14,11,151,150,301
2020,4,14,12,178,149,327
2020,4,14,13,183,191,374
2020,4,14,14,155,168,323
2020,4,14,15,140,122,262
2020,4,14,16,112,116,228
2020,4,14,17,81,89,170
2020,4,14,18,75,82,157
2020,4,14,19,51,49,100
2020,4,14,20,32,43,75
2020,4,14,21,34,20,54
2020,4,14,22,11,9,20
2020,4,14,23,13,9,22
2020,4,15,0,12,4,16
2020,4,15,1,20,2,22
2020,4,15,2,8,7,15
2020,4,15,3,8,8,16
2020,4,15,4,92,40,132
2020,4,15,5,172,101,273
2020,4,15,6,173,89,262
2020,4,15,7,123,83,206
2020,4,15,8,135,95,230
2020,4,15,9,139,115,254
2020,4,15,10,162,116,278
2020,4,15,11,146,126,272
2020,4,15,12,174,166,340
2020,4,15,13,185,188,373
2020,4,15,14,169,164,333
2020,4,15,15,122,129,251
2020,4,15,16,91,114,205
2020,4,15,17,75,94,169
2020,4,15,18,90,92,182
2020,4,15,19,70,45,115
2020,4,15,20,34,53,87
2020,4,15,21,26,23,49
2020,4,15,22,12,13,25
2020,4,15,23,16,7,23
2020,4,16,0,2,7,9
2020,4,16,1,9,4,13
2020,4,16,2,4,2,6
2020,4,16,3,11,7,18
2020,4,16,4,85,44,129
2020,4,16,5,157,83,240
2020,4,16,6,164,77,241
2020,4,16,7,146,87,233
2020,4,16,8,139,116,255
2020,4,16,9,145,131,276
2020,4,16,10,138,125,263
2020,4,16,11,169,132,301
2020,4,16,12,191,166,357
2020,4,16,13,181,172,353
2020,4,16,14,165,177,342
2020,4,16,15,124,135,259
2020,4,16,16,115,108,223
2020,4,16,17,122,122,244
2020,4,16,18,86,83,169
2020,4,16,19,74,71,145
2020,4,16,20,42,37,79
2020,4,16,21,19,26,45
2020,4,16,22,7,17,24
2020,4,16,23,8,6,14
2020,4,17,0,6,8,14
2020,4,17,1,5,5,10
2020,4,17,2,5,4,9
2020,4,17,3,9,5,14
2020,4,17,4,94,50,144
2020,4,17,5,168,80,248
2020,4,17,6,160,91,251
2020,4,17,7,131,91,222
2020,4,17,8,157,104,261
2020,4,17,9,147,134,281
2020,4,17,10,176,166,342
2020,4,17,11,182,171,353
2020,4,17,12,198,204,402
2020,4,17,13,213,205,418
2020,4,17,14,156,192,348
2020,4,17,15,132,150,282
2020,4,17,16,116,109,225
2020,4,17,17,105,103,208
2020,4,17,18,56,97,153
2020,4,17,19,75,81,156
2020,4,17,20,40,44,84
2020,4,17,21,28,41,69
2020,4,17,22,24,13,37
2020,4,17,23,19,21,40
2020,4,18,0,11,5,16
2020,4,18,1,10,7,17
2020,4,18,2,4,5,9
2020,4,18,3,4,7,11
2020,4,18,4,24,11,35
2020,4,18,5,28,12,40
2020,4,18,6,27,13,40
2020,4,18,7,28,37,65
2020,4,18,8,63,57,120
2020,4,18,9,97,80,177
2020,4,18,10,134,107,241
2020,4,18,11,104,125,229
2020,4,18,12,136,142,278
2020,4,18,13,118,131,249
2020,4,18,14,114,123,237
2020,4,18,15,110,140,250
2020,4,18,16,104,113,217
2020,4,18,17,85,95,180
2020,4,18,18,86,106,192
2020,4,18,19,54,77,131
2020,4,18,20,36,64,100
2020,4,18,21,28,39,67
2020,4,18,22,26,39,65
2020,4,18,23,25,31,56
2020,4,19,0,10,6,16
2020,4,19,1,10,4,14
2020,4,19,2,5,4,9
2020,4,19,3,10,0,10
2020,4,19,4,16,10,26
2020,4,19,5,14,19,33
2020,4,19,6,23,8,31
2020,4,19,7,31,32,63
2020,4,19,8,45,37,82
2020,4,19,9,76,59,135
2020,4,19,10,105,97,202
2020,4,19,11,131,128,259
2020,4,19,12,142,134,276
2020,4,19,13,119,138,257
2020,4,19,14,116,133,249
2020,4,19,15,113,126,239
2020,4,19,16,139,136,275
2020,4,19,17,97,108,205
2020,4,19,18,105,112,217
2020,4,19,19,84,93,177
2020,4,19,20,54,45,99
2020,4,19,21,29,30,59
2020,4,19,22,13,10,23
2020,4,19,23,9,7,16
2020,4,20,0,9,2,11
2020,4,20,1,7,7,14
2020,4,20,2,11,6,17
2020,4,20,3,14,1,15
2020,4,20,4,99,35,134
2020,4,20,5,169,84,253
2020,4,20,6,187,96,283
2020,4,20,7,156,98,254
2020,4,20,8,144,120,264
2020,4,20,9,155,131,286
2020,4,20,10,141,134,275
2020,4,20,11,153,141,294
2020,4,20,12,181,179,360
2020,4,20,13,182,191,373
2020,4,20,14,162,175,337
2020,4,20,15,102,112,214
2020,4,20,16,111,156,267
2020,4,20,17,131,126,257
2020,4,20,18,66,104,170
2020,4,20,19,70,79,149
2020,4,20,20,44,41,85
2020,4,20,21,28,19,47
2020,4,20,22,11,10,21
2020,4,20,23,5,9,14
2020,4,21,0,6,3,9
2020,4,21,1,6,4,10
2020,4,21,2,7,2,9
2020,4,21,3,15,5,20
2020,4,21,4,84,46,130
2020,4,21,5,181,88,269
2020,4,21,6,169,84,253
2020,4,21,7,147,118,265
2020,4,21,8,177,92,269
2020,4,21,9,156,145,301
2020,4,21,10,164,136,300
2020,4,21,11,159,148,307
2020,4,21,12,200,238,438
2020,4,21,13,226,232,458
2020,4,21,14,149,159,308
2020,4,21,15,130,107,237
2020,4,21,16,101,117,218
2020,4,21,17,107,108,215
2020,4,21,18,96,113,209
2020,4,21,19,84,90,174
2020,4,21,20,52,51,103
2020,4,21,21,27,30,57
2020,4,21,22,6,16,22
2020,4,21,23,10,11,21
2020,4,22,0,7,7,14
2020,4,22,1,15,5,20
2020,4,22,2,10,4,14
2020,4,22,3,11,8,19
2020,4,22,4,77,45,122
2020,4,22,5,153,86,239
2020,4,22,6,153,79,232
2020,4,22,7,167,95,262
2020,4,22,8,146,118,264
2020,4,22,9,151,134,285
2020,4,22,10,149,118,267
2020,4,22,11,154,141,295
2020,4,22,12,177,198,375
2020,4,22,13,226,204,430
2020,4,22,14,158,176,334
2020,4,22,15,127,142,269
2020,4,22,16,114,105,219
2020,4,22,17,105,109,214
2020,4,22,18,100,108,208
2020,4,22,19,77,98,175
2020,4,22,20,58,261,319
2020,4,22,21,31,105,136
2020,4,22,22,13,46,59
2020,4,22,23,7,25,32
2020,4,23,0,8,16,24
2020,4,23,1,7,17,24
2020,4,23,2,7,11,18
2020,4,23,3,15,14,29
2020,4,23,4,78,32,110
2020,4,23,5,156,89,245
2020,4,23,6,189,90,279
2020,4,23,7,143,84,227
2020,4,23,8,148,115,263
2020,4,23,9,145,137,282
2020,4,23,10,172,145,317
2020,4,23,11,139,134,273
2020,4,23,12,191,197,388
2020,4,23,13,215,195,410
2020,4,23,14,148,180,328
2020,4,23,15,135,133,268
2020,4,23,16,132,123,255
2020,4,23,17,123,125,248
2020,4,23,18,94,90,184
2020,4,23,19,69,69,138
2020,4,23,20,45,53,98
2020,4,23,21,20,24,44
2020,4,23,22,13,19,32
2020,4,23,23,7,8,15
2020,4,24,0,6,8,14
2020,4,24,1,9,5,14
2020,4,24,2,15,9,24
2020,4,24,3,15,7,22
2020,4,24,4,88,36,124
2020,4,24,5,150,92,242
2020,4,24,6,167,79,246
2020,4,24,7,142,94,236
2020,4,24,8,142,95,237
2020,4,24,9,150,141,291
2020,4,24,10,162,141,303
2020,4,24,11,182,147,329
2020,4,24,12,215,197,412
2020,4,24,13,209,191,400
2020,4,24,14,146,158,304
2020,4,24,15,130,153,283
2020,4,24,16,129,127,256
2020,4,24,17,89,94,183
2020,4,24,18,64,90,154
2020,4,24,19,56,80,136
2020,4,24,20,48,56,104
2020,4,24,21,34,29,63
2020,4,24,22,14,18,32
2020,4,24,23,15,19,34
2020,4,25,0,10,9,19
2020,4,25,1,7,5,12
2020,4,25,2,4,7,11
2020,4,25,3,8,5,13
2020,4,25,4,19,11,30
2020,4,25,5,23,19,42
2020,4,25,6,32,37,69
2020,4,25,7,32,36,68
2020,4,25,8,71,58,129
2020,4,25,9,83,67,150
2020,4,25,10,105,97,202
2020,4,25,11,95,104,199
2020,4,25,12,128,116,244
2020,4,25,13,115,120,235
2020,4,25,14,125,145,270
2020,4,25,15,80,110,190
2020,4,25,16,82,110,192
2020,4,25,17,70,95,165
2020,4,25,18,65,79,144
2020,4,25,19,56,64,120
2020,4,25,20,41,51,92
2020,4,25,21,30,37,67
2020,4,25,22,32,30,62
2020,4,25,23,20,24,44
2020,4,26,0,8,9,17
2020,4,26,1,9,7,16
2020,4,26,2,11,4,15
2020,4,26,3,7,9,16
2020,4,26,4,18,8,26
2020,4,26,5,14,14,28
2020,4,26,6,21,15,36
2020,4,26,7,24,18,42
2020,4,26,8,38,29,67
2020,4,26,9,52,46,98
2020,4,26,10,68,86,154
2020,4,26,11,105,107,212
2020,4,26,12,113,131,244
2020,4,26,13,128,121,249
2020,4,26,14,121,121,242
2020,4,26,15,112,98,210
2020,4,26,16,123,110,233
2020,4,26,17,105,112,217
2020,4,26,18,94,88,182
2020,4,26,19,56,90,146
2020,4,26,20,42,44,86
2020,4,26,21,20,25,45
2020,4,26,22,8,10,18
2020,4,26,23,5,7,12
2020,4,27,0,9,4,13
2020,4,27,1,9,3,12
2020,4,27,2,6,5,11
2020,4,27,3,17,9,26
2020,4,27,4,94,46,140
2020,4,27,5,178,93,271
2020,4,27,6,234,114,348
2020,4,27,7,186,126,312
2020,4,27,8,187,114,301
2020,4,27,9,157,128,285
2020,4,27,10,172,143,315
2020,4,27,11,167,146,313
2020,4,27,12,205,193,398
2020,4,27,13,236,220,456
2020,4,27,14,165,193,358
2020,4,27,15,134,135,269
2020,4,27,16,112,123,235
2020,4,27,17,99,110,209
2020,4,27,18,76,101,177
2020,4,27,19,72,68,140
2020,4,27,20,50,143,193
2020,4,27,21,25,79,104
2020,4,27,22,10,33,43
2020,4,27,23,7,24,31
2020,4,28,0,7,16,23
2020,4,28,1,5,19,24
2020,4,28,2,5,9,14
2020,4,28,3,21,30,51
2020,4,28,4,86,46,132
2020,4,28,5,171,98,269
2020,4,28,6,237,113,350
2020,4,28,7,161,114,275
2020,4,28,8,186,120,306
2020,4,28,9,194,153,347
2020,4,28,10,180,133,313
2020,4,28,11,187,184,371
2020,4,28,12,211,204,415
2020,4,28,13,211,227,438
2020,4,28,14,172,192,364
2020,4,28,15,148,133,281
2020,4,28,16,124,121,245
2020,4,28,17,103,105,208
2020,4,28,18,97,98,195
2020,4,28,19,71,83,154
2020,4,28,20,52,48,100
2020,4,28,21,34,27,61
2020,4,28,22,11,12,23
2020,4,28,23,10,13,23
2020,4,29,0,7,0,7
2020,4,29,1,6,6,12
2020,4,29,2,8,3,11
2020,4,29,3,12,10,22
2020,4,29,4,99,36,135
2020,4,29,5,178,99,277
2020,4,29,6,231,133,364
2020,4,29,7,169,100,269
2020,4,29,8,171,118,289
2020,4,29,9,187,129,316
2020,4,29,10,187,160,347
2020,4,29,11,209,201,410
2020,4,29,12,183,212,395
2020,4,29,13,217,241,458
2020,4,29,14,170,188,358
2020,4,29,15,142,167,309
2020,4,29,16,118,112,230
2020,4,29,17,100,123,223
2020,4,29,18,107,101,208
2020,4,29,19,76,88,164
2020,4,29,20,43,63,106
2020,4,29,21,22,25,47
2020,4,29,22,19,12,31
2020,4,29,23,11,8,19
2020,4,30,0,1,3,4
2020,4,30,1,7,1,8
2020,4,30,2,11,10,21
2020,4,30,3,10,8,18
2020,4,30,4,94,44,138
2020,4,30,5,176,102,278
2020,4,30,6,218,117,335
2020,4,30,7,179,107,286
2020,4,30,8,177,148,325
2020,4,30,9,205,154,359
2020,4,30,10,185,159,344
2020,4,30,11,206,168,374
2020,4,30,12,211,211,422
2020,4,30,13,271,249,520
2020,4,30,14,229,160,389
2020,4,30,15,147,145,292
2020,4,30,16,118,128,246
2020,4,30,17,113,116,229
2020,4,30,18,90,92,182
2020,4,30,19,75,66,141
2020,4,30,20,34,57,91
2020,4,30,21,25,47,72
2020,4,30,22,15,18,33
2020,4,30,23,15,17,32
2020,5,1,0,11,17,28
2020,5,1,1,8,7,15
2020,5,1,2,5,5,10
2020,5,1,3,3,8,11
2020,5,1,4,24,11,35
2020,5,1,5,27,15,42
2020,5,1,6,31,26,57
2020,5,1,7,42,35,77
2020,5,1,8,55,49,104
2020,5,1,9,82,72,154
2020,5,1,10,88,94,182
2020,5,1,11,107,117,224
2020,5,1,12,108,132,240
2020,5,1,13,131,135,266
2020,5,1,14,114,120,234
2020,5,1,15,113,127,240
2020,5,1,16,102,107,209
2020,5,1,17,101,93,194
2020,5,1,18,76,95,171
2020,5,1,19,48,54,102
2020,5,1,20,44,45,89
2020,5,1,21,29,45,74
2020,5,1,22,25,21,46
2020,5,1,23,22,22,44
2020,5,2,0,16,21,37
2020,5,2,1,13,9,22
2020,5,2,2,1,7,8
2020,5,2,3,9,7,16
2020,5,2,4,20,9,29
2020,5,2,5,26,26,52
2020,5,2,6,24,21,45
2020,5,2,7,39,27,66
2020,5,2,8,71,58,129
2020,5,2,9,82,70,152
2020,5,2,10,110,99,209
2020,5,2,11,115,112,227
2020,5,2,12,112,134,246
2020,5,2,13,125,153,278
2020,5,2,14,134,119,253
2020,5,2,15,86,121,207
2020,5,2,16,113,94,207
2020,5,2,17,77,91,168
2020,5,2,18,65,85,150
2020,5,2,19,48,76,124
2020,5,2,20,38,65,103
2020,5,2,21,45,40,85
2020,5,2,22,21,32,53
2020,5,2,23,18,21,39
2020,5,3,0,10,17,27
2020,5,3,1,14,16,30
2020,5,3,2,9,12,21
2020,5,3,3,6,3,9
2020,5,3,4,21,7,28
2020,5,3,5,8,11,19
2020,5,3,6,13,13,26
2020,5,3,7,20,13,33
2020,5,3,8,47,30,77
2020,5,3,9,59,47,106
2020,5,3,10,78,82,160
2020,5,3,11,106,123,229
2020,5,3,12,124,124,248
2020,5,3,13,114,152,266
2020,5,3,14,134,134,268
2020,5,3,15,114,144,258
2020,5,3,16,127,128,255
2020,5,3,17,118,136,254
2020,5,3,18,107,110,217
2020,5,3,19,99,85,184
2020,5,3,20,53,54,107
2020,5,3,21,35,34,69
2020,5,3,22,25,19,44
2020,5,3,23,7,16,23
2020,5,4,0,7,6,13
2020,5,4,1,8,5,13
2020,5,4,2,9,5,14
2020,5,4,3,20,4,24
2020,5,4,4,96,55,151
2020,5,4,5,171,102,273
2020,5,4,6,277,122,399
2020,5,4,7,164,123,287
2020,5,4,8,180,160,340
2020,5,4,9,178,148,326
2020,5,4,10,161,163,324
2020,5,4,11,186,163,349
2020,5,4,12,214,226,440
2020,5,4,13,217,244,461
2020,5,4,14,180,166,346
2020,5,4,15,133,142,275
2020,5,4,16,121,101,222
2020,5,4,17,133,131,264
2020,5,4,18,96,119,215
2020,5,4,19,69,81,150
2020,5,4,20,57,54,111
2020,5,4,21,24,26,50
2020,5,4,22,9,10,19
2020,5,4,23,12,20,32
2020,5,5,0,4,18,22
2020,5,5,1,6,4,10
2020,5,5,2,11,8,19
2020,5,5,3,15,7,22
2020,5,5,4,108,49,157
2020,5,5,5,196,87,283
2020,5,5,6,232,105,337
2020,5,5,7,174,118,292
2020,5,5,8,165,124,289
2020,5,5,9,184,122,306
2020,5,5,10,197,164,361
2020,5,5,11,187,157,344
2020,5,5,12,209,217,426
2020,5,5,13,213,222,435
2020,5,5,14,173,190,363
2020,5,5,15,141,145,286
2020,5,5,16,127,105,232
2020,5,5,17,131,129,260
2020,5,5,18,105,110,215
2020,5,5,19,83,91,174
2020,5,5,20,50,54,104
2020,5,5,21,25,32,57
2020,5,5,22,19,19,38
2020,5,5,23,9,7,16
2020,5,6,0,13,5,18
2020,5,6,1,19,7,26
2020,5,6,2,15,8,23
2020,5,6,3,19,7,26
2020,5,6,4,105,46,151
2020,5,6,5,186,109,295
2020,5,6,6,243,130,373
2020,5,6,7,170,105,275
2020,5,6,8,174,117,291
2020,5,6,9,190,158,348
2020,5,6,10,186,165,351
2020,5,6,11,184,187,371
2020,5,6,12,197,183,380
2020,5,6,13,207,231,438
2020,5,6,14,187,178,365
2020,5,6,15,147,158,305
2020,5,6,16,122,127,249
2020,5,6,17,129,127,256
2020,5,6,18,95,120,215
2020,5,6,19,67,88,155
2020,5,6,20,52,175,227
2020,5,6,21,26,97,123
2020,5,6,22,13,56,69
2020,5,6,23,12,32,44
2020,5,7,0,12,28,40
2020,5,7,1,12,20,32
2020,5,7,2,9,19,28
2020,5,7,3,13,14,27
2020,5,7,4,100,44,144
2020,5,7,5,181,105,286
2020,5,7,6,242,114,356
2020,5,7,7,173,119,292
2020,5,7,8,175,129,304
2020,5,7,9,166,130,296
2020,5,7,10,196,153,349
2020,5,7,11,197,170,367
2020,5,7,12,192,192,384
2020,5,7,13,209,206,415
2020,5,7,14,152,175,327
2020,5,7,15,137,123,260
2020,5,7,16,126,125,251
2020,5,7,17,137,141,278
2020,5,7,18,91,109,200
2020,5,7,19,83,88,171
2020,5,7,20,52,53,105
2020,5,7,21,26,28,54
2020,5,7,22,12,17,29
2020,5,7,23,15,16,31
2020,5,8,0,8,9,17
2020,5,8,1,5,9,14
2020,5,8,2,10,2,12
2020,5,8,3,15,8,23
2020,5,8,4,89,39,128
2020,5,8,5,167,88,255
2020,5,8,6,246,128,374
2020,5,8,7,189,103,292
2020,5,8,8,185,137,322
2020,5,8,9,163,132,295
2020,5,8,10,215,158,373
2020,5,8,11,172,181,353
2020,5,8,12,204,216,420
2020,5,8,13,234,305,539
2020,5,8,14,209,216,425
2020,5,8,15,132,137,269
2020,5,8,16,129,144,273
2020,5,8,17,113,124,237
2020,5,8,18,86,89,175
2020,5,8,19,48,72,120
2020,5,8,20,44,58,102
2020,5,8,21,34,50,84
2020,5,8,22,23,35,58
2020,5,8,23,16,28,44
2020,5,9,0,20,15,35
2020,5,9,1,11,9,20
2020,5,9,2,7,6,13
2020,5,9,3,8,9,17
2020,5,9,4,28,17,45
2020,5,9,5,31,20,51
2020,5,9,6,28,22,50
2020,5,9,7,43,34,77
2020,5,9,8,72,49,121
2020,5,9,9,101,69,170
2020,5,9,10,124,124,248
2020,5,9,11,124,133,257
2020,5,9,12,151,132,283
2020,5,9,13,122,148,270
2020,5,9,14,119,120,239
2020,5,9,15,115,119,234
2020,5,9,16,112,127,239
2020,5,9,17,96,84,180
2020,5,9,18,70,75,145
2020,5,9,19,59,67,126
2020,5,9,20,50,60,110
2020,5,9,21,35,39,74
2020,5,9,22,31,39,70
2020,5,9,23,27,26,53
2020,5,10,0,13,24,37
2020,5,10,1,19,17,36
2020,5,10,2,7,12,19
2020,5,10,3,9,5,14
2020,5,10,4,20,12,32
2020,5,10,5,19,18,37
2020,5,10,6,26,18,44
2020,5,10,7,35,21,56
2020,5,10,8,44,44,88
2020,5,10,9,73,67,140
2020,5,10,10,94,93,187
2020,5,10,11,107,140,247
2020,5,10,12,154,144,298
2020,5,10,13,127,130,257
2020,5,10,14,135,130,265
2020,5,10,15,126,149,275
2020,5,10,16,138,153,291
2020,5,10,17,117,123,240
2020,5,10,18,102,118,220
2020,5,10,19,94,105,199
2020,5,10,20,48,63,111
2020,5,10,21,32,34,66
2020,5,10,22,15,22,37
2020,5,10,23,12,9,21
2020,5,11,0,0,4,4
2020,5,11,1,7,5,12
2020,5,11,2,7,6,13
2020,5,11,3,16,3,19
2020,5,11,4,97,52,149
2020,5,11,5,205,99,304
2020,5,11,6,258,145,403
2020,5,11,7,204,109,313
2020,5,11,8,180,137,317
2020,5,11,9,193,132,325
2020,5,11,10,190,156,346
2020,5,11,11,217,194,411
2020,5,11,12,221,193,414
2020,5,11,13,255,233,488
2020,5,11,14,184,203,387
2020,5,11,15,153,170,323
2020,5,11,16,132,156,288
2020,5,11,17,111,115,226
2020,5,11,18,97,102,199
2020,5,11,19,79,85,164
2020,5,11,20,43,46,89
2020,5,11,21,31,39,70
2020,5,11,22,14,17,31
2020,5,11,23,8,11,19
2020,5,12,0,14,7,21
2020,5,12,1,4,0,4
2020,5,12,2,8,3,11
2020,5,12,3,15,10,25
2020,5,12,4,109,46,155
2020,5,12,5,232,107,339
2020,5,12,6,287,150,437
2020,5,12,7,199,109,308
2020,5,12,8,178,131,309
2020,5,12,9,198,134,332
2020,5,12,10,184,155,339
2020,5,12,11,182,204,386
2020,5,12,12,226,241,467
2020,5,12,13,250,234,484
2020,5,12,14,180,210,390
2020,5,12,15,127,143,270
2020,5,12,16,125,144,269
2020,5,12,17,122,114,236
2020,5,12,18,104,116,220
2020,5,12,19,92,85,177
2020,5,12,20,46,83,129
2020,5,12,21,18,40,58
2020,5,12,22,11,17,28
2020,5,12,23,9,20,29
2020,5,13,0,5,11,16
2020,5,13,1,4,6,10
2020,5,13,2,7,7,14
2020,5,13,3,12,3,15
2020,5,13,4,109,46,155
2020,5,13,5,194,113,307
2020,5,13,6,307,153,460
2020,5,13,7,193,115,308
2020,5,13,8,193,144,337
2020,5,13,9,204,138,342
2020,5,13,10,207,171,378
2020,5,13,11,206,177,383
2020,5,13,12,215,194,409
2020,5,13,13,255,283,538
2020,5,13,14,221,202,423
2020,5,13,15,173,176,349
2020,5,13,16,168,136,304
2020,5,13,17,139,131,270
2020,5,13,18,96,121,217
2020,5,13,19,80,91,171
2020,5,13,20,47,62,109
2020,5,13,21,27,47,74
2020,5,13,22,12,22,34
2020,5,13,23,10,27,37
2020,5,14,0,8,15,23
2020,5,14,1,9,9,18
2020,5,14,2,4,9,13
2020,5,14,3,16,7,23
2020,5,14,4,121,48,169
2020,5,14,5,228,111,339
2020,5,14,6,285,132,417
2020,5,14,7,224,125,349
2020,5,14,8,193,135,328
2020,5,14,9,196,168,364
2020,5,14,10,187,179,366
2020,5,14,11,231,162,393
2020,5,14,12,226,210,436
2020,5,14,13,262,245,507
2020,5,14,14,186,225,411
2020,5,14,15,140,178,318
2020,5,14,16,145,148,293
2020,5,14,17,116,114,230
2020,5,14,18,100,108,208
2020,5,14,19,91,81,172
2020,5,14,20,59,56,115
2020,5,14,21,31,32,63
2020,5,14,22,10,18,28
2020,5,14,23,15,16,31
2020,5,15,0,9,10,19
2020,5,15,1,4,4,8
2020,5,15,2,7,5,12
2020,5,15,3,17,8,25
2020,5,15,4,107,49,156
2020,5,15,5,210,118,328
2020,5,15,6,301,144,445
2020,5,15,7,197,121,318
2020,5,15,8,188,144,332
2020,5,15,9,193,144,337
2020,5,15,10,222,173,395
2020,5,15,11,210,210,420
2020,5,15,12,242,239,481
2020,5,15,13,293,242,535
2020,5,15,14,200,199,399
2020,5,15,15,141,159,300
2020,5,15,16,138,156,294
2020,5,15,17,120,117,237
2020,5,15,18,90,98,188
2020,5,15,19,82,80,162
2020,5,15,20,59,59,118
2020,5,15,21,29,50,79
2020,5,15,22,23,28,51
2020,5,15,23,25,26,51
2020,5,16,0,19,18,37
2020,5,16,1,8,14,22
2020,5,16,2,12,11,23
2020,5,16,3,3,5,8
2020,5,16,4,18,6,24
2020,5,16,5,36,18,54
2020,5,16,6,27,27,54
2020,5,16,7,46,36,82
2020,5,16,8,83,57,140
2020,5,16,9,111,104,215
2020,5,16,10,144,132,276
2020,5,16,11,137,151,288
2020,5,16,12,178,169,347
2020,5,16,13,124,145,269
2020,5,16,14,133,144,277
2020,5,16,15,118,136,254
2020,5,16,16,139,116,255
2020,5,16,17,95,109,204
2020,5,16,18,82,91,173
2020,5,16,19,60,67,127
2020,5,16,20,56,64,120
2020,5,16,21,50,50,100
2020,5,16,22,28,46,74
2020,5,16,23,14,21,35
2020,5,17,0,20,17,37
2020,5,17,1,19,18,37
2020,5,17,2,11,11,22
2020,5,17,3,11,5,16
2020,5,17,4,28,18,46
2020,5,17,5,34,27,61
2020,5,17,6,65,43,108
2020,5,17,7,109,69,178
2020,5,17,8,90,79,169
2020,5,17,9,113,121,234
2020,5,17,10,130,129,259
2020,5,17,11,130,146,276
2020,5,17,12,118,156,274
2020,5,17,13,112,147,259
2020,5,17,14,128,143,271
2020,5,17,15,116,148,264
2020,5,17,16,129,148,277
2020,5,17,17,129,143,272
2020,5,17,18,90,122,212
2020,5,17,19,90,103,193
2020,5,17,20,69,88,157
2020,5,17,21,57,78,135
2020,5,17,22,31,27,58
2020,5,17,23,37,31,68
2020,5,18,0,27,26,53
2020,5,18,1,17,12,29
2020,5,18,2,14,15,29
2020,5,18,3,22,7,29
2020,5,18,4,114,46,160
2020,5,18,5,200,101,301
2020,5,18,6,302,158,460
2020,5,18,7,193,113,306
2020,5,18,8,179,121,300
2020,5,18,9,208,152,360
2020,5,18,10,182,156,338
2020,5,18,11,197,194,391
2020,5,18,12,209,203,412
2020,5,18,13,238,242,480
2020,5,18,14,159,216,375
2020,5,18,15,158,151,309
2020,5,18,16,142,140,282
2020,5,18,17,121,128,249
2020,5,18,18,97,93,190
2020,5,18,19,80,117,197
2020,5,18,20,37,67,104
2020,5,18,21,31,36,67
2020,5,18,22,11,20,31
2020,5,18,23,8,10,18
2020,5,19,0,4,8,12
2020,5,19,1,5,3,8
2020,5,19,2,5,4,9
2020,5,19,3,15,9,24
2020,5,19,4,120,39,159
2020,5,19,5,208,114,322
2020,5,19,6,327,173,500
2020,5,19,7,240,141,381
2020,5,19,8,195,133,328
2020,5,19,9,206,171,377
2020,5,19,10,227,180,407
2020,5,19,11,232,194,426
2020,5,19,12,208,261,469
2020,5,19,13,259,262,521
2020,5,19,14,195,203,398
2020,5,19,15,155,147,302
2020,5,19,16,132,131,263
2020,5,19,17,120,130,250
2020,5,19,18,113,126,239
2020,5,19,19,96,111,207
2020,5,19,20,61,60,121
2020,5,19,21,27,34,61
2020,5,19,22,12,17,29
2020,5,19,23,8,8,16
2020,5,20,0,7,4,11
2020,5,20,1,11,5,16
2020,5,20,2,9,6,15
2020,5,20,3,12,7,19
2020,5,20,4,103,44,147
2020,5,20,5,233,118,351
2020,5,20,6,325,163,488
2020,5,20,7,208,125,333
2020,5,20,8,217,157,374
2020,5,20,9,208,149,357
2020,5,20,10,208,173,381
2020,5,20,11,240,204,444
2020,5,20,12,243,248,491
2020,5,20,13,288,289,577
2020,5,20,14,235,195,430
2020,5,20,15,163,172,335
2020,5,20,16,162,158,320
2020,5,20,17,122,123,245
2020,5,20,18,107,104,211
2020,5,20,19,78,110,188
2020,5,20,20,67,63,130
2020,5,20,21,42,43,85
2020,5,20,22,18,24,42
2020,5,20,23,15,21,36
2020,5,21,0,12,19,31
2020,5,21,1,12,14,26
2020,5,21,2,2,3,5
2020,5,21,3,9,3,12
2020,5,21,4,18,10,28
2020,5,21,5,19,15,34
2020,5,21,6,26,14,40
2020,5,21,7,45,48,93
2020,5,21,8,79,61,140
2020,5,21,9,98,77,175
2020,5,21,10,108,89,197
2020,5,21,11,127,118,245
2020,5,21,12,135,140,275
2020,5,21,13,131,160,291
2020,5,21,14,105,123,228
2020,5,21,15,125,149,274
2020,5,21,16,108,124,232
2020,5,21,17,116,120,236
2020,5,21,18,98,124,222
2020,5,21,19,65,97,162
2020,5,21,20,57,56,113
2020,5,21,21,44,40,84
2020,5,21,22,20,35,55
2020,5,21,23,20,21,41
2020,5,22,0,5,11,16
2020,5,22,1,11,4,15
2020,5,22,2,13,7,20
2020,5,22,3,13,9,22
2020,5,22,4,77,42,119
2020,5,22,5,133,76,209
2020,5,22,6,139,76,215
2020,5,22,7,135,97,232
2020,5,22,8,147,111,258
2020,5,22,9,161,144,305
2020,5,22,10,199,180,379
2020,5,22,11,175,191,366
2020,5,22,12,197,191,388
2020,5,22,13,204,184,388
2020,5,22,14,157,176,333
2020,5,22,15,122,139,261
2020,5,22,16,135,105,240
2020,5,22,17,87,91,178
2020,5,22,18,80,60,140
2020,5,22,19,63,66,129
2020,5,22,20,45,56,101
2020,5,22,21,37,41,78
2020,5,22,22,31,41,72
2020,5,22,23,33,32,65
2020,5,23,0,20,20,40
2020,5,23,1,19,15,34
2020,5,23,2,8,6,14
2020,5,23,3,8,7,15
2020,5,23,4,22,18,40
2020,5,23,5,28,21,49
2020,5,23,6,24,26,50
2020,5,23,7,51,27,78
2020,5,23,8,48,50,98
2020,5,23,9,101,74,175
2020,5,23,10,128,99,227
2020,5,23,11,137,133,270
2020,5,23,12,145,156,301
2020,5,23,13,142,151,293
2020,5,23,14,106,140,246
2020,5,23,15,130,137,267
2020,5,23,16,123,141,264
2020,5,23,17,120,94,214
2020,5,23,18,83,87,170
2020,5,23,19,56,60,116
2020,5,23,20,35,46,81
2020,5,23,21,42,43,85
2020,5,23,22,31,41,72
2020,5,23,23,29,38,67
2020,5,24,0,21,27,48
2020,5,24,1,18,23,41
2020,5,24,2,13,15,28
2020,5,24,3,13,7,20
2020,5,24,4,18,8,26
2020,5,24,5,26,24,50
2020,5,24,6,24,14,38
2020,5,24,7,26,24,50
2020,5,24,8,47,40,87
2020,5,24,9,72,64,136
2020,5,24,10,98,96,194
2020,5,24,11,142,125,267
2020,5,24,12,157,147,304
2020,5,24,13,110,173,283
2020,5,24,14,132,130,262
2020,5,24,15,113,108,221
2020,5,24,16,130,122,252
2020,5,24,17,110,106,216
2020,5,24,18,108,109,217
2020,5,24,19,92,113,205
2020,5,24,20,58,73,131
2020,5,24,21,27,39,66
2020,5,24,22,17,16,33
2020,5,24,23,9,15,24
2020,5,25,0,0,8,8
2020,5,25,1,9,2,11
2020,5,25,2,7,5,12
2020,5,25,3,15,1,16
2020,5,25,4,107,51,158
2020,5,25,5,220,127,347
2020,5,25,6,355,158,513
2020,5,25,7,236,147,383
2020,5,25,8,194,155,349
2020,5,25,9,190,161,351
2020,5,25,10,226,183,409
2020,5,25,11,197,195,392
2020,5,25,12,213,212,425
2020,5,25,13,259,270,529
2020,5,25,14,197,229,426
2020,5,25,15,148,166,314
2020,5,25,16,135,132,267
2020,5,25,17,107,140,247
2020,5,25,18,93,105,198
2020,5,25,19,85,89,174
2020,5,25,20,61,61,122
2020,5,25,21,30,47,77
2020,5,25,22,17,20,37
2020,5,25,23,15,11,26
2020,5,26,0,5,3,8
2020,5,26,1,4,5,9
2020,5,26,2,9,7,16
2020,5,26,3,18,7,25
2020,5,26,4,109,53,162
2020,5,26,5,236,121,357
2020,5,26,6,357,151,508
2020,5,26,7,240,159,399
2020,5,26,8,193,133,326
2020,5,26,9,192,232,424
2020,5,26,10,231,265,496
2020,5,26,11,208,179,387
2020,5,26,12,186,213,399
2020,5,26,13,295,261,556
2020,5,26,14,226,234,460
2020,5,26,15,167,167,334
2020,5,26,16,132,117,249
2020,5,26,17,113,112,225
2020,5,26,18,106,108,214
2020,5,26,19,70,96,166
2020,5,26,20,48,87,135
2020,5,26,21,32,36,68
2020,5,26,22,17,32,49
2020,5,26,23,18,12,30
2020,5,27,0,10,6,16
2020,5,27,1,19,9,28
2020,5,27,2,16,5,21
2020,5,27,3,17,4,21
2020,5,27,4,105,55,160
2020,5,27,5,224,102,326
2020,5,27,6,326,156,482
2020,5,27,7,229,133,362
2020,5,27,8,212,139,351
2020,5,27,9,214,156,370
2020,5,27,10,226,175,401
2020,5,27,11,209,316,525
2020,5,27,12,216,264,480
2020,5,27,13,240,256,496
2020,5,27,14,191,242,433
2020,5,27,15,180,168,348
2020,5,27,16,146,143,289
2020,5,27,17,134,129,263
2020,5,27,18,101,104,205
2020,5,27,19,93,96,189
2020,5,27,20,76,68,144
2020,5,27,21,32,32,64
2020,5,27,22,17,23,40
2020,5,27,23,8,15,23
2020,5,28,0,6,9,15
2020,5,28,1,20,6,26
2020,5,28,2,16,6,22
2020,5,28,3,19,6,25
2020,5,28,4,99,45,144
2020,5,28,5,217,101,318
2020,5,28,6,314,161,475
2020,5,28,7,228,138,366
2020,5,28,8,205,154,359
2020,5,28,9,192,170,362
2020,5,28,10,210,186,396
2020,5,28,11,241,212,453
2020,5,28,12,231,226,457
2020,5,28,13,273,266,539
2020,5,28,14,226,204,430
2020,5,28,15,154,171,325
2020,5,28,16,146,127,273
2020,5,28,17,132,128,260
2020,5,28,18,100,152,252
2020,5,28,19,91,115,206
2020,5,28,20,69,71,140
2020,5,28,21,51,49,100
2020,5,28,22,20,25,45
2020,5,28,23,15,12,27
2020,5,29,0,11,13,24
2020,5,29,1,12,7,19
2020,5,29,2,9,9,18
2020,5,29,3,14,5,19
2020,5,29,4,97,49,146
2020,5,29,5,211,110,321
2020,5,29,6,311,156,467
2020,5,29,7,230,129,359
2020,5,29,8,181,154,335
2020,5,29,9,234,182,416
2020,5,29,10,210,196,406
2020,5,29,11,230,216,446
2020,5,29,12,261,234,495
2020,5,29,13,289,259,548
2020,5,29,14,157,209,366
2020,5,29,15,161,159,320
2020,5,29,16,147,120,267
2020,5,29,17,105,106,211
2020,5,29,18,91,109,200
2020,5,29,19,88,71,159
2020,5,29,20,63,91,154
2020,5,29,21,34,52,86
2020,5,29,22,25,35,60
2020,5,29,23,19,27,46
2020,5,30,0,22,28,50
2020,5,30,1,12,15,27
2020,5,30,2,5,9,14
2020,5,30,3,10,5,15
2020,5,30,4,22,8,30
2020,5,30,5,35,22,57
2020,5,30,6,36,25,61
2020,5,30,7,60,54,114
2020,5,30,8,82,61,143
2020,5,30,9,110,95,205
2020,5,30,10,116,108,224
2020,5,30,11,134,110,244
2020,5,30,12,124,164,288
2020,5,30,13,123,145,268
2020,5,30,14,138,155,293
2020,5,30,15,128,134,262
2020,5,30,16,106,122,228
2020,5,30,17,113,117,230
2020,5,30,18,83,104,187
2020,5,30,19,79,94,173
2020,5,30,20,54,63,117
2020,5,30,21,44,56,100
2020,5,30,22,39,39,78
2020,5,30,23,37,31,68
2020,5,31,0,24,28,52
2020,5,31,1,29,30,59
2020,5,31,2,10,25,35
2020,5,31,3,8,4,12
2020,5,31,4,17,11,28
2020,5,31,5,19,8,27
2020,5,31,6,15,14,29
2020,5,31,7,37,18,55
2020,5,31,8,69,66,135
2020,5,31,9,100,87,187
2020,5,31,10,99,88,187
2020,5,31,11,122,111,233
2020,5,31,12,134,128,262
2020,5,31,13,132,129,261
2020,5,31,14,125,124,249
2020,5,31,15,101,126,227
2020,5,31,16,124,133,257
2020,5,31,17,102,126,228
2020,5,31,18,83,106,189
2020,5,31,19,77,83,160
2020,5,31,20,67,69,136
2020,5,31,21,43,49,92
2020,5,31,22,17,44,61
2020,5,31,23,21,18,39
2020,6,1,0,12,12,24
2020,6,1,1,4,7,11
2020,6,1,2,6,7,13
2020,6,1,3,7,5,12
2020,6,1,4,19,13,32
2020,6,1,5,23,11,34
2020,6,1,6,25,27,52
2020,6,1,7,31,25,56
2020,6,1,8,69,54,123
2020,6,1,9,91,85,176
2020,6,1,10,100,117,217
2020,6,1,11,138,114,252
2020,6,1,12,130,142,272
2020,6,1,13,140,134,274
2020,6,1,14,162,152,314
2020,6,1,15,150,135,285
2020,6,1,16,134,127,261
2020,6,1,17,141,166,307
2020,6,1,18,124,119,243
2020,6,1,19,83,110,193
2020,6,1,20,73,85,158
2020,6,1,21,29,44,73
2020,6,1,22,19,22,41
2020,6,1,23,11,14,25
2020,6,2,0,4,10,14
2020,6,2,1,7,5,12
2020,6,2,2,10,3,13
2020,6,2,3,17,10,27
2020,6,2,4,112,48,160
2020,6,2,5,242,121,363
2020,6,2,6,342,163,505
2020,6,2,7,227,158,385
2020,6,2,8,214,161,375
2020,6,2,9,193,144,337
2020,6,2,10,225,245,470
2020,6,2,11,210,217,427
2020,6,2,12,247,224,471
2020,6,2,13,282,275,557
2020,6,2,14,223,227,450
2020,6,2,15,160,173,333
2020,6,2,16,166,138,304
2020,6,2,17,120,137,257
2020,6,2,18,87,115,202
2020,6,2,19,90,89,179
2020,6,2,20,91,81,172
2020,6,2,21,49,51,100
2020,6,2,22,22,17,39
2020,6,2,23,14,17,31
2020,6,3,0,7,16,23
2020,6,3,1,12,11,23
2020,6,3,2,8,7,15
2020,6,3,3,14,9,23
2020,6,3,4,100,68,168
2020,6,3,5,212,105,317
2020,6,3,6,365,167,532
2020,6,3,7,236,124,360
2020,6,3,8,214,165,379
2020,6,3,9,210,165,375
2020,6,3,10,230,168,398
2020,6,3,11,227,205,432
2020,6,3,12,247,247,494
2020,6,3,13,305,274,579
2020,6,3,14,228,230,458
2020,6,3,15,156,173,329
2020,6,3,16,165,148,313
2020,6,3,17,132,143,275
2020,6,3,18,122,111,233
2020,6,3,19,93,95,188
2020,6,3,20,63,61,124
2020,6,3,21,38,44,82
2020,6,3,22,19,19,38
2020,6,3,23,14,27,41
2020,6,4,0,8,12,20
2020,6,4,1,4,7,11
2020,6,4,2,10,5,15
2020,6,4,3,16,12,28
2020,6,4,4,118,52,170
2020,6,4,5,232,113,345
2020,6,4,6,346,187,533
2020,6,4,7,232,125,357
2020,6,4,8,179,155,334
2020,6,4,9,218,134,352
2020,6,4,10,209,174,383
2020,6,4,11,209,201,410
2020,6,4,12,215,238,453
2020,6,4,13,297,266,563
2020,6,4,14,228,228,456
2020,6,4,15,159,321,480
2020,6,4,16,166,170,336
2020,6,4,17,121,126,247
2020,6,4,18,113,116,229
2020,6,4,19,101,92,193
2020,6,4,20,56,60,116
2020,6,4,21,43,45,88
2020,6,4,22,21,22,43
2020,6,4,23,8,10,18
2020,6,5,0,7,10,17
2020,6,5,1,14,8,22
2020,6,5,2,10,8,18
2020,6,5,3,17,10,27
2020,6,5,4,109,64,173
2020,6,5,5,224,109,333
2020,6,5,6,325,172,497
2020,6,5,7,224,108,332
2020,6,5,8,191,131,322
2020,6,5,9,209,177,386
2020,6,5,10,247,195,442
2020,6,5,11,244,211,455
2020,6,5,12,268,233,501
2020,6,5,13,312,263,575
2020,6,5,14,201,243,444
2020,6,5,15,165,185,350
2020,6,5,16,149,133,282
2020,6,5,17,123,105,228
2020,6,5,18,96,108,204
2020,6,5,19,69,81,150
2020,6,5,20,49,69,118
2020,6,5,21,33,52,85
2020,6,5,22,34,40,74
2020,6,5,23,28,31,59
2020,6,6,0,29,29,58
2020,6,6,1,21,31,52
2020,6,6,2,7,12,19
2020,6,6,3,8,4,12
2020,6,6,4,26,11,37
2020,6,6,5,38,20,58
2020,6,6,6,41,35,76
2020,6,6,7,59,42,101
2020,6,6,8,76,67,143
2020,6,6,9,122,102,224
2020,6,6,10,141,138,279
2020,6,6,11,145,143,288
2020,6,6,12,142,147,289
2020,6,6,13,148,185,333
2020,6,6,14,132,157,289
2020,6,6,15,145,118,263
2020,6,6,16,139,145,284
2020,6,6,17,100,96,196
2020,6,6,18,69,65,134
2020,6,6,19,53,70,123
2020,6,6,20,59,63,122
2020,6,6,21,49,71,120
2020,6,6,22,37,46,83
2020,6,6,23,21,25,46
2020,6,7,0,22,21,43
2020,6,7,1,23,34,57
2020,6,7,2,9,21,30
2020,6,7,3,11,14,25
2020,6,7,4,22,5,27
2020,6,7,5,14,14,28
2020,6,7,6,22,14,36
2020,6,7,7,33,29,62
2020,6,7,8,55,39,94
2020,6,7,9,71,59,130
2020,6,7,10,109,91,200
2020,6,7,11,124,149,273
2020,6,7,12,150,152,302
2020,6,7,13,156,172,328
2020,6,7,14,145,155,300
2020,6,7,15,138,140,278
2020,6,7,16,120,126,246
2020,6,7,17,126,152,278
2020,6,7,18,97,117,214
2020,6,7,19,115,112,227
2020,6,7,20,53,66,119
2020,6,7,21,30,41,71
2020,6,7,22,21,24,45
2020,6,7,23,10,8,18
2020,6,8,0,4,4,8
2020,6,8,1,8,8,16
2020,6,8,2,9,4,13
2020,6,8,3,19,8,27
2020,6,8,4,97,51,148
2020,6,8,5,242,132,374
2020,6,8,6,338,185,523
2020,6,8,7,245,146,391
2020,6,8,8,216,143,359
2020,6,8,9,206,172,378
2020,6,8,10,237,168,405
2020,6,8,11,193,208,401
2020,6,8,12,248,260,508
2020,6,8,13,289,273,562
2020,6,8,14,258,245,503
2020,6,8,15,178,174,352
2020,6,8,16,143,168,311
2020,6,8,17,129,136,265
2020,6,8,18,121,119,240
2020,6,8,19,109,97,206
2020,6,8,20,65,147,212
2020,6,8,21,58,116,174
2020,6,8,22,17,59,76
2020,6,8,23,17,20,37
2020,6,9,0,10,9,19
2020,6,9,1,8,7,15
2020,6,9,2,10,6,16
2020,6,9,3,24,11,35
2020,6,9,4,108,45,153
2020,6,9,5,238,114,352
2020,6,9,6,324,154,478
2020,6,9,7,247,142,389
2020,6,9,8,219,134,353
2020,6,9,9,216,184,400
2020,6,9,10,203,181,384
2020,6,9,11,216,173,389
2020,6,9,12,216,215,431
2020,6,9,13,266,256,522
2020,6,9,14,248,252,500
2020,6,9,15,173,175,348
2020,6,9,16,163,153,316
2020,6,9,17,145,132,277
2020,6,9,18,103,149,252
2020,6,9,19,122,99,221
2020,6,9,20,97,75,172
2020,6,9,21,76,38,114
2020,6,9,22,19,23,42
2020,6,9,23,13,17,30
2020,6,10,0,10,15,25
2020,6,10,1,8,9,17
2020,6,10,2,5,11,16
2020,6,10,3,17,10,27
2020,6,10,4,101,57,158
2020,6,10,5,245,119,364
2020,6,10,6,330,167,497
2020,6,10,7,233,125,358
2020,6,10,8,228,149,377
2020,6,10,9,218,143,361
2020,6,10,10,190,183,373
2020,6,10,11,232,197,429
2020,6,10,12,237,245,482
2020,6,10,13,283,278,561
2020,6,10,14,243,257,500
2020,6,10,15,168,196,364
2020,6,10,16,150,166,316
2020,6,10,17,146,124,270
2020,6,10,18,108,136,244
2020,6,10,19,108,132,240
2020,6,10,20,71,73,144
2020,6,10,21,41,39,80
2020,6,10,22,11,21,32
2020,6,10,23,15,25,40
2020,6,11,0,9,8,17
2020,6,11,1,7,10,17
2020,6,11,2,3,8,11
2020,6,11,3,22,14,36
2020,6,11,4,105,48,153
2020,6,11,5,230,126,356
2020,6,11,6,331,149,480
2020,6,11,7,226,144,370
2020,6,11,8,228,164,392
2020,6,11,9,237,202,439
2020,6,11,10,235,186,421
2020,6,11,11,238,211,449
2020,6,11,12,244,238,482
2020,6,11,13,318,317,635
2020,6,11,14,239,250,489
2020,6,11,15,181,184,365
2020,6,11,16,130,168,298
2020,6,11,17,150,165,315
2020,6,11,18,112,131,243
2020,6,11,19,116,108,224
2020,6,11,20,83,98,181
2020,6,11,21,32,38,70
2020,6,11,22,18,121,139
2020,6,11,23,14,30,44
2020,6,12,0,9,13,22
2020,6,12,1,12,7,19
2020,6,12,2,7,10,17
2020,6,12,3,17,17,34
2020,6,12,4,111,50,161
2020,6,12,5,205,114,319
2020,6,12,6,318,148,466
2020,6,12,7,181,134,315
2020,6,12,8,239,166,405
2020,6,12,9,216,209,425
2020,6,12,10,236,223,459
2020,6,12,11,245,198,443
2020,6,12,12,286,267,553
2020,6,12,13,309,350,659
2020,6,12,14,218,238,456
2020,6,12,15,171,164,335
2020,6,12,16,156,154,310
2020,6,12,17,131,146,277
2020,6,12,18,103,108,211
2020,6,12,19,86,123,209
2020,6,12,20,79,97,176
2020,6,12,21,49,73,122
2020,6,12,22,38,52,90
2020,6,12,23,27,36,63
2020,6,13,0,25,17,42
2020,6,13,1,24,27,51
2020,6,13,2,12,21,33
2020,6,13,3,7,4,11
2020,6,13,4,29,16,45
2020,6,13,5,26,21,47
2020,6,13,6,43,39,82
2020,6,13,7,69,46,115
2020,6,13,8,102,68,170
2020,6,13,9,113,85,198
2020,6,13,10,108,110,218
2020,6,13,11,130,130,260
2020,6,13,12,133,141,274
2020,6,13,13,162,158,320
2020,6,13,14,143,156,299
2020,6,13,15,135,130,265
2020,6,13,16,123,144,267
2020,6,13,17,117,115,232
2020,6,13,18,87,115,202
2020,6,13,19,59,90,149
2020,6,13,20,65,64,129
2020,6,13,21,45,68,113
2020,6,13,22,42,62,104
2020,6,13,23,25,31,56
2020,6,14,0,25,17,42
2020,6,14,1,16,29,45
2020,6,14,2,17,36,53
2020,6,14,3,10,19,29
2020,6,14,4,19,7,26
2020,6,14,5,14,14,28
2020,6,14,6,26,19,45
2020,6,14,7,34,26,60
2020,6,14,8,54,40,94
2020,6,14,9,68,61,129
2020,6,14,10,111,102,213
2020,6,14,11,136,114,250
2020,6,14,12,146,133,279
2020,6,14,13,147,157,304
2020,6,14,14,161,162,323
2020,6,14,15,153,156,309
2020,6,14,16,140,141,281
2020,6,14,17,150,137,287
2020,6,14,18,135,162,297
2020,6,14,19,104,117,221
2020,6,14,20,75,88,163
2020,6,14,21,38,50,88
2020,6,14,22,16,24,40
2020,6,14,23,8,13,21
2020,6,15,0,10,11,21
2020,6,15,1,9,7,16
2020,6,15,2,11,8,19
2020,6,15,3,22,10,32
2020,6,15,4,107,52,159
2020,6,15,5,237,102,339
2020,6,15,6,361,174,535
2020,6,15,7,275,153,428
2020,6,15,8,215,146,361
2020,6,15,9,210,172,382
2020,6,15,10,234,185,419
2020,6,15,11,249,221,470
2020,6,15,12,249,221,470
2020,6,15,13,300,282,582
2020,6,15,14,229,272,501
2020,6,15,15,163,172,335
2020,6,15,16,158,152,310
2020,6,15,17,128,141,269
2020,6,15,18,120,139,259
2020,6,15,19,101,127,228
2020,6,15,20,82,78,160
2020,6,15,21,53,44,97
2020,6,15,22,20,25,45
2020,6,15,23,15,18,33
2020,6,16,0,4,8,12
2020,6,16,1,6,7,13
2020,6,16,2,11,5,16
2020,6,16,3,19,6,25
2020,6,16,4,100,54,154
2020,6,16,5,207,131,338
2020,6,16,6,358,159,517
2020,6,16,7,273,165,438
2020,6,16,8,213,392,605
2020,6,16,9,254,273,527
2020,6,16,10,252,188,440
2020,6,16,11,225,217,442
2020,6,16,12,254,257,511
2020,6,16,13,317,306,623
2020,6,16,14,249,266,515
2020,6,16,15,159,174,333
2020,6,16,16,169,166,335
2020,6,16,17,165,161,326
2020,6,16,18,137,160,297
2020,6,16,19,112,135,247
2020,6,16,20,74,117,191
2020,6,16,21,51,94,145
2020,6,16,22,13,33,46
2020,6,16,23,12,19,31
2020,6,17,0,13,11,24
2020,6,17,1,23,5,28
2020,6,17,2,15,6,21
2020,6,17,3,22,14,36
2020,6,17,4,108,51,159
2020,6,17,5,246,127,373
2020,6,17,6,354,199,553
2020,6,17,7,253,146,399
2020,6,17,8,234,148,382
2020,6,17,9,254,189,443
2020,6,17,10,231,213,444
2020,6,17,11,250,226,476
2020,6,17,12,251,216,467
2020,6,17,13,315,295,610
2020,6,17,14,247,245,492
2020,6,17,15,190,221,411
2020,6,17,16,174,181,355
2020,6,17,17,125,148,273
2020,6,17,18,135,148,283
2020,6,17,19,102,107,209
2020,6,17,20,82,89,171
2020,6,17,21,55,58,113
2020,6,17,22,16,27,43
2020,6,17,23,16,22,38
2020,6,18,0,13,11,24
2020,6,18,1,11,11,22
2020,6,18,2,8,1,9
2020,6,18,3,18,10,28
2020,6,18,4,113,53,166
2020,6,18,5,242,135,377
2020,6,18,6,320,163,483
2020,6,18,7,268,161,429
2020,6,18,8,223,163,386
2020,6,18,9,229,213,442
2020,6,18,10,255,252,507
2020,6,18,11,273,209,482
2020,6,18,12,278,262,540
2020,6,18,13,292,287,579
2020,6,18,14,232,285,517
2020,6,18,15,182,186,368
2020,6,18,16,165,172,337
2020,6,18,17,167,183,350
2020,6,18,18,137,146,283
2020,6,18,19,125,122,247
2020,6,18,20,77,104,181
2020,6,18,21,43,66,109
2020,6,18,22,21,29,50
2020,6,18,23,16,25,41
2020,6,19,0,22,17,39
2020,6,19,1,10,12,22
2020,6,19,2,13,10,23
2020,6,19,3,17,10,27
2020,6,19,4,100,60,160
2020,6,19,5,230,110,340
2020,6,19,6,339,172,511
2020,6,19,7,215,158,373
2020,6,19,8,222,148,370
2020,6,19,9,223,182,405
2020,6,19,10,244,218,462
2020,6,19,11,269,228,497
2020,6,19,12,254,283,537
2020,6,19,13,315,279,594
2020,6,19,14,204,247,451
2020,6,19,15,157,159,316
2020,6,19,16,151,132,283
2020,6,19,17,124,139,263
2020,6,19,18,127,130,257
2020,6,19,19,80,100,180
2020,6,19,20,65,79,144
2020,6,19,21,53,77,130
2020,6,19,22,36,57,93
2020,6,19,23,35,43,78
2020,6,20,0,20,23,43
2020,6,20,1,19,28,47
2020,6,20,2,17,18,35
2020,6,20,3,7,14,21
2020,6,20,4,26,17,43
2020,6,20,5,39,25,64
2020,6,20,6,27,24,51
2020,6,20,7,56,42,98
2020,6,20,8,73,58,131
2020,6,20,9,111,84,195
2020,6,20,10,140,133,273
2020,6,20,11,153,121,274
2020,6,20,12,142,158,300
2020,6,20,13,165,169,334
2020,6,20,14,152,174,326
2020,6,20,15,150,167,317
2020,6,20,16,137,145,282
2020,6,20,17,118,141,259
2020,6,20,18,85,104,189
2020,6,20,19,61,74,135
2020,6,20,20,57,71,128
2020,6,20,21,35,65,100
2020,6,20,22,34,47,81
2020,6,20,23,32,37,69
2020,6,21,0,26,34,60
2020,6,21,1,38,35,73
2020,6,21,2,13,28,41
2020,6,21,3,16,22,38
2020,6,21,4,22,8,30
2020,6,21,5,24,22,46
2020,6,21,6,28,17,45
2020,6,21,7,28,20,48
2020,6,21,8,67,45,112
2020,6,21,9,77,58,135
2020,6,21,10,96,109,205
2020,6,21,11,126,133,259
2020,6,21,12,157,146,303
2020,6,21,13,176,168,344
2020,6,21,14,142,174,316
2020,6,21,15,144,153,297
2020,6,21,16,151,158,309
2020,6,21,17,129,138,267
2020,6,21,18,125,131,256
2020,6,21,19,90,130,220
2020,6,21,20,64,85,149
2020,6,21,21,50,64,114
2020,6,21,22,23,23,46
2020,6,21,23,16,19,35
2020,6,22,0,10,10,20
2020,6,22,1,7,4,11
2020,6,22,2,10,8,18
2020,6,22,3,11,9,20
2020,6,22,4,105,53,158
2020,6,22,5,220,122,342
2020,6,22,6,309,146,455
2020,6,22,7,231,142,373
2020,6,22,8,188,149,337
2020,6,22,9,230,163,393
2020,6,22,10,247,178,425
2020,6,22,11,217,185,402
2020,6,22,12,207,246,453
2020,6,22,13,288,264,552
2020,6,22,14,204,299,503
2020,6,22,15,158,165,323
2020,6,22,16,156,149,305
2020,6,22,17,117,133,250
2020,6,22,18,119,94,213
2020,6,22,19,90,97,187
2020,6,22,20,58,67,125
2020,6,22,21,36,48,84
2020,6,22,22,20,20,40
2020,6,22,23,17,16,33
2020,6,23,0,6,13,19
2020,6,23,1,12,19,31
2020,6,23,2,7,30,37
2020,6,23,3,16,15,31
2020,6,23,4,111,46,157
2020,6,23,5,207,128,335
2020,6,23,6,297,151,448
2020,6,23,7,221,113,334
2020,6,23,8,212,141,353
2020,6,23,9,215,161,376
2020,6,23,10,219,154,373
2020,6,23,11,237,184,421
2020,6,23,12,272,248,520
2020,6,23,13,282,334,616
2020,6,23,14,224,258,482
2020,6,23,15,170,177,347
2020,6,23,16,135,152,287
2020,6,23,17,140,122,262
2020,6,23,18,127,110,237
2020,6,23,19,96,112,208
2020,6,23,20,81,87,168
2020,6,23,21,57,57,114
2020,6,23,22,24,23,47
2020,6,23,23,10,24,34
2020,6,24,0,12,23,35
2020,6,24,1,19,16,35
2020,6,24,2,8,3,11
2020,6,24,3,13,13,26
2020,6,24,4,82,42,124
2020,6,24,5,213,95,308
2020,6,24,6,295,154,449
2020,6,24,7,216,133,349
2020,6,24,8,234,123,357
2020,6,24,9,205,150,355
2020,6,24,10,227,168,395
2020,6,24,11,231,195,426
2020,6,24,12,245,248,493
2020,6,24,13,317,327,644
2020,6,24,14,215,283,498
2020,6,24,15,174,191,365
2020,6,24,16,155,158,313
2020,6,24,17,124,122,246
2020,6,24,18,123,136,259
2020,6,24,19,91,128,219
2020,6,24,20,70,90,160
2020,6,24,21,42,60,102
2020,6,24,22,20,36,56
2020,6,24,23,17,22,39
2020,6,25,0,9,6,15
2020,6,25,1,8,8,16
2020,6,25,2,6,7,13
2020,6,25,3,19,10,29
2020,6,25,4,122,56,178
2020,6,25,5,200,118,318
2020,6,25,6,268,146,414
2020,6,25,7,250,158,408
2020,6,25,8,204,136,340
2020,6,25,9,216,187,403
2020,6,25,10,210,157,367
2020,6,25,11,240,219,459
2020,6,25,12,257,251,508
2020,6,25,13,323,297,620
2020,6,25,14,214,247,461
2020,6,25,15,160,193,353
2020,6,25,16,148,159,307
2020,6,25,17,147,170,317
2020,6,25,18,118,106,224
2020,6,25,19,98,106,204
2020,6,25,20,66,85,151
2020,6,25,21,46,58,104
2020,6,25,22,19,21,40
2020,6,25,23,16,25,41
2020,6,26,0,12,20,32
2020,6,26,1,12,18,30
2020,6,26,2,6,9,15
2020,6,26,3,15,9,24
2020,6,26,4,108,35,143
2020,6,26,5,206,110,316
2020,6,26,6,228,117,345
2020,6,26,7,218,152,370
2020,6,26,8,215,161,376
2020,6,26,9,224,168,392
2020,6,26,10,228,204,432
2020,6,26,11,230,227,457
2020,6,26,12,248,268,516
2020,6,26,13,284,265,549
2020,6,26,14,175,233,408
2020,6,26,15,149,151,300
2020,6,26,16,138,136,274
2020,6,26,17,125,151,276
2020,6,26,18,111,103,214
2020,6,26,19,82,89,171
2020,6,26,20,70,89,159
2020,6,26,21,49,63,112
2020,6,26,22,39,39,78
2020,6,26,23,38,38,76
2020,6,27,0,18,27,45
2020,6,27,1,19,21,40
2020,6,27,2,7,17,24
2020,6,27,3,12,5,17
2020,6,27,4,33,18,51
2020,6,27,5,29,17,46
2020,6,27,6,31,19,50
2020,6,27,7,54,57,111
2020,6,27,8,86,68,154
2020,6,27,9,118,93,211
2020,6,27,10,143,132,275
2020,6,27,11,154,125,279
2020,6,27,12,142,142,284
2020,6,27,13,140,150,290
2020,6,27,14,132,150,282
2020,6,27,15,104,145,249
2020,6,27,16,145,156,301
2020,6,27,17,103,121,224
2020,6,27,18,94,101,195
2020,6,27,19,68,98,166
2020,6,27,20,56,65,121
2020,6,27,21,45,66,111
2020,6,27,22,28,38,66
2020,6,27,23,31,35,66
2020,6,28,0,34,34,68
2020,6,28,1,17,23,40
2020,6,28,2,14,19,33
2020,6,28,3,14,7,21
2020,6,28,4,22,10,32
2020,6,28,5,19,18,37
2020,6,28,6,30,20,50
2020,6,28,7,41,30,71
2020,6,28,8,60,40,100
2020,6,28,9,86,79,165
2020,6,28,10,118,102,220
2020,6,28,11,141,142,283
2020,6,28,12,158,141,299
2020,6,28,13,158,145,303
2020,6,28,14,159,181,340
2020,6,28,15,142,157,299
2020,6,28,16,145,148,293
2020,6,28,17,138,140,278
2020,6,28,18,102,132,234
2020,6,28,19,93,106,199
2020,6,28,20,68,81,149
2020,6,28,21,42,58,100
2020,6,28,22,17,22,39
2020,6,28,23,13,12,25
2020,6,29,0,6,4,10
2020,6,29,1,9,14,23
2020,6,29,2,9,8,17
2020,6,29,3,12,13,25
2020,6,29,4,91,50,141
2020,6,29,5,194,108,302
2020,6,29,6,301,142,443
2020,6,29,7,218,133,351
2020,6,29,8,203,183,386
2020,6,29,9,226,142,368
2020,6,29,10,230,182,412
2020,6,29,11,236,204,440
2020,6,29,12,235,235,470
2020,6,29,13,260,294,554
2020,6,29,14,210,263,473
2020,6,29,15,151,172,323
2020,6,29,16,150,154,304
2020,6,29,17,129,147,276
2020,6,29,18,122,119,241
2020,6,29,19,98,101,199
2020,6,29,20,72,75,147
2020,6,29,21,29,49,78
2020,6,29,22,24,22,46
2020,6,29,23,22,28,50
2020,6,30,0,9,10,19
2020,6,30,1,21,6,27
2020,6,30,2,18,5,23
2020,6,30,3,17,5,22
2020,6,30,4,119,55,174
2020,6,30,5,215,94,309
2020,6,30,6,294,142,436
2020,6,30,7,208,149,357
2020,6,30,8,198,143,341
2020,6,30,9,243,177,420
2020,6,30,10,217,182,399
2020,6,30,11,212,185,397
2020,6,30,12,229,211,440
2020,6,30,13,280,305,585
2020,6,30,14,215,270,485
2020,6,30,15,163,175,338
2020,6,30,16,149,154,303
2020,6,30,17,127,121,248
2020,6,30,18,120,138,258
2020,6,30,19,82,104,186
2020,6,30,20,62,88,150
2020,6,30,21,37,51,88
2020,6,30,22,23,33,56
2020,6,30,23,11,22,33
2020,7,1,0,13,9,22
2020,7,1,1,15,2,17
2020,7,1,2,20,6,26
2020,7,1,3,20,8,28
2020,7,1,4,107,49,156
2020,7,1,5,197,98,295
2020,7,1,6,289,146,435
2020,7,1,7,200,131,331
2020,7,1,8,198,137,335
2020,7,1,9,247,201,448
2020,7,1,10,218,205,423
2020,7,1,11,242,209,451
2020,7,1,12,257,220,477
2020,7,1,13,275,271,546
2020,7,1,14,198,237,435
2020,7,1,15,155,202,357
2020,7,1,16,141,137,278
2020,7,1,17,142,159,301
2020,7,1,18,113,138,251
2020,7,1,19,89,110,199
2020,7,1,20,82,84,166
2020,7,1,21,47,53,100
2020,7,1,22,31,24,55
2020,7,1,23,18,10,28
2020,7,2,0,15,14,29
2020,7,2,1,24,12,36
2020,7,2,2,20,3,23
2020,7,2,3,9,13,22
2020,7,2,4,94,49,143
2020,7,2,5,174,95,269
2020,7,2,6,266,140,406
2020,7,2,7,219,117,336
2020,7,2,8,202,149,351
2020,7,2,9,234,184,418
2020,7,2,10,208,188,396
2020,7,2,11,233,219,452
2020,7,2,12,236,211,447
2020,7,2,13,327,268,595
2020,7,2,14,238,401,639
2020,7,2,15,274,230,504
2020,7,2,16,127,151,278
2020,7,2,17,132,144,276
2020,7,2,18,103,100,203
2020,7,2,19,80,95,175
2020,7,2,20,70,66,136
2020,7,2,21,51,64,115
2020,7,2,22,26,23,49
2020,7,2,23,18,15,33
2020,7,3,0,13,12,25
2020,7,3,1,23,18,41
2020,7,3,2,23,5,28
2020,7,3,3,16,6,22
2020,7,3,4,90,47,137
2020,7,3,5,192,84,276
2020,7,3,6,268,124,392
2020,7,3,7,220,125,345
2020,7,3,8,191,163,354
2020,7,3,9,226,152,378
2020,7,3,10,204,181,385
2020,7,3,11,231,211,442
2020,7,3,12,307,260,567
2020,7,3,13,274,272,546
2020,7,3,14,205,283,488
2020,7,3,15,134,180,314
2020,7,3,16,139,149,288
2020,7,3,17,105,116,221
2020,7,3,18,95,97,192
2020,7,3,19,73,82,155
2020,7,3,20,64,75,139
2020,7,3,21,43,54,97
2020,7,3,22,38,45,83
2020,7,3,23,21,28,49
2020,7,4,0,19,26,45
2020,7,4,1,23,28,51
2020,7,4,2,10,19,29
2020,7,4,3,10,8,18
2020,7,4,4,30,12,42
2020,7,4,5,26,22,48
2020,7,4,6,47,39,86
2020,7,4,7,61,53,114
2020,7,4,8,95,95,190
2020,7,4,9,117,103,220
2020,7,4,10,151,107,258
2020,7,4,11,148,149,297
2020,7,4,12,176,135,311
2020,7,4,13,158,154,312
2020,7,4,14,117,139,256
2020,7,4,15,123,124,247
2020,7,4,16,124,123,247
2020,7,4,17,98,106,204
2020,7,4,18,82,80,162
2020,7,4,19,53,72,125
2020,7,4,20,45,50,95
2020,7,4,21,38,57,95
2020,7,4,22,38,52,90
2020,7,4,23,29,46,75
2020,7,5,0,24,27,51
2020,7,5,1,22,22,44
2020,7,5,2,15,19,34
2020,7,5,3,21,12,33
2020,7,5,4,19,9,28
2020,7,5,5,13,17,30
2020,7,5,6,16,17,33
2020,7,5,7,30,22,52
2020,7,5,8,73,51,124
2020,7,5,9,87,75,162
2020,7,5,10,118,103,221
2020,7,5,11,142,125,267
2020,7,5,12,171,221,392
2020,7,5,13,161,214,375
2020,7,5,14,148,162,310
2020,7,5,15,134,163,297
2020,7,5,16,120,124,244
2020,7,5,17,98,95,193
2020,7,5,18,97,108,205
2020,7,5,19,74,87,161
2020,7,5,20,63,59,122
2020,7,5,21,37,32,69
2020,7,5,22,23,26,49
2020,7,5,23,11,11,22
2020,7,6,0,6,6,12
2020,7,6,1,7,4,11
2020,7,6,2,7,6,13
2020,7,6,3,13,9,22
2020,7,6,4,98,38,136
2020,7,6,5,174,96,270
2020,7,6,6,207,117,324
2020,7,6,7,196,118,314
2020,7,6,8,187,134,321
2020,7,6,9,217,151,368
2020,7,6,10,210,177,387
2020,7,6,11,232,193,425
2020,7,6,12,230,238,468
2020,7,6,13,230,236,466
2020,7,6,14,166,231,397
2020,7,6,15,160,171,331
2020,7,6,16,117,132,249
2020,7,6,17,88,99,187
2020,7,6,18,85,80,165
2020,7,6,19,80,84,164
2020,7,6,20,82,67,149
2020,7,6,21,43,30,73
2020,7,6,22,20,16,36
2020,7,6,23,16,18,34
2020,7,7,0,5,12,17
2020,7,7,1,12,13,25
2020,7,7,2,8,7,15
2020,7,7,3,13,12,25
2020,7,7,4,85,51,136
2020,7,7,5,148,95,243
2020,7,7,6,186,113,299
2020,7,7,7,167,106,273
2020,7,7,8,184,133,317
2020,7,7,9,179,147,326
2020,7,7,10,186,163,349
2020,7,7,11,221,175,396
2020,7,7,12,231,204,435
2020,7,7,13,212,220,432
2020,7,7,14,188,199,387
2020,7,7,15,139,158,297
2020,7,7,16,113,118,231
2020,7,7,17,96,114,210
2020,7,7,18,98,87,185
2020,7,7,19,74,83,157
2020,7,7,20,57,66,123
2020,7,7,21,34,49,83
2020,7,7,22,21,16,37
2020,7,7,23,8,21,29
2020,7,8,0,13,11,24
2020,7,8,1,7,10,17
2020,7,8,2,9,8,17
2020,7,8,3,8,8,16
2020,7,8,4,91,29,120
2020,7,8,5,169,112,281
2020,7,8,6,181,115,296
2020,7,8,7,181,106,287
2020,7,8,8,200,134,334
2020,7,8,9,210,130,340
2020,7,8,10,223,177,400
2020,7,8,11,203,167,370
2020,7,8,12,223,210,433
2020,7,8,13,234,227,461
2020,7,8,14,171,214,385
2020,7,8,15,153,169,322
2020,7,8,16,118,139,257
2020,7,8,17,100,128,228
2020,7,8,18,89,87,176
2020,7,8,19,67,78,145
2020,7,8,20,58,60,118
2020,7,8,21,43,47,90
2020,7,8,22,14,30,44
2020,7,8,23,20,15,35
2020,7,9,0,10,7,17
2020,7,9,1,12,17,29
2020,7,9,2,9,5,14
2020,7,9,3,18,12,30
2020,7,9,4,87,44,131
2020,7,9,5,167,104,271
2020,7,9,6,172,98,270
2020,7,9,7,164,101,265
2020,7,9,8,199,122,321
2020,7,9,9,207,147,354
2020,7,9,10,194,159,353
2020,7,9,11,201,165,366
2020,7,9,12,224,182,406
2020,7,9,13,267,214,481
2020,7,9,14,184,215,399
2020,7,9,15,137,160,297
2020,7,9,16,148,129,277
2020,7,9,17,114,121,235
2020,7,9,18,95,114,209
2020,7,9,19,86,79,165
2020,7,9,20,57,63,120
2020,7,9,21,43,34,77
2020,7,9,22,26,28,54
2020,7,9,23,17,20,37
2020,7,10,0,11,10,21
2020,7,10,1,17,14,31
2020,7,10,2,8,7,15
2020,7,10,3,17,3,20
2020,7,10,4,92,40,132
2020,7,10,5,126,87,213
2020,7,10,6,177,116,293
2020,7,10,7,144,102,246
2020,7,10,8,186,134,320
2020,7,10,9,169,121,290
2020,7,10,10,222,157,379
2020,7,10,11,202,196,398
2020,7,10,12,194,200,394
2020,7,10,13,224,210,434
2020,7,10,14,157,180,337
2020,7,10,15,127,137,264
2020,7,10,16,126,106,232
2020,7,10,17,112,109,221
2020,7,10,18,78,75,153
2020,7,10,19,72,70,142
2020,7,10,20,61,63,124
2020,7,10,21,28,47,75
2020,7,10,22,26,34,60
2020,7,10,23,24,24,48
2020,7,11,0,20,29,49
2020,7,11,1,16,19,35
2020,7,11,2,14,14,28
2020,7,11,3,15,4,19
2020,7,11,4,34,10,44
2020,7,11,5,28,21,49
2020,7,11,6,25,27,52
2020,7,11,7,52,29,81
2020,7,11,8,90,57,147
2020,7,11,9,112,79,191
2020,7,11,10,119,101,220
2020,7,11,11,125,94,219
2020,7,11,12,129,123,252
2020,7,11,13,124,138,262
2020,7,11,14,136,138,274
2020,7,11,15,105,128,233
2020,7,11,16,106,111,217
2020,7,11,17,69,83,152
2020,7,11,18,57,68,125
2020,7,11,19,62,52,114
2020,7,11,20,51,55,106
2020,7,11,21,35,36,71
2020,7,11,22,35,42,77
2020,7,11,23,22,23,45
2020,7,12,0,26,20,46
2020,7,12,1,20,27,47
2020,7,12,2,19,30,49
2020,7,12,3,15,9,24
2020,7,12,4,20,7,27
2020,7,12,5,19,10,29
2020,7,12,6,25,15,40
2020,7,12,7,36,22,58
2020,7,12,8,76,52,128
2020,7,12,9,85,64,149
2020,7,12,10,93,98,191
2020,7,12,11,107,123,230
2020,7,12,12,141,163,304
2020,7,12,13,122,107,229
2020,7,12,14,137,138,275
2020,7,12,15,127,135,262
2020,7,12,16,113,101,214
2020,7,12,17,108,90,198
2020,7,12,18,93,103,196
2020,7,12,19,83,64,147
2020,7,12,20,59,59,118
2020,7,12,21,38,20,58
2020,7,12,22,20,21,41
2020,7,12,23,16,10,26
2020,7,13,0,6,10,16
2020,7,13,1,5,5,10
2020,7,13,2,8,4,12
2020,7,13,3,15,10,25
2020,7,13,4,63,36,99
2020,7,13,5,132,67,199
2020,7,13,6,139,107,246
2020,7,13,7,154,102,256
2020,7,13,8,168,119,287
2020,7,13,9,163,142,305
2020,7,13,10,182,164,346
2020,7,13,11,194,178,372
2020,7,13,12,192,180,372
2020,7,13,13,176,166,342
2020,7,13,14,154,184,338
2020,7,13,15,142,155,297
2020,7,13,16,134,105,239
2020,7,13,17,108,114,222
2020,7,13,18,104,88,192
2020,7,13,19,51,43,94
2020,7,13,20,47,52,99
2020,7,13,21,36,41,77
2020,7,13,22,12,19,31
2020,7,13,23,6,12,18
2020,7,14,0,8,8,16
2020,7,14,1,7,6,13
2020,7,14,2,7,8,15
2020,7,14,3,17,10,27
2020,7,14,4,59,38,97
2020,7,14,5,135,75,210
2020,7,14,6,151,74,225
2020,7,14,7,138,88,226
2020,7,14,8,180,113,293
2020,7,14,9,170,119,289
2020,7,14,10,196,142,338
2020,7,14,11,188,172,360
2020,7,14,12,187,183,370
2020,7,14,13,190,187,377
2020,7,14,14,173,169,342
2020,7,14,15,108,118,226
2020,7,14,16,116,117,233
2020,7,14,17,100,101,201
2020,7,14,18,79,87,166
2020,7,14,19,78,68,146
2020,7,14,20,45,47,92
2020,7,14,21,24,34,58
2020,7,14,22,12,24,36
2020,7,14,23,13,15,28
2020,7,15,0,8,11,19
2020,7,15,1,4,10,14
2020,7,15,2,9,4,13
2020,7,15,3,13,9,22
2020,7,15,4,48,32,80
2020,7,15,5,128,68,196
2020,7,15,6,135,82,217
2020,7,15,7,155,93,248
2020,7,15,8,189,110,299
2020,7,15,9,184,138,322
2020,7,15,10,192,150,342
2020,7,15,11,197,136,333
2020,7,15,12,179,158,337
2020,7,15,13,163,182,345
2020,7,15,14,151,162,313
2020,7,15,15,141,139,280
2020,7,15,16,109,122,231
2020,7,15,17,107,110,217
2020,7,15,18,86,95,181
2020,7,15,19,68,68,136
2020,7,15,20,55,49,104
2020,7,15,21,39,32,71
2020,7,15,22,20,33,53
2020,7,15,23,15,19,34
2020,7,16,0,10,18,28
2020,7,16,1,7,15,22
2020,7,16,2,5,8,13
2020,7,16,3,16,9,25
2020,7,16,4,58,34,92
2020,7,16,5,126,72,198
2020,7,16,6,137,76,213
2020,7,16,7,130,81,211
2020,7,16,8,146,100,246
2020,7,16,9,160,124,284
2020,7,16,10,171,151,322
2020,7,16,11,187,171,358
2020,7,16,12,194,170,364
2020,7,16,13,181,178,359
2020,7,16,14,150,175,325
2020,7,16,15,133,155,288
2020,7,16,16,103,92,195
2020,7,16,17,91,109,200
2020,7,16,18,74,79,153
2020,7,16,19,60,68,128
2020,7,16,20,52,47,99
2020,7,16,21,28,43,71
2020,7,16,22,24,31,55
2020,7,16,23,11,19,30
2020,7,17,0,11,14,25
2020,7,17,1,13,16,29
2020,7,17,2,5,4,9
2020,7,17,3,17,16,33
2020,7,17,4,51,30,81
2020,7,17,5,124,83,207
2020,7,17,6,135,79,214
2020,7,17,7,130,87,217
2020,7,17,8,158,96,254
2020,7,17,9,169,121,290
2020,7,17,10,178,153,331
2020,7,17,11,213,168,381
2020,7,17,12,198,159,357
2020,7,17,13,195,169,364
2020,7,17,14,139,185,324
2020,7,17,15,137,140,277
2020,7,17,16,120,102,222
2020,7,17,17,84,84,168
2020,7,17,18,75,66,141
2020,7,17,19,59,65,124
2020,7,17,20,48,58,106
2020,7,17,21,34,43,77
2020,7,17,22,26,32,58
2020,7,17,23,22,29,51
2020,7,18,0,16,21,37
2020,7,18,1,5,20,25
2020,7,18,2,4,16,20
2020,7,18,3,15,11,26
2020,7,18,4,17,10,27
2020,7,18,5,23,17,40
2020,7,18,6,36,17,53
2020,7,18,7,42,30,72
2020,7,18,8,91,50,141
2020,7,18,9,101,88,189
2020,7,18,10,137,105,242
2020,7,18,11,147,155,302
2020,7,18,12,128,111,239
2020,7,18,13,125,128,253
2020,7,18,14,96,133,229
2020,7,18,15,121,144,265
2020,7,18,16,124,111,235
2020,7,18,17,88,81,169
2020,7,18,18,75,70,145
2020,7,18,19,65,70,135
2020,7,18,20,53,58,111
2020,7,18,21,50,56,106
2020,7,18,22,29,46,75
2020,7,18,23,26,28,54
2020,7,19,0,24,32,56
2020,7,19,1,20,26,46
2020,7,19,2,15,26,41
2020,7,19,3,9,11,20
2020,7,19,4,25,9,34
2020,7,19,5,18,15,33
2020,7,19,6,23,8,31
2020,7,19,7,29,24,53
2020,7,19,8,74,47,121
2020,7,19,9,90,74,164
2020,7,19,10,99,106,205
2020,7,19,11,133,111,244
2020,7,19,12,134,114,248
2020,7,19,13,133,121,254
2020,7,19,14,120,128,248
2020,7,19,15,130,119,249
2020,7,19,16,113,117,230
2020,7,19,17,105,110,215
2020,7,19,18,85,93,178
2020,7,19,19,87,78,165
2020,7,19,20,53,70,123
2020,7,19,21,43,41,84
2020,7,19,22,22,24,46
2020,7,19,23,11,18,29
2020,7,20,0,6,10,16
2020,7,20,1,6,10,16
2020,7,20,2,5,6,11
2020,7,20,3,14,10,24
2020,7,20,4,61,34,95
2020,7,20,5,118,71,189
2020,7,20,6,116,86,202
2020,7,20,7,137,96,233
2020,7,20,8,143,113,256
2020,7,20,9,156,122,278
2020,7,20,10,187,146,333
2020,7,20,11,331,349,680
2020,7,20,12,194,177,371
2020,7,20,13,183,160,343
2020,7,20,14,164,159,323
2020,7,20,15,133,147,280
2020,7,20,16,124,102,226
2020,7,20,17,105,122,227
2020,7,20,18,95,83,178
2020,7,20,19,56,73,129
2020,7,20,20,50,53,103
2020,7,20,21,25,31,56
2020,7,20,22,14,24,38
2020,7,20,23,12,18,30
2020,7,21,0,9,8,17
2020,7,21,1,6,6,12
2020,7,21,2,8,7,15
2020,7,21,3,11,6,17
2020,7,21,4,56,34,90
2020,7,21,5,111,75,186
2020,7,21,6,145,90,235
2020,7,21,7,114,72,186
2020,7,21,8,143,86,229
2020,7,21,9,158,120,278
2020,7,21,10,175,131,306
2020,7,21,11,185,210,395
2020,7,21,12,194,197,391
2020,7,21,13,181,166,347
2020,7,21,14,145,171,316
2020,7,21,15,115,125,240
2020,7,21,16,122,114,236
2020,7,21,17,99,109,208
2020,7,21,18,85,79,164
2020,7,21,19,77,62,139
2020,7,21,20,57,46,103
2020,7,21,21,31,36,67
2020,7,21,22,17,21,38
2020,7,21,23,11,27,38
2020,7,22,0,4,30,34
2020,7,22,1,9,9,18
2020,7,22,2,10,12,22
2020,7,22,3,11,6,17
2020,7,22,4,46,39,85
2020,7,22,5,116,68,184
2020,7,22,6,144,63,207
2020,7,22,7,119,67,186
2020,7,22,8,144,119,263
2020,7,22,9,161,114,275
2020,7,22,10,163,138,301
2020,7,22,11,195,136,331
2020,7,22,12,177,162,339
2020,7,22,13,158,174,332
2020,7,22,14,153,169,322
2020,7,22,15,141,132,273
2020,7,22,16,134,125,259
2020,7,22,17,79,94,173
2020,7,22,18,79,77,156
2020,7,22,19,66,83,149
2020,7,22,20,48,58,106
2020,7,22,21,38,44,82
2020,7,22,22,21,15,36
2020,7,22,23,17,22,39
2020,7,23,0,14,11,25
2020,7,23,1,12,13,25
2020,7,23,2,4,14,18
2020,7,23,3,9,8,17
2020,7,23,4,56,33,89
2020,7,23,5,108,63,171
2020,7,23,6,125,66,191
2020,7,23,7,125,72,197
2020,7,23,8,151,110,261
2020,7,23,9,151,106,257
2020,7,23,10,175,137,312
2020,7,23,11,178,150,328
2020,7,23,12,157,141,298
2020,7,23,13,170,175,345
2020,7,23,14,152,159,311
2020,7,23,15,140,132,272
2020,7,23,16,117,133,250
2020,7,23,17,104,111,215
2020,7,23,18,88,96,184
2020,7,23,19,91,73,164
2020,7,23,20,57,53,110
2020,7,23,21,35,34,69
2020,7,23,22,21,17,38
2020,7,23,23,20,26,46
2020,7,24,0,14,12,26
2020,7,24,1,8,14,22
2020,7,24,2,11,8,19
2020,7,24,3,14,5,19
2020,7,24,4,59,31,90
2020,7,24,5,115,64,179
2020,7,24,6,124,77,201
2020,7,24,7,114,77,191
2020,7,24,8,124,98,222
2020,7,24,9,140,130,270
2020,7,24,10,177,144,321
2020,7,24,11,189,152,341
2020,7,24,12,168,147,315
2020,7,24,13,154,162,316
2020,7,24,14,165,151,316
2020,7,24,15,154,120,274
2020,7,24,16,93,104,197
2020,7,24,17,107,112,219
2020,7,24,18,92,94,186
2020,7,24,19,79,74,153
2020,7,24,20,62,75,137
2020,7,24,21,53,50,103
2020,7,24,22,29,37,66
2020,7,24,23,21,29,50
2020,7,25,0,22,23,45
2020,7,25,1,18,26,44
2020,7,25,2,12,15,27
2020,7,25,3,9,4,13
2020,7,25,4,17,10,27
2020,7,25,5,17,18,35
2020,7,25,6,29,27,56
2020,7,25,7,49,41,90
2020,7,25,8,77,69,146
2020,7,25,9,93,92,185
2020,7,25,10,116,87,203
2020,7,25,11,142,109,251
2020,7,25,12,128,114,242
2020,7,25,13,127,105,232
2020,7,25,14,119,105,224
2020,7,25,15,125,114,239
2020,7,25,16,112,117,229
2020,7,25,17,87,95,182
2020,7,25,18,88,79,167
2020,7,25,19,63,77,140
2020,7,25,20,58,64,122
2020,7,25,21,50,50,100
2020,7,25,22,27,40,67
2020,7,25,23,23,34,57
2020,7,26,0,25,36,61
2020,7,26,1,28,29,57
2020,7,26,2,15,24,39
2020,7,26,3,14,7,21
2020,7,26,4,15,11,26
2020,7,26,5,17,13,30
2020,7,26,6,19,9,28
2020,7,26,7,27,21,48
2020,7,26,8,78,46,124
2020,7,26,9,82,72,154
2020,7,26,10,110,106,216
2020,7,26,11,149,144,293
2020,7,26,12,135,110,245
2020,7,26,13,152,121,273
2020,7,26,14,130,132,262
2020,7,26,15,125,126,251
2020,7,26,16,89,95,184
2020,7,26,17,113,96,209
2020,7,26,18,82,130,212
2020,7,26,19,86,70,156
2020,7,26,20,56,47,103
2020,7,26,21,26,24,50
2020,7,26,22,18,18,36
2020,7,26,23,12,9,21
2020,7,27,0,9,12,21
2020,7,27,1,9,11,20
2020,7,27,2,7,6,13
2020,7,27,3,11,11,22
2020,7,27,4,76,37,113
2020,7,27,5,141,83,224
2020,7,27,6,164,89,253
2020,7,27,7,156,112,268
2020,7,27,8,176,111,287
2020,7,27,9,168,114,282
2020,7,27,10,175,158,333
2020,7,27,11,204,185,389
2020,7,27,12,184,178,362
2020,7,27,13,229,202,431
2020,7,27,14,153,180,333
2020,7,27,15,127,154,281
2020,7,27,16,121,120,241
2020,7,27,17,118,98,216
2020,7,27,18,88,72,160
2020,7,27,19,64,61,125
2020,7,27,20,52,48,100
2020,7,27,21,31,28,59
2020,7,27,22,10,19,29
2020,7,27,23,14,11,25
2020,7,28,0,8,8,16
2020,7,28,1,4,7,11
2020,7,28,2,6,3,9
2020,7,28,3,16,5,21
2020,7,28,4,69,36,105
2020,7,28,5,147,86,233
2020,7,28,6,143,93,236
2020,7,28,7,160,92,252
2020,7,28,8,160,110,270
2020,7,28,9,176,108,284
2020,7,28,10,207,154,361
2020,7,28,11,205,181,386
2020,7,28,12,181,181,362
2020,7,28,13,197,189,386
2020,7,28,14,164,175,339
2020,7,28,15,141,162,303
2020,7,28,16,132,123,255
2020,7,28,17,112,114,226
2020,7,28,18,89,100,189
2020,7,28,19,77,70,147
2020,7,28,20,49,42,91
2020,7,28,21,30,41,71
2020,7,28,22,13,17,30
2020,7,28,23,12,15,27
2020,7,29,0,11,15,26
2020,7,29,1,6,10,16
2020,7,29,2,7,8,15
2020,7,29,3,14,4,18
2020,7,29,4,57,32,89
2020,7,29,5,140,67,207
2020,7,29,6,158,99,257
2020,7,29,7,165,107,272
2020,7,29,8,158,125,283
2020,7,29,9,153,136,289
2020,7,29,10,216,169,385
2020,7,29,11,196,167,363
2020,7,29,12,193,197,390
2020,7,29,13,198,190,388
2020,7,29,14,157,188,345
2020,7,29,15,142,157,299
2020,7,29,16,129,113,242
2020,7,29,17,106,102,208
2020,7,29,18,89,85,174
2020,7,29,19,64,75,139
2020,7,29,20,60,53,113
2020,7,29,21,27,35,62
2020,7,29,22,21,26,47
2020,7,29,23,10,23,33
2020,7,30,0,8,12,20
2020,7,30,1,8,7,15
2020,7,30,2,7,10,17
2020,7,30,3,9,6,15
2020,7,30,4,57,32,89
2020,7,30,5,134,62,196
2020,7,30,6,182,91,273
2020,7,30,7,156,85,241
2020,7,30,8,162,143,305
2020,7,30,9,186,126,312
2020,7,30,10,203,180,383
2020,7,30,11,224,189,413
2020,7,30,12,218,203,421
2020,7,30,13,221,214,435
2020,7,30,14,186,199,385
2020,7,30,15,172,187,359
2020,7,30,16,157,135,292
2020,7,30,17,149,144,293
2020,7,30,18,116,105,221
2020,7,30,19,99,86,185
2020,7,30,20,77,57,134
2020,7,30,21,41,29,70
2020,7,30,22,19,24,43
2020,7,30,23,24,17,41
2020,7,31,0,9,11,20
2020,7,31,1,25,13,38
2020,7,31,2,16,8,24
2020,7,31,3,18,12,30
2020,7,31,4,67,38,105
2020,7,31,5,137,77,214
2020,7,31,6,154,95,249
2020,7,31,7,167,112,279
2020,7,31,8,196,113,309
2020,7,31,9,233,175,408
2020,7,31,10,193,185,378
2020,7,31,11,214,162,376
2020,7,31,12,204,186,390
2020,7,31,13,231,200,431
2020,7,31,14,158,220,378
2020,7,31,15,181,164,345
2020,7,31,16,129,139,268
2020,7,31,17,131,109,240
2020,7,31,18,96,93,189
2020,7,31,19,82,70,152
2020,7,31,20,65,75,140
2020,7,31,21,48,56,104
2020,7,31,22,34,41,75
2020,7,31,23,23,19,42
2020,8,1,0,14,17,31
2020,8,1,1,13,10,23
2020,8,1,2,13,15,28
2020,8,1,3,8,3,11
2020,8,1,4,21,15,36
2020,8,1,5,21,20,41
2020,8,1,6,29,24,53
2020,8,1,7,57,53,110
2020,8,1,8,94,84,178
2020,8,1,9,128,97,225
2020,8,1,10,155,146,301
2020,8,1,11,158,142,300
2020,8,1,12,166,141,307
2020,8,1,13,155,179,334
2020,8,1,14,160,172,332
2020,8,1,15,141,120,261
2020,8,1,16,132,119,251
2020,8,1,17,105,101,206
2020,8,1,18,66,79,145
2020,8,1,19,61,75,136
2020,8,1,20,39,67,106
2020,8,1,21,50,51,101
2020,8,1,22,48,70,118
2020,8,1,23,26,31,57
2020,8,2,0,20,20,40
2020,8,2,1,22,31,53
2020,8,2,2,22,34,56
2020,8,2,3,12,17,29
2020,8,2,4,27,10,37
2020,8,2,5,19,17,36
2020,8,2,6,14,16,30
2020,8,2,7,45,21,66
2020,8,2,8,77,49,126
2020,8,2,9,98,64,162
2020,8,2,10,115,118,233
2020,8,2,11,136,128,264
2020,8,2,12,153,140,293
2020,8,2,13,163,161,324
2020,8,2,14,150,170,320
2020,8,2,15,161,136,297
2020,8,2,16,134,131,265
2020,8,2,17,130,130,260
2020,8,2,18,98,117,215
2020,8,2,19,84,88,172
2020,8,2,20,45,70,115
2020,8,2,21,33,31,64
2020,8,2,22,14,19,33
2020,8,2,23,12,8,20
2020,8,3,0,7,10,17
2020,8,3,1,3,9,12
2020,8,3,2,2,4,6
2020,8,3,3,22,8,30
2020,8,3,4,80,45,125
2020,8,3,5,203,93,296
2020,8,3,6,268,131,399
2020,8,3,7,192,133,325
2020,8,3,8,186,139,325
2020,8,3,9,192,157,349
2020,8,3,10,208,168,376
2020,8,3,11,223,184,407
2020,8,3,12,230,230,460
2020,8,3,13,235,230,465
2020,8,3,14,180,256,436
2020,8,3,15,185,189,374
2020,8,3,16,141,128,269
2020,8,3,17,124,115,239
2020,8,3,18,119,108,227
2020,8,3,19,95,101,196
2020,8,3,20,60,75,135
2020,8,3,21,39,36,75
2020,8,3,22,14,34,48
2020,8,3,23,16,10,26
2020,8,4,0,7,7,14
2020,8,4,1,6,5,11
2020,8,4,2,3,8,11
2020,8,4,3,11,5,16
2020,8,4,4,92,41,133
2020,8,4,5,163,78,241
2020,8,4,6,249,148,397
2020,8,4,7,223,144,367
2020,8,4,8,206,161,367
2020,8,4,9,177,138,315
2020,8,4,10,214,166,380
2020,8,4,11,237,193,430
2020,8,4,12,236,224,460
2020,8,4,13,242,250,492
2020,8,4,14,202,263,465
2020,8,4,15,153,174,327
2020,8,4,16,121,122,243
2020,8,4,17,115,119,234
2020,8,4,18,116,123,239
2020,8,4,19,82,90,172
2020,8,4,20,67,227,294
2020,8,4,21,39,122,161
2020,8,4,22,19,86,105
2020,8,4,23,13,46,59
2020,8,5,0,9,36,45
2020,8,5,1,10,25,35
2020,8,5,2,7,21,28
2020,8,5,3,12,18,30
2020,8,5,4,88,46,134
2020,8,5,5,195,93,288
2020,8,5,6,266,144,410
2020,8,5,7,209,146,355
2020,8,5,8,217,142,359
2020,8,5,9,203,150,353
2020,8,5,10,201,172,373
2020,8,5,11,236,181,417
2020,8,5,12,219,192,411
2020,8,5,13,277,304,581
2020,8,5,14,248,287,535
2020,8,5,15,157,182,339
2020,8,5,16,142,141,283
2020,8,5,17,133,138,271
2020,8,5,18,141,133,274
2020,8,5,19,81,76,157
2020,8,5,20,64,71,135
2020,8,5,21,47,30,77
