,Fra_time,Volum til SNTR,Volum til DNP,Volum totalt,is_holiday,weekdays,months
0,11,265,232,497,False,2,11
1,12,243,223,466,False,2,11
2,13,251,289,540,False,2,11
3,14,369,409,778,False,2,11
4,15,283,365,648,False,2,11
5,16,219,200,419,False,2,11
6,17,180,160,340,False,2,11
7,18,162,211,373,False,2,11
8,19,119,142,261,False,2,11
9,20,77,126,203,False,2,11
10,21,66,357,423,False,2,11
11,22,44,312,356,False,2,11
12,23,25,39,64,False,2,11
13,0,17,39,56,False,3,11
14,1,14,25,39,False,3,11
15,2,10,31,41,False,3,11
16,3,7,35,42,False,3,11
17,4,21,20,41,False,3,11
18,5,110,73,183,False,3,11
19,6,274,203,477,False,3,11
20,7,481,233,714,False,3,11
21,8,267,181,448,False,3,11
22,9,252,181,433,False,3,11
23,10,242,226,468,False,3,11
24,11,266,217,483,False,3,11
25,12,256,261,517,False,3,11
26,13,248,309,557,False,3,11
27,14,369,429,798,False,3,11
28,15,333,387,720,False,3,11
29,16,235,226,461,False,3,11
30,17,199,200,399,False,3,11
31,18,175,184,359,False,3,11
32,19,106,142,248,False,3,11
33,20,121,124,245,False,3,11
34,21,69,76,145,False,3,11
35,22,59,70,129,False,3,11
36,23,25,43,68,False,3,11
37,0,28,38,66,False,4,11
38,1,12,39,51,False,4,11
39,2,13,41,54,False,4,11
40,3,8,20,28,False,4,11
41,4,27,18,45,False,4,11
42,5,109,77,186,False,4,11
43,6,267,188,455,False,4,11
44,7,408,191,599,False,4,11
45,8,275,180,455,False,4,11
46,9,232,192,424,False,4,11
47,10,276,197,473,False,4,11
48,11,267,245,512,False,4,11
49,12,308,276,584,False,4,11
50,13,320,357,677,False,4,11
51,14,388,431,819,False,4,11
52,15,295,394,689,False,4,11
53,16,352,241,593,False,4,11
54,17,189,203,392,False,4,11
55,18,157,162,319,False,4,11
56,19,113,154,267,False,4,11
57,20,78,88,166,False,4,11
58,21,55,62,117,False,4,11
59,22,66,83,149,False,4,11
60,23,37,52,89,False,4,11
61,0,28,47,75,False,5,11
62,1,22,40,62,False,5,11
63,2,17,40,57,False,5,11
64,3,16,31,47,False,5,11
65,4,20,13,33,False,5,11
66,5,27,25,52,False,5,11
67,6,26,22,48,False,5,11
68,7,42,34,76,False,5,11
69,8,58,57,115,False,5,11
70,9,94,69,163,False,5,11
71,10,162,126,288,False,5,11
72,11,194,152,346,False,5,11
73,12,165,166,331,False,5,11
74,13,198,221,419,False,5,11
75,14,208,182,390,False,5,11
76,15,156,150,306,False,5,11
77,16,154,158,312,False,5,11
78,17,126,153,279,False,5,11
79,18,145,144,289,False,5,11
80,19,91,99,190,False,5,11
81,20,60,90,150,False,5,11
82,21,41,72,113,False,5,11
83,22,40,72,112,False,5,11
84,23,44,61,105,False,5,11
85,0,48,68,116,True,6,11
86,1,36,38,74,True,6,11
87,2,23,58,81,True,6,11
88,3,25,50,75,True,6,11
89,4,20,26,46,True,6,11
90,5,21,14,35,True,6,11
91,6,16,22,38,True,6,11
92,7,21,19,40,True,6,11
93,8,33,35,68,True,6,11
94,9,91,47,138,True,6,11
95,10,104,85,189,True,6,11
96,11,166,132,298,True,6,11
97,12,169,151,320,True,6,11
98,13,222,194,416,True,6,11
99,14,178,207,385,True,6,11
100,15,178,166,344,True,6,11
101,16,146,114,260,True,6,11
102,17,116,123,239,True,6,11
103,18,158,149,307,True,6,11
104,19,137,151,288,True,6,11
105,20,102,117,219,True,6,11
106,21,62,60,122,True,6,11
107,22,43,66,109,True,6,11
108,23,21,39,60,True,6,11
109,0,15,25,40,True,0,11
110,1,12,13,25,True,0,11
111,2,12,11,23,True,0,11
112,3,9,16,25,True,0,11
113,4,28,24,52,True,0,11
114,5,105,92,197,True,0,11
115,6,254,185,439,True,0,11
116,7,347,202,549,True,0,11
117,8,235,153,388,True,0,11
118,9,248,213,461,True,0,11
119,10,295,244,539,True,0,11
120,11,282,257,539,True,0,11
121,12,299,336,635,True,0,11
122,13,318,367,685,True,0,11
123,14,364,444,808,True,0,11
124,15,338,443,781,True,0,11
125,16,231,248,479,True,0,11
126,17,161,200,361,True,0,11
127,18,145,224,369,True,0,11
128,19,136,174,310,True,0,11
129,20,111,123,234,True,0,11
130,21,78,85,163,True,0,11
131,22,51,77,128,True,0,11
132,23,19,38,57,True,0,11
133,0,12,32,44,True,1,11
134,1,5,17,22,True,1,11
135,2,13,21,34,True,1,11
136,3,8,12,20,True,1,11
137,4,12,16,28,True,1,11
138,5,87,57,144,True,1,11
139,6,234,163,397,True,1,11
140,7,335,185,520,True,1,11
141,8,254,169,423,True,1,11
142,9,253,229,482,True,1,11
143,10,262,256,518,True,1,11
144,11,244,265,509,True,1,11
145,12,290,275,565,True,1,11
146,13,310,325,635,True,1,11
147,14,331,413,744,True,1,11
148,15,241,299,540,True,1,11
149,16,190,185,375,True,1,11
150,17,143,135,278,True,1,11
151,18,139,173,312,True,1,11
152,19,128,150,278,True,1,11
153,20,94,97,191,True,1,11
154,21,71,67,138,True,1,11
155,22,46,58,104,True,1,11
156,23,26,31,57,True,1,11
157,0,12,25,37,True,2,11
158,1,17,28,45,True,2,11
159,2,15,21,36,True,2,11
160,3,11,14,25,True,2,11
161,4,16,19,35,True,2,11
162,5,64,48,112,True,2,11
163,6,174,117,291,True,2,11
164,7,179,113,292,True,2,11
165,8,162,114,276,True,2,11
166,9,192,164,356,True,2,11
167,10,209,188,397,True,2,11
168,11,259,233,492,True,2,11
169,12,254,282,536,True,2,11
170,13,290,244,534,True,2,11
171,14,251,278,529,True,2,11
172,15,195,218,413,True,2,11
173,16,176,167,343,True,2,11
174,17,135,126,261,True,2,11
175,18,119,123,242,True,2,11
176,19,93,102,195,True,2,11
177,20,81,73,154,True,2,11
178,21,48,47,95,True,2,11
179,22,46,48,94,True,2,11
180,23,19,22,41,True,2,11
181,0,15,26,41,True,3,11
182,1,14,10,24,True,3,11
183,2,5,6,11,True,3,11
184,3,6,9,15,True,3,11
185,4,3,7,10,True,3,11
186,5,24,16,40,True,3,11
187,6,41,40,81,True,3,11
188,7,40,34,74,True,3,11
189,8,55,56,111,True,3,11
190,9,82,75,157,True,3,11
191,10,107,113,220,True,3,11
192,11,190,169,359,True,3,11
193,12,173,161,334,True,3,11
194,13,149,112,261,True,3,11
195,14,152,126,278,True,3,11
196,15,135,157,292,True,3,11
197,16,76,92,168,True,3,11
198,17,49,47,96,True,3,11
199,18,23,39,62,True,3,11
200,19,38,31,69,True,3,11
201,20,46,43,89,True,3,11
202,21,74,99,173,True,3,11
203,22,54,49,103,True,3,11
204,23,68,67,135,True,3,11
205,0,27,29,56,True,4,11
206,1,19,18,37,True,4,11
207,2,13,5,18,True,4,11
208,3,6,12,18,True,4,11
209,4,5,4,9,True,4,11
210,5,11,15,26,True,4,11
211,6,17,12,29,True,4,11
212,7,9,7,16,True,4,11
213,8,14,10,24,True,4,11
214,9,32,25,57,True,4,11
215,10,37,38,75,True,4,11
216,11,62,72,134,True,4,11
217,12,85,88,173,True,4,11
218,13,107,116,223,True,4,11
219,14,113,93,206,True,4,11
220,15,119,131,250,True,4,11
221,16,79,80,159,True,4,11
222,17,73,73,146,True,4,11
223,18,64,83,147,True,4,11
224,19,66,79,145,True,4,11
225,20,63,64,127,True,4,11
226,21,52,43,95,True,4,11
227,22,25,45,70,True,4,11
228,23,35,37,72,True,4,11
229,0,16,23,39,True,5,11
230,1,22,17,39,True,5,11
231,2,15,20,35,True,5,11
232,3,12,22,34,True,5,11
233,4,11,7,18,True,5,11
234,5,17,13,30,True,5,11
235,6,24,18,42,True,5,11
236,7,9,13,22,True,5,11
237,8,22,15,37,True,5,11
238,9,40,36,76,True,5,11
239,10,69,53,122,True,5,11
240,11,97,88,185,True,5,11
241,12,108,125,233,True,5,11
242,13,128,141,269,True,5,11
243,14,129,130,259,True,5,11
244,15,121,105,226,True,5,11
245,16,108,93,201,True,5,11
246,17,125,105,230,True,5,11
247,18,115,92,207,True,5,11
248,19,130,110,240,True,5,11
249,20,108,92,200,True,5,11
250,21,60,68,128,True,5,11
251,22,52,50,102,True,5,11
252,23,34,49,83,True,5,11
253,0,27,41,68,True,6,11
254,1,22,34,56,True,6,11
255,2,22,55,77,True,6,11
256,3,16,33,49,True,6,11
257,4,20,40,60,True,6,11
258,5,12,11,23,True,6,11
259,6,17,15,32,True,6,11
260,7,20,17,37,True,6,11
261,8,19,25,44,True,6,11
262,9,56,29,85,True,6,11
263,10,61,51,112,True,6,11
264,11,93,89,182,True,6,11
265,12,84,80,164,True,6,11
266,13,104,116,220,True,6,11
267,14,101,135,236,True,6,11
268,15,101,121,222,True,6,11
269,16,112,94,206,True,6,11
270,17,104,74,178,True,6,11
271,18,105,101,206,True,6,11
272,19,92,120,212,True,6,11
273,20,74,78,152,True,6,11
274,21,51,43,94,True,6,11
275,22,29,47,76,True,6,11
276,23,21,35,56,True,6,11
277,0,17,25,42,False,0,11
278,1,7,20,27,False,0,11
279,2,13,15,28,False,0,11
280,3,13,11,24,False,0,11
281,4,14,11,25,False,0,11
282,5,48,20,68,False,0,11
283,6,98,83,181,False,0,11
284,7,115,60,175,False,0,11
285,8,116,78,194,False,0,11
286,9,121,101,222,False,0,11
287,10,139,107,246,False,0,11
288,11,149,126,275,False,0,11
289,12,180,149,329,False,0,11
290,13,165,170,335,False,0,11
291,14,193,196,389,False,0,11
292,15,132,135,267,False,0,11
293,16,124,105,229,False,0,11
294,17,102,76,178,False,0,11
295,18,91,107,198,False,0,11
296,19,73,73,146,False,0,11
297,20,64,68,132,False,0,11
298,21,45,55,100,False,0,11
299,22,56,50,106,False,0,11
300,23,24,37,61,False,0,11
301,0,9,16,25,False,1,11
302,1,13,20,33,False,1,11
303,2,12,19,31,False,1,11
304,3,13,15,28,False,1,11
305,4,16,12,28,False,1,11
306,5,51,19,70,False,1,11
307,6,98,63,161,False,1,11
308,7,124,77,201,False,1,11
309,8,119,85,204,False,1,11
310,9,140,98,238,False,1,11
311,10,151,112,263,False,1,11
312,11,161,136,297,False,1,11
313,12,200,190,390,False,1,11
314,13,210,177,387,False,1,11
315,14,211,233,444,False,1,11
316,15,196,196,392,False,1,11
317,16,131,126,257,False,1,11
318,17,93,115,208,False,1,11
319,18,93,116,209,False,1,11
320,19,109,111,220,False,1,11
321,20,63,75,138,False,1,11
322,21,46,59,105,False,1,11
323,22,39,49,88,False,1,11
324,23,29,22,51,False,1,11
325,0,21,22,43,False,2,11
326,1,9,26,35,False,2,11
327,2,19,19,38,False,2,11
328,3,2,13,15,False,2,11
329,4,14,7,21,False,2,11
330,5,47,24,71,False,2,11
331,6,96,68,164,False,2,11
332,7,100,78,178,False,2,11
333,8,105,65,170,False,2,11
334,9,134,109,243,False,2,11
335,10,180,124,304,False,2,11
336,11,196,148,344,False,2,11
337,12,193,182,375,False,2,11
338,13,195,184,379,False,2,11
339,14,221,232,453,False,2,11
340,15,158,177,335,False,2,11
341,16,141,138,279,False,2,11
342,17,116,131,247,False,2,11
343,18,100,94,194,False,2,11
344,19,96,98,194,False,2,11
345,20,70,86,156,False,2,11
346,21,44,48,92,False,2,11
347,22,37,48,85,False,2,11
348,23,29,34,63,False,2,11
349,0,14,27,41,False,3,11
350,1,15,19,34,False,3,11
351,2,11,16,27,False,3,11
352,3,8,10,18,False,3,11
353,4,6,4,10,False,3,11
354,5,24,18,42,False,3,11
355,6,42,42,84,False,3,11
356,7,41,32,73,False,3,11
357,8,66,43,109,False,3,11
358,9,50,57,107,False,3,11
359,10,100,102,202,False,3,11
360,11,147,117,264,False,3,11
361,12,124,147,271,False,3,11
362,13,122,130,252,False,3,11
363,14,133,128,261,False,3,11
364,15,117,107,224,False,3,11
365,16,118,100,218,False,3,11
366,17,88,99,187,False,3,11
367,18,76,83,159,False,3,11
368,19,83,75,158,False,3,11
369,20,53,58,111,False,3,11
370,21,50,78,128,False,3,11
371,22,65,52,117,False,3,11
372,23,45,78,123,False,3,11
373,0,62,72,134,True,4,0
374,1,47,59,106,True,4,0
375,2,63,56,119,True,4,0
376,3,35,52,87,True,4,0
377,4,34,43,77,True,4,0
378,5,34,31,65,True,4,0
379,6,27,19,46,True,4,0
380,7,18,8,26,True,4,0
381,8,22,16,38,True,4,0
382,9,22,17,39,True,4,0
383,10,36,38,74,True,4,0
384,11,41,54,95,True,4,0
385,12,64,67,131,True,4,0
386,13,96,97,193,True,4,0
387,14,89,113,202,True,4,0
388,15,123,120,243,True,4,0
389,16,87,106,193,True,4,0
390,17,88,89,177,True,4,0
391,18,75,72,147,True,4,0
392,19,79,91,170,True,4,0
393,20,59,73,132,True,4,0
394,21,40,53,93,True,4,0
395,22,35,48,83,True,4,0
396,23,29,37,66,True,4,0
397,0,18,31,49,False,5,0
398,1,13,16,29,False,5,0
399,2,5,10,15,False,5,0
400,3,7,15,22,False,5,0
401,4,6,10,16,False,5,0
402,5,23,19,42,False,5,0
403,6,26,18,44,False,5,0
404,7,30,25,55,False,5,0
405,8,38,29,67,False,5,0
406,9,59,51,110,False,5,0
407,10,100,73,173,False,5,0
408,11,93,103,196,False,5,0
409,12,137,100,237,False,5,0
410,13,131,145,276,False,5,0
411,14,149,141,290,False,5,0
412,15,139,135,274,False,5,0
413,16,114,128,242,False,5,0
414,17,99,107,206,False,5,0
415,18,89,101,190,False,5,0
416,19,73,82,155,False,5,0
417,20,75,66,141,False,5,0
418,21,48,55,103,False,5,0
419,22,54,60,114,False,5,0
420,23,29,51,80,False,5,0
421,0,23,35,58,True,6,0
422,1,17,28,45,True,6,0
423,2,22,33,55,True,6,0
424,3,12,35,47,True,6,0
425,4,8,14,22,True,6,0
426,5,15,13,28,True,6,0
427,6,18,13,31,True,6,0
428,7,23,17,40,True,6,0
429,8,34,21,55,True,6,0
430,9,63,39,102,True,6,0
431,10,53,56,109,True,6,0
432,11,100,101,201,True,6,0
433,12,120,124,244,True,6,0
434,13,175,144,319,True,6,0
435,14,128,174,302,True,6,0
436,15,193,159,352,True,6,0
437,16,173,129,302,True,6,0
438,17,136,141,277,True,6,0
439,18,133,178,311,True,6,0
440,19,92,115,207,True,6,0
441,20,97,88,185,True,6,0
442,21,49,50,99,True,6,0
443,22,44,44,88,True,6,0
444,23,18,23,41,True,6,0
445,0,11,13,24,False,0,0
446,1,3,13,16,False,0,0
447,2,8,4,12,False,0,0
448,3,3,8,11,False,0,0
449,4,13,14,27,False,0,0
450,5,113,67,180,False,0,0
451,6,283,174,457,False,0,0
452,7,357,221,578,False,0,0
453,8,219,151,370,False,0,0
454,9,193,174,367,False,0,0
455,10,215,168,383,False,0,0
456,11,180,167,347,False,0,0
457,12,184,189,373,False,0,0
458,13,203,228,431,False,0,0
459,14,334,356,690,False,0,0
460,15,224,314,538,False,0,0
461,16,162,166,328,False,0,0
462,17,182,150,332,False,0,0
463,18,126,122,248,False,0,0
464,19,121,111,232,False,0,0
465,20,68,91,159,False,0,0
466,21,62,59,121,False,0,0
467,22,35,33,68,False,0,0
468,23,16,15,31,False,0,0
469,0,9,17,26,False,1,0
470,1,6,9,15,False,1,0
471,2,15,8,23,False,1,0
472,3,6,7,13,False,1,0
473,4,19,6,25,False,1,0
474,5,109,65,174,False,1,0
475,6,288,196,484,False,1,0
476,7,366,189,555,False,1,0
477,8,217,145,362,False,1,0
478,9,206,143,349,False,1,0
479,10,193,183,376,False,1,0
480,11,205,179,384,False,1,0
481,12,198,171,369,False,1,0
482,13,223,215,438,False,1,0
483,14,304,345,649,False,1,0
484,15,262,302,564,False,1,0
485,16,168,181,349,False,1,0
486,17,158,141,299,False,1,0
487,18,160,130,290,False,1,0
488,19,118,125,243,False,1,0
489,20,85,87,172,False,1,0
490,21,71,106,177,False,1,0
491,22,35,33,68,False,1,0
492,23,19,25,44,False,1,0
493,0,7,10,17,False,2,0
494,1,11,9,20,False,2,0
495,2,9,11,20,False,2,0
496,3,5,16,21,False,2,0
497,4,21,13,34,False,2,0
498,5,88,64,152,False,2,0
499,6,247,167,414,False,2,0
500,7,296,166,462,False,2,0
501,8,196,127,323,False,2,0
502,9,175,154,329,False,2,0
503,10,182,149,331,False,2,0
504,11,167,156,323,False,2,0
505,12,205,171,376,False,2,0
506,13,193,205,398,False,2,0
507,14,258,270,528,False,2,0
508,15,224,209,433,False,2,0
509,16,162,139,301,False,2,0
510,17,127,131,258,False,2,0
511,18,105,136,241,False,2,0
512,19,89,92,181,False,2,0
513,20,69,87,156,False,2,0
514,21,62,85,147,False,2,0
515,22,31,68,99,False,2,0
516,23,22,26,48,False,2,0
517,0,14,26,40,False,3,0
518,1,15,19,34,False,3,0
519,2,8,11,19,False,3,0
520,3,5,12,17,False,3,0
521,4,17,16,33,False,3,0
522,5,100,63,163,False,3,0
523,6,259,163,422,False,3,0
524,7,330,173,503,False,3,0
525,8,186,136,322,False,3,0
526,9,184,140,324,False,3,0
527,10,181,162,343,False,3,0
528,11,172,170,342,False,3,0
529,12,142,184,326,False,3,0
530,13,202,211,413,False,3,0
531,14,248,291,539,False,3,0
532,15,186,241,427,False,3,0
533,16,139,127,266,False,3,0
534,17,149,134,283,False,3,0
535,18,102,109,211,False,3,0
536,19,93,96,189,False,3,0
537,20,72,98,170,False,3,0
538,21,49,69,118,False,3,0
539,22,32,38,70,False,3,0
540,23,19,37,56,False,3,0
541,0,6,18,24,False,4,0
542,1,13,19,32,False,4,0
543,2,14,24,38,False,4,0
544,3,7,12,19,False,4,0
545,4,17,16,33,False,4,0
546,5,97,75,172,False,4,0
547,6,246,140,386,False,4,0
548,7,296,183,479,False,4,0
549,8,208,145,353,False,4,0
550,9,189,153,342,False,4,0
551,10,190,161,351,False,4,0
552,11,171,170,341,False,4,0
553,12,184,187,371,False,4,0
554,13,225,224,449,False,4,0
555,14,272,283,555,False,4,0
556,15,185,263,448,False,4,0
557,16,139,125,264,False,4,0
558,17,86,85,171,False,4,0
559,18,104,84,188,False,4,0
560,19,55,83,138,False,4,0
561,20,62,77,139,False,4,0
562,21,55,57,112,False,4,0
563,22,42,51,93,False,4,0
564,23,34,57,91,False,4,0
565,0,30,37,67,False,5,0
566,1,22,32,54,False,5,0
567,2,21,36,57,False,5,0
568,3,11,26,37,False,5,0
569,4,9,9,18,False,5,0
570,5,35,8,43,False,5,0
571,6,25,27,52,False,5,0
572,7,37,25,62,False,5,0
573,8,60,37,97,False,5,0
574,9,87,71,158,False,5,0
575,10,115,96,211,False,5,0
576,11,146,144,290,False,5,0
577,12,163,141,304,False,5,0
578,13,156,163,319,False,5,0
579,14,176,169,345,False,5,0
580,15,124,176,300,False,5,0
581,16,129,163,292,False,5,0
582,17,131,140,271,False,5,0
583,18,135,160,295,False,5,0
584,19,90,92,182,False,5,0
585,20,60,58,118,False,5,0
586,21,41,47,88,False,5,0
587,22,51,64,115,False,5,0
588,23,41,69,110,False,5,0
589,0,37,52,89,True,6,0
590,1,30,52,82,True,6,0
591,2,29,55,84,True,6,0
592,3,18,49,67,True,6,0
593,4,13,15,28,True,6,0
594,5,18,14,32,True,6,0
595,6,18,16,34,True,6,0
596,7,28,23,51,True,6,0
597,8,69,35,104,True,6,0
598,9,80,50,130,True,6,0
599,10,86,70,156,True,6,0
600,11,110,160,270,True,6,0
601,12,150,154,304,True,6,0
602,13,179,192,371,True,6,0
603,14,187,175,362,True,6,0
604,15,173,226,399,True,6,0
605,16,144,179,323,True,6,0
606,17,141,169,310,True,6,0
607,18,137,172,309,True,6,0
608,19,99,122,221,True,6,0
609,20,83,90,173,True,6,0
610,21,60,60,120,True,6,0
611,22,38,49,87,True,6,0
612,23,23,25,48,True,6,0
613,0,9,13,22,False,0,0
614,1,7,13,20,False,0,0
615,2,13,11,24,False,0,0
616,3,6,9,15,False,0,0
617,4,14,16,30,False,0,0
618,5,125,66,191,False,0,0
619,6,266,173,439,False,0,0
620,7,330,206,536,False,0,0
621,8,219,133,352,False,0,0
622,9,200,161,361,False,0,0
623,10,191,159,350,False,0,0
624,11,187,160,347,False,0,0
625,12,193,172,365,False,0,0
626,13,177,201,378,False,0,0
627,14,256,326,582,False,0,0
628,15,191,248,439,False,0,0
629,16,175,144,319,False,0,0
630,17,140,143,283,False,0,0
631,18,107,118,225,False,0,0
632,19,99,112,211,False,0,0
633,20,80,90,170,False,0,0
634,21,60,75,135,False,0,0
635,22,24,38,62,False,0,0
636,23,18,24,42,False,0,0
637,0,14,15,29,False,1,0
638,1,13,14,27,False,1,0
639,2,6,9,15,False,1,0
640,3,1,8,9,False,1,0
641,4,18,17,35,False,1,0
642,5,125,71,196,False,1,0
643,6,268,176,444,False,1,0
644,7,336,213,549,False,1,0
645,8,225,169,394,False,1,0
646,9,196,158,354,False,1,0
647,10,159,129,288,False,1,0
648,11,198,191,389,False,1,0
649,12,174,190,364,False,1,0
650,13,228,248,476,False,1,0
651,14,290,299,589,False,1,0
652,15,232,277,509,False,1,0
653,16,153,188,341,False,1,0
654,17,147,138,285,False,1,0
655,18,137,133,270,False,1,0
656,19,102,106,208,False,1,0
657,20,69,98,167,False,1,0
658,21,65,91,156,False,1,0
659,22,32,45,77,False,1,0
660,23,13,16,29,False,1,0
661,0,11,14,25,False,2,0
662,1,8,9,17,False,2,0
663,2,8,19,27,False,2,0
664,3,7,12,19,False,2,0
665,4,16,16,32,False,2,0
666,5,132,75,207,False,2,0
667,6,254,202,456,False,2,0
668,7,434,239,673,False,2,0
669,8,255,150,405,False,2,0
670,9,229,180,409,False,2,0
671,10,233,186,419,False,2,0
672,11,187,194,381,False,2,0
673,12,211,219,430,False,2,0
674,13,198,241,439,False,2,0
675,14,329,364,693,False,2,0
676,15,259,326,585,False,2,0
677,16,183,201,384,False,2,0
678,17,141,136,277,False,2,0
679,18,142,131,273,False,2,0
680,19,114,123,237,False,2,0
681,20,94,113,207,False,2,0
682,21,55,81,136,False,2,0
683,22,42,52,94,False,2,0
684,23,23,25,48,False,2,0
685,0,10,20,30,False,3,0
686,1,7,14,21,False,3,0
687,2,11,9,20,False,3,0
688,3,5,18,23,False,3,0
689,4,16,13,29,False,3,0
690,5,120,68,188,False,3,0
691,6,276,192,468,False,3,0
692,7,395,217,612,False,3,0
693,8,253,159,412,False,3,0
694,9,213,171,384,False,3,0
695,10,200,179,379,False,3,0
696,11,204,166,370,False,3,0
697,12,223,237,460,False,3,0
698,13,236,237,473,False,3,0
699,14,344,335,679,False,3,0
700,15,254,303,557,False,3,0
701,16,169,189,358,False,3,0
702,17,197,189,386,False,3,0
703,18,150,144,294,False,3,0
704,19,109,115,224,False,3,0
705,20,84,116,200,False,3,0
706,21,54,103,157,False,3,0
707,22,39,50,89,False,3,0
708,23,24,28,52,False,3,0
709,0,16,19,35,False,4,0
710,1,17,31,48,False,4,0
711,2,23,28,51,False,4,0
712,3,9,28,37,False,4,0
713,4,20,17,37,False,4,0
714,5,131,63,194,False,4,0
715,6,275,182,457,False,4,0
716,7,424,213,637,False,4,0
717,8,274,150,424,False,4,0
718,9,216,195,411,False,4,0
719,10,226,192,418,False,4,0
720,11,248,188,436,False,4,0
721,12,251,265,516,False,4,0
722,13,287,286,573,False,4,0
723,14,280,247,527,False,4,0
724,15,250,251,501,False,4,0
725,16,148,327,475,False,4,0
726,17,145,323,468,False,4,0
727,18,101,144,245,False,4,0
728,19,88,105,193,False,4,0
729,20,63,85,148,False,4,0
730,21,63,71,134,False,4,0
731,22,56,64,120,False,4,0
732,23,40,51,91,False,4,0
733,0,24,44,68,False,5,0
734,1,24,50,74,False,5,0
735,2,19,39,58,False,5,0
736,3,15,46,61,False,5,0
737,4,14,10,24,False,5,0
738,5,27,19,46,False,5,0
739,6,46,36,82,False,5,0
740,7,33,26,59,False,5,0
741,8,46,42,88,False,5,0
742,9,71,62,133,False,5,0
743,10,99,70,169,False,5,0
744,11,116,123,239,False,5,0
745,12,131,119,250,False,5,0
746,13,119,138,257,False,5,0
747,14,129,109,238,False,5,0
748,15,111,118,229,False,5,0
749,16,113,124,237,False,5,0
750,17,116,99,215,False,5,0
751,18,112,106,218,False,5,0
752,19,87,75,162,False,5,0
753,20,64,67,131,False,5,0
754,21,47,52,99,False,5,0
755,22,51,62,113,False,5,0
756,23,41,54,95,False,5,0
757,0,35,50,85,True,6,0
758,1,29,52,81,True,6,0
759,2,29,51,80,True,6,0
760,3,21,36,57,True,6,0
761,4,15,23,38,True,6,0
762,5,17,15,32,True,6,0
763,6,18,11,29,True,6,0
764,7,30,29,59,True,6,0
765,8,42,36,78,True,6,0
766,9,68,47,115,True,6,0
767,10,76,52,128,True,6,0
768,11,92,113,205,True,6,0
769,12,125,92,217,True,6,0
770,13,162,140,302,True,6,0
771,14,146,131,277,True,6,0
772,15,138,165,303,True,6,0
773,16,140,139,279,True,6,0
774,17,98,104,202,True,6,0
775,18,132,112,244,True,6,0
776,19,110,101,211,True,6,0
777,20,69,92,161,True,6,0
778,21,65,52,117,True,6,0
779,22,50,43,93,True,6,0
780,23,16,19,35,True,6,0
781,0,13,15,28,False,0,0
782,1,6,14,20,False,0,0
783,2,10,9,19,False,0,0
784,3,8,7,15,False,0,0
785,4,17,15,32,False,0,0
786,5,130,56,186,False,0,0
787,6,269,173,442,False,0,0
788,7,373,165,538,False,0,0
789,8,259,183,442,False,0,0
790,9,194,164,358,False,0,0
791,10,204,160,364,False,0,0
792,11,209,148,357,False,0,0
793,12,208,206,414,False,0,0
794,13,187,240,427,False,0,0
795,14,297,294,591,False,0,0
796,15,225,293,518,False,0,0
797,16,145,168,313,False,0,0
798,17,146,120,266,False,0,0
799,18,123,122,245,False,0,0
800,19,102,101,203,False,0,0
801,20,83,105,188,False,0,0
802,21,53,219,272,False,0,0
803,22,27,162,189,False,0,0
804,23,19,40,59,False,0,0
805,0,25,20,45,False,1,0
806,1,9,9,18,False,1,0
807,2,13,11,24,False,1,0
808,3,12,9,21,False,1,0
809,4,26,22,48,False,1,0
810,5,114,67,181,False,1,0
811,6,248,184,432,False,1,0
812,7,391,172,563,False,1,0
813,8,249,162,411,False,1,0
814,9,213,137,350,False,1,0
815,10,221,160,381,False,1,0
816,11,213,177,390,False,1,0
817,12,210,189,399,False,1,0
818,13,213,244,457,False,1,0
819,14,285,348,633,False,1,0
820,15,246,278,524,False,1,0
821,16,173,165,338,False,1,0
822,17,191,159,350,False,1,0
823,18,156,133,289,False,1,0
824,19,99,109,208,False,1,0
825,20,90,88,178,False,1,0
826,21,57,82,139,False,1,0
827,22,44,40,84,False,1,0
828,23,17,29,46,False,1,0
829,0,12,23,35,False,2,0
830,1,13,17,30,False,2,0
831,2,25,23,48,False,2,0
832,3,7,13,20,False,2,0
833,4,17,20,37,False,2,0
834,5,116,68,184,False,2,0
835,6,276,183,459,False,2,0
836,7,390,211,601,False,2,0
837,8,243,151,394,False,2,0
838,9,219,162,381,False,2,0
839,10,224,159,383,False,2,0
840,11,195,191,386,False,2,0
841,12,193,173,366,False,2,0
842,13,230,276,506,False,2,0
843,14,307,321,628,False,2,0
844,15,209,311,520,False,2,0
845,16,202,213,415,False,2,0
846,17,178,126,304,False,2,0
847,18,154,134,288,False,2,0
848,19,102,114,216,False,2,0
849,20,58,81,139,False,2,0
850,21,57,58,115,False,2,0
851,22,45,43,88,False,2,0
852,23,16,33,49,False,2,0
853,0,14,17,31,False,3,0
854,1,8,16,24,False,3,0
855,2,9,16,25,False,3,0
856,3,11,9,20,False,3,0
857,4,19,13,32,False,3,0
858,5,121,66,187,False,3,0
859,6,255,173,428,False,3,0
860,7,422,192,614,False,3,0
861,8,260,155,415,False,3,0
862,9,218,157,375,False,3,0
863,10,173,144,317,False,3,0
864,11,146,144,290,False,3,0
865,12,218,181,399,False,3,0
866,13,203,240,443,False,3,0
867,14,309,328,637,False,3,0
868,15,264,301,565,False,3,0
869,16,188,180,368,False,3,0
870,17,163,169,332,False,3,0
871,18,168,159,327,False,3,0
872,19,103,116,219,False,3,0
873,20,82,113,195,False,3,0
874,21,83,62,145,False,3,0
875,22,38,45,83,False,3,0
876,23,25,31,56,False,3,0
877,0,14,22,36,False,4,0
878,1,13,27,40,False,4,0
879,2,16,19,35,False,4,0
880,3,12,13,25,False,4,0
881,4,16,11,27,False,4,0
882,5,128,69,197,False,4,0
883,6,247,172,419,False,4,0
884,7,377,208,585,False,4,0
885,8,238,157,395,False,4,0
886,9,217,180,397,False,4,0
887,10,233,178,411,False,4,0
888,11,214,230,444,False,4,0
889,12,231,244,475,False,4,0
890,13,271,308,579,False,4,0
891,14,332,356,688,False,4,0
892,15,226,291,517,False,4,0
893,16,155,170,325,False,4,0
894,17,176,139,315,False,4,0
895,18,124,121,245,False,4,0
896,19,95,89,184,False,4,0
897,20,68,84,152,False,4,0
898,21,48,63,111,False,4,0
899,22,46,68,114,False,4,0
900,23,30,61,91,False,4,0
901,0,32,47,79,False,5,0
902,1,23,41,64,False,5,0
903,2,14,48,62,False,5,0
904,3,14,39,53,False,5,0
905,4,14,9,23,False,5,0
906,5,31,17,48,False,5,0
907,6,35,18,53,False,5,0
908,7,39,25,64,False,5,0
909,8,66,40,106,False,5,0
910,9,87,67,154,False,5,0
911,10,143,113,256,False,5,0
912,11,164,126,290,False,5,0
913,12,152,159,311,False,5,0
914,13,180,148,328,False,5,0
915,14,140,189,329,False,5,0
916,15,144,163,307,False,5,0
917,16,120,130,250,False,5,0
918,17,120,127,247,False,5,0
919,18,106,118,224,False,5,0
920,19,82,78,160,False,5,0
921,20,61,99,160,False,5,0
922,21,60,52,112,False,5,0
923,22,49,48,97,False,5,0
924,23,42,88,130,False,5,0
925,0,32,64,96,True,6,0
926,1,33,61,94,True,6,0
927,2,44,74,118,True,6,0
928,3,24,36,60,True,6,0
929,4,16,25,41,True,6,0
930,5,30,14,44,True,6,0
931,6,11,14,25,True,6,0
932,7,27,15,42,True,6,0
933,8,36,30,66,True,6,0
934,9,90,46,136,True,6,0
935,10,101,78,179,True,6,0
936,11,128,108,236,True,6,0
937,12,145,158,303,True,6,0
938,13,181,197,378,True,6,0
939,14,145,188,333,True,6,0
940,15,163,212,375,True,6,0
941,16,141,132,273,True,6,0
942,17,139,126,265,True,6,0
943,18,169,133,302,True,6,0
944,19,101,154,255,True,6,0
945,20,74,95,169,True,6,0
946,21,61,86,147,True,6,0
947,22,33,44,77,True,6,0
948,23,14,18,32,True,6,0
949,0,7,17,24,False,0,0
950,1,5,12,17,False,0,0
951,2,8,11,19,False,0,0
952,3,8,11,19,False,0,0
953,4,17,19,36,False,0,0
954,5,123,61,184,False,0,0
955,6,270,181,451,False,0,0
956,7,380,219,599,False,0,0
957,8,276,149,425,False,0,0
958,9,225,175,400,False,0,0
959,10,232,195,427,False,0,0
960,11,218,190,408,False,0,0
961,12,220,200,420,False,0,0
962,13,206,283,489,False,0,0
963,14,298,363,661,False,0,0
964,15,235,297,532,False,0,0
965,16,212,201,413,False,0,0
966,17,195,154,349,False,0,0
967,18,144,159,303,False,0,0
968,19,106,122,228,False,0,0
969,20,85,129,214,False,0,0
970,21,68,78,146,False,0,0
971,22,31,49,80,False,0,0
972,23,17,42,59,False,0,0
973,0,7,21,28,False,1,0
974,1,4,6,10,False,1,0
975,2,8,11,19,False,1,0
976,3,4,3,7,False,1,0
977,4,19,16,35,False,1,0
978,5,126,60,186,False,1,0
979,6,293,198,491,False,1,0
980,7,415,216,631,False,1,0
981,8,246,173,419,False,1,0
982,9,210,171,381,False,1,0
983,10,241,192,433,False,1,0
984,11,229,219,448,False,1,0
985,12,222,226,448,False,1,0
986,13,268,273,541,False,1,0
987,14,325,361,686,False,1,0
988,15,263,309,572,False,1,0
989,16,181,197,378,False,1,0
990,17,192,173,365,False,1,0
991,18,135,150,285,False,1,0
992,19,134,128,262,False,1,0
993,20,77,101,178,False,1,0
994,21,63,85,148,False,1,0
995,22,33,41,74,False,1,0
996,23,16,23,39,False,1,0
997,0,8,25,33,False,2,0
998,1,9,16,25,False,2,0
999,2,15,24,39,False,2,0
1000,3,4,10,14,False,2,0
1001,4,9,17,26,False,2,0
1002,5,141,79,220,False,2,0
1003,6,283,214,497,False,2,0
1004,7,438,212,650,False,2,0
1005,8,260,143,403,False,2,0
1006,9,249,179,428,False,2,0
1007,10,232,196,428,False,2,0
1008,11,225,224,449,False,2,0
1009,12,224,199,423,False,2,0
1010,13,230,250,480,False,2,0
1011,14,324,367,691,False,2,0
1012,15,254,278,532,False,2,0
1013,16,234,199,433,False,2,0
1014,17,175,166,341,False,2,0
1015,18,142,151,293,False,2,0
1016,19,110,124,234,False,2,0
1017,20,82,114,196,False,2,0
1018,21,36,89,125,False,2,0
1019,22,25,46,71,False,2,0
1020,23,11,31,42,False,2,0
1021,0,6,22,28,False,3,0
1022,1,7,21,28,False,3,0
1023,2,11,16,27,False,3,0
1024,3,4,11,15,False,3,0
1025,4,16,20,36,False,3,0
1026,5,134,64,198,False,3,0
1027,6,289,195,484,False,3,0
1028,7,467,218,685,False,3,0
1029,8,253,179,432,False,3,0
1030,9,232,188,420,False,3,0
1031,10,218,201,419,False,3,0
1032,11,252,203,455,False,3,0
1033,12,191,192,383,False,3,0
1034,13,236,294,530,False,3,0
1035,14,315,355,670,False,3,0
1036,15,250,297,547,False,3,0
1037,16,204,230,434,False,3,0
1038,17,179,169,348,False,3,0
1039,18,158,177,335,False,3,0
1040,19,124,129,253,False,3,0
1041,20,88,107,195,False,3,0
1042,21,69,82,151,False,3,0
1043,22,40,53,93,False,3,0
1044,23,19,32,51,False,3,0
1045,0,10,29,39,False,4,0
1046,1,11,29,40,False,4,0
1047,2,19,21,40,False,4,0
1048,3,7,16,23,False,4,0
1049,4,18,20,38,False,4,0
1050,5,132,69,201,False,4,0
1051,6,274,171,445,False,4,0
1052,7,453,249,702,False,4,0
1053,8,245,166,411,False,4,0
1054,9,249,217,466,False,4,0
1055,10,275,278,553,False,4,0
1056,11,287,342,629,False,4,0
1057,12,233,278,511,False,4,0
1058,13,228,239,467,False,4,0
1059,14,205,225,430,False,4,0
1060,15,156,184,340,False,4,0
1061,16,159,154,313,False,4,0
1062,17,114,116,230,False,4,0
1063,18,98,89,187,False,4,0
1064,19,73,74,147,False,4,0
1065,20,68,67,135,False,4,0
1066,21,60,85,145,False,4,0
1067,22,50,66,116,False,4,0
1068,23,36,58,94,False,4,0
1069,0,35,38,73,False,5,0
1070,1,18,44,62,False,5,0
1071,2,24,44,68,False,5,0
1072,3,13,28,41,False,5,0
1073,4,13,16,29,False,5,0
1074,5,29,12,41,False,5,0
1075,6,30,19,49,False,5,0
1076,7,47,38,85,False,5,0
1077,8,54,32,86,False,5,0
1078,9,103,80,183,False,5,0
1079,10,146,106,252,False,5,0
1080,11,162,143,305,False,5,0
1081,12,176,164,340,False,5,0
1082,13,158,188,346,False,5,0
1083,14,155,186,341,False,5,0
1084,15,159,163,322,False,5,0
1085,16,150,165,315,False,5,0
1086,17,132,122,254,False,5,0
1087,18,112,103,215,False,5,0
1088,19,88,114,202,False,5,0
1089,20,66,69,135,False,5,0
1090,21,67,67,134,False,5,0
1091,22,53,73,126,False,5,0
1092,23,40,71,111,False,5,0
1093,0,31,57,88,True,6,0
1094,1,40,65,105,True,6,0
1095,2,34,91,125,True,6,0
1096,3,18,40,58,True,6,0
1097,4,19,27,46,True,6,0
1098,5,17,16,33,True,6,0
1099,6,26,20,46,True,6,0
1100,7,29,21,50,True,6,0
1101,8,35,34,69,True,6,0
1102,9,79,50,129,True,6,0
1103,10,104,72,176,True,6,0
1104,11,125,103,228,True,6,0
1105,12,121,130,251,True,6,0
1106,13,177,169,346,True,6,0
1107,14,120,163,283,True,6,0
1108,15,145,205,350,True,6,0
1109,16,149,161,310,True,6,0
1110,17,130,130,260,True,6,0
1111,18,124,138,262,True,6,0
1112,19,109,126,235,True,6,0
1113,20,73,83,156,True,6,0
1114,21,38,190,228,True,6,0
1115,22,43,122,165,True,6,0
1116,23,25,31,56,True,6,0
1117,0,15,14,29,False,0,1
1118,1,12,4,16,False,0,1
1119,2,5,9,14,False,0,1
1120,3,7,13,20,False,0,1
1121,4,19,16,35,False,0,1
1122,5,137,72,209,False,0,1
1123,6,242,179,421,False,0,1
1124,7,355,184,539,False,0,1
1125,8,273,168,441,False,0,1
1126,9,197,178,375,False,0,1
1127,10,234,173,407,False,0,1
1128,11,143,136,279,False,0,1
1129,12,215,209,424,False,0,1
1130,13,217,237,454,False,0,1
1131,14,256,323,579,False,0,1
1132,15,226,282,508,False,0,1
1133,16,197,185,382,False,0,1
1134,17,155,126,281,False,0,1
1135,18,143,144,287,False,0,1
1136,19,110,120,230,False,0,1
1137,20,64,107,171,False,0,1
1138,21,60,80,140,False,0,1
1139,22,35,42,77,False,0,1
1140,23,19,12,31,False,0,1
1141,0,7,17,24,False,1,1
1142,1,7,8,15,False,1,1
1143,2,6,8,14,False,1,1
1144,3,8,10,18,False,1,1
1145,4,19,13,32,False,1,1
1146,5,138,79,217,False,1,1
1147,6,236,187,423,False,1,1
1148,7,364,188,552,False,1,1
1149,8,286,176,462,False,1,1
1150,9,231,168,399,False,1,1
1151,10,256,206,462,False,1,1
1152,11,218,191,409,False,1,1
1153,12,204,203,407,False,1,1
1154,13,212,274,486,False,1,1
1155,14,234,336,570,False,1,1
1156,15,227,286,513,False,1,1
1157,16,228,188,416,False,1,1
1158,17,184,186,370,False,1,1
1159,18,137,162,299,False,1,1
1160,19,112,132,244,False,1,1
1161,20,96,95,191,False,1,1
1162,21,72,86,158,False,1,1
1163,22,33,30,63,False,1,1
1164,23,18,19,37,False,1,1
1165,0,7,21,28,False,2,1
1166,1,8,13,21,False,2,1
1167,2,11,15,26,False,2,1
1168,3,12,13,25,False,2,1
1169,4,9,23,32,False,2,1
1170,5,124,71,195,False,2,1
1171,6,231,164,395,False,2,1
1172,7,341,201,542,False,2,1
1173,8,264,170,434,False,2,1
1174,9,221,149,370,False,2,1
1175,10,214,184,398,False,2,1
1176,11,192,185,377,False,2,1
1177,12,251,227,478,False,2,1
1178,13,223,252,475,False,2,1
1179,14,265,324,589,False,2,1
1180,15,233,266,499,False,2,1
1181,16,213,181,394,False,2,1
1182,17,184,144,328,False,2,1
1183,18,145,150,295,False,2,1
1184,19,96,127,223,False,2,1
1185,20,73,105,178,False,2,1
1186,21,65,82,147,False,2,1
1187,22,33,49,82,False,2,1
1188,23,25,26,51,False,2,1
1189,0,17,27,44,False,3,1
1190,1,13,19,32,False,3,1
1191,2,12,13,25,False,3,1
1192,3,3,6,9,False,3,1
1193,4,19,17,36,False,3,1
1194,5,103,61,164,False,3,1
1195,6,218,172,390,False,3,1
1196,7,338,168,506,False,3,1
1197,8,258,156,414,False,3,1
1198,9,206,170,376,False,3,1
1199,10,203,167,370,False,3,1
1200,11,190,176,366,False,3,1
1201,12,210,196,406,False,3,1
1202,13,210,241,451,False,3,1
1203,14,239,351,590,False,3,1
1204,15,202,256,458,False,3,1
1205,16,194,210,404,False,3,1
1206,17,173,133,306,False,3,1
1207,18,226,155,381,False,3,1
1208,19,114,117,231,False,3,1
1209,20,89,110,199,False,3,1
1210,21,72,69,141,False,3,1
1211,22,42,41,83,False,3,1
1212,23,20,43,63,False,3,1
1213,0,18,40,58,False,4,1
1214,1,14,31,45,False,4,1
1215,2,16,24,40,False,4,1
1216,3,14,15,29,False,4,1
1217,4,23,17,40,False,4,1
1218,5,138,73,211,False,4,1
1219,6,224,177,401,False,4,1
1220,7,250,173,423,False,4,1
1221,8,236,154,390,False,4,1
1222,9,220,166,386,False,4,1
1223,10,262,208,470,False,4,1
1224,11,235,230,465,False,4,1
1225,12,230,196,426,False,4,1
1226,13,204,268,472,False,4,1
1227,14,272,327,599,False,4,1
1228,15,205,259,464,False,4,1
1229,16,142,186,328,False,4,1
1230,17,139,123,262,False,4,1
1231,18,113,125,238,False,4,1
1232,19,87,86,173,False,4,1
1233,20,71,87,158,False,4,1
1234,21,54,65,119,False,4,1
1235,22,36,53,89,False,4,1
1236,23,43,46,89,False,4,1
1237,0,17,42,59,False,5,1
1238,1,19,38,57,False,5,1
1239,2,22,36,58,False,5,1
1240,3,19,33,52,False,5,1
1241,4,9,9,18,False,5,1
1242,5,29,17,46,False,5,1
1243,6,29,23,52,False,5,1
1244,7,30,36,66,False,5,1
1245,8,109,65,174,False,5,1
1246,9,106,69,175,False,5,1
1247,10,139,110,249,False,5,1
1248,11,171,140,311,False,5,1
1249,12,179,151,330,False,5,1
1250,13,153,161,314,False,5,1
1251,14,151,210,361,False,5,1
1252,15,123,157,280,False,5,1
1253,16,138,160,298,False,5,1
1254,17,143,101,244,False,5,1
1255,18,112,91,203,False,5,1
1256,19,74,97,171,False,5,1
1257,20,70,84,154,False,5,1
1258,21,58,57,115,False,5,1
1259,22,37,75,112,False,5,1
1260,23,40,63,103,False,5,1
1261,0,34,52,86,True,6,1
1262,1,42,62,104,True,6,1
1263,2,31,69,100,True,6,1
1264,3,17,49,66,True,6,1
1265,4,23,24,47,True,6,1
1266,5,20,20,40,True,6,1
1267,6,28,18,46,True,6,1
1268,7,24,19,43,True,6,1
1269,8,36,25,61,True,6,1
1270,9,90,50,140,True,6,1
1271,10,107,75,182,True,6,1
1272,11,102,108,210,True,6,1
1273,12,136,166,302,True,6,1
1274,13,181,171,352,True,6,1
1275,14,160,185,345,True,6,1
1276,15,177,234,411,True,6,1
1277,16,163,167,330,True,6,1
1278,17,142,145,287,True,6,1
1279,18,157,146,303,True,6,1
1280,19,98,137,235,True,6,1
1281,20,68,97,165,True,6,1
1282,21,61,61,122,True,6,1
1283,22,39,50,89,True,6,1
1284,23,23,33,56,True,6,1
1285,0,10,19,29,False,0,1
1286,1,7,7,14,False,0,1
1287,2,12,5,17,False,0,1
1288,3,6,11,17,False,0,1
1289,4,15,15,30,False,0,1
1290,5,131,76,207,False,0,1
1291,6,257,186,443,False,0,1
1292,7,384,197,581,False,0,1
1293,8,275,141,416,False,0,1
1294,9,201,187,388,False,0,1
1295,10,215,178,393,False,0,1
1296,11,215,188,403,False,0,1
1297,12,194,218,412,False,0,1
1298,13,216,267,483,False,0,1
1299,14,243,332,575,False,0,1
1300,15,243,296,539,False,0,1
1301,16,204,166,370,False,0,1
1302,17,201,153,354,False,0,1
1303,18,127,154,281,False,0,1
1304,19,128,131,259,False,0,1
1305,20,76,101,177,False,0,1
1306,21,85,96,181,False,0,1
1307,22,33,36,69,False,0,1
1308,23,28,22,50,False,0,1
1309,0,15,11,26,False,1,1
1310,1,5,7,12,False,1,1
1311,2,12,8,20,False,1,1
1312,3,4,4,8,False,1,1
1313,4,12,14,26,False,1,1
1314,5,139,78,217,False,1,1
1315,6,275,186,461,False,1,1
1316,7,357,231,588,False,1,1
1317,8,275,159,434,False,1,1
1318,9,229,218,447,False,1,1
1319,10,233,181,414,False,1,1
1320,11,217,205,422,False,1,1
1321,12,179,218,397,False,1,1
1322,13,245,251,496,False,1,1
1323,14,260,312,572,False,1,1
1324,15,233,270,503,False,1,1
1325,16,194,209,403,False,1,1
1326,17,183,157,340,False,1,1
1327,18,160,156,316,False,1,1
1328,19,112,122,234,False,1,1
1329,20,94,147,241,False,1,1
1330,21,66,66,132,False,1,1
1331,22,37,50,87,False,1,1
1332,23,14,22,36,False,1,1
1333,0,10,20,30,False,2,1
1334,1,7,11,18,False,2,1
1335,2,14,18,32,False,2,1
1336,3,10,9,19,False,2,1
1337,4,14,21,35,False,2,1
1338,5,128,62,190,False,2,1
1339,6,243,165,408,False,2,1
1340,7,351,203,554,False,2,1
1341,8,260,165,425,False,2,1
1342,9,226,163,389,False,2,1
1343,10,212,180,392,False,2,1
1344,11,210,204,414,False,2,1
1345,12,223,187,410,False,2,1
1346,13,219,238,457,False,2,1
1347,14,229,297,526,False,2,1
1348,15,217,266,483,False,2,1
1349,16,232,190,422,False,2,1
1350,17,190,186,376,False,2,1
1351,18,129,157,286,False,2,1
1352,19,123,164,287,False,2,1
1353,20,84,122,206,False,2,1
1354,21,61,84,145,False,2,1
1355,22,38,42,80,False,2,1
1356,23,25,25,50,False,2,1
1357,0,15,21,36,False,3,1
1358,1,5,24,29,False,3,1
1359,2,11,14,25,False,3,1
1360,3,9,5,14,False,3,1
1361,4,18,11,29,False,3,1
1362,5,110,67,177,False,3,1
1363,6,231,171,402,False,3,1
1364,7,374,182,556,False,3,1
1365,8,250,147,397,False,3,1
1366,9,217,150,367,False,3,1
1367,10,183,154,337,False,3,1
1368,11,222,206,428,False,3,1
1369,12,208,215,423,False,3,1
1370,13,212,250,462,False,3,1
1371,14,248,334,582,False,3,1
1372,15,222,280,502,False,3,1
1373,16,195,203,398,False,3,1
1374,17,192,155,347,False,3,1
1375,18,168,178,346,False,3,1
1376,19,100,125,225,False,3,1
1377,20,93,121,214,False,3,1
1378,21,78,84,162,False,3,1
1379,22,46,44,90,False,3,1
1380,23,20,30,50,False,3,1
1381,0,17,27,44,False,4,1
1382,1,11,19,30,False,4,1
1383,2,12,26,38,False,4,1
1384,3,5,15,20,False,4,1
1385,4,18,21,39,False,4,1
1386,5,127,71,198,False,4,1
1387,6,259,182,441,False,4,1
1388,7,377,204,581,False,4,1
1389,8,273,179,452,False,4,1
1390,9,247,190,437,False,4,1
1391,10,210,186,396,False,4,1
1392,11,253,201,454,False,4,1
1393,12,219,248,467,False,4,1
1394,13,272,291,563,False,4,1
1395,14,262,355,617,False,4,1
1396,15,203,265,468,False,4,1
1397,16,178,177,355,False,4,1
1398,17,171,154,325,False,4,1
1399,18,127,140,267,False,4,1
1400,19,118,101,219,False,4,1
1401,20,77,106,183,False,4,1
1402,21,71,68,139,False,4,1
1403,22,52,66,118,False,4,1
1404,23,43,54,97,False,4,1
1405,0,39,49,88,False,5,1
1406,1,28,40,68,False,5,1
1407,2,32,58,90,False,5,1
1408,3,19,31,50,False,5,1
1409,4,8,16,24,False,5,1
1410,5,25,14,39,False,5,1
1411,6,30,30,60,False,5,1
1412,7,71,43,114,False,5,1
1413,8,62,53,115,False,5,1
1414,9,98,75,173,False,5,1
1415,10,120,107,227,False,5,1
1416,11,162,127,289,False,5,1
1417,12,158,136,294,False,5,1
1418,13,130,161,291,False,5,1
1419,14,151,142,293,False,5,1
1420,15,144,176,320,False,5,1
1421,16,122,149,271,False,5,1
1422,17,135,152,287,False,5,1
1423,18,97,110,207,False,5,1
1424,19,86,93,179,False,5,1
1425,20,61,81,142,False,5,1
1426,21,56,69,125,False,5,1
1427,22,55,66,121,False,5,1
1428,23,33,35,68,False,5,1
1429,0,30,28,58,True,6,1
1430,1,27,37,64,True,6,1
1431,2,34,67,101,True,6,1
1432,3,28,41,69,True,6,1
1433,4,21,24,45,True,6,1
1434,5,13,14,27,True,6,1
1435,6,23,15,38,True,6,1
1436,7,41,24,65,True,6,1
1437,8,53,48,101,True,6,1
1438,9,89,53,142,True,6,1
1439,10,98,83,181,True,6,1
1440,11,143,123,266,True,6,1
1441,12,149,161,310,True,6,1
1442,13,193,157,350,True,6,1
1443,14,174,179,353,True,6,1
1444,15,159,183,342,True,6,1
1445,16,144,179,323,True,6,1
1446,17,156,153,309,True,6,1
1447,18,161,136,297,True,6,1
1448,19,124,157,281,True,6,1
1449,20,108,93,201,True,6,1
1450,21,53,64,117,True,6,1
1451,22,39,49,88,True,6,1
1452,23,10,20,30,True,6,1
1453,0,12,18,30,False,0,1
1454,1,7,3,10,False,0,1
1455,2,9,7,16,False,0,1
1456,3,6,11,17,False,0,1
1457,4,15,16,31,False,0,1
1458,5,137,88,225,False,0,1
1459,6,253,181,434,False,0,1
1460,7,345,215,560,False,0,1
1461,8,270,166,436,False,0,1
1462,9,231,186,417,False,0,1
1463,10,234,182,416,False,0,1
1464,11,229,202,431,False,0,1
1465,12,210,212,422,False,0,1
1466,13,216,259,475,False,0,1
1467,14,257,343,600,False,0,1
1468,15,206,280,486,False,0,1
1469,16,200,207,407,False,0,1
1470,17,197,167,364,False,0,1
1471,18,156,152,308,False,0,1
1472,19,106,116,222,False,0,1
1473,20,79,117,196,False,0,1
1474,21,66,83,149,False,0,1
1475,22,37,48,85,False,0,1
1476,23,20,12,32,False,0,1
1477,0,5,8,13,False,1,1
1478,1,9,8,17,False,1,1
1479,2,9,13,22,False,1,1
1480,3,5,4,9,False,1,1
1481,4,17,12,29,False,1,1
1482,5,145,71,216,False,1,1
1483,6,260,176,436,False,1,1
1484,7,357,214,571,False,1,1
1485,8,244,167,411,False,1,1
1486,9,257,188,445,False,1,1
1487,10,254,183,437,False,1,1
1488,11,235,205,440,False,1,1
1489,12,220,222,442,False,1,1
1490,13,209,259,468,False,1,1
1491,14,244,347,591,False,1,1
1492,15,238,304,542,False,1,1
1493,16,222,188,410,False,1,1
1494,17,209,159,368,False,1,1
1495,18,148,144,292,False,1,1
1496,19,132,140,272,False,1,1
1497,20,82,128,210,False,1,1
1498,21,67,99,166,False,1,1
1499,22,38,46,84,False,1,1
1500,23,16,24,40,False,1,1
1501,0,11,26,37,False,2,1
1502,1,9,20,29,False,2,1
1503,2,7,14,21,False,2,1
1504,3,6,7,13,False,2,1
1505,4,14,15,29,False,2,1
1506,5,145,78,223,False,2,1
1507,6,271,180,451,False,2,1
1508,7,358,203,561,False,2,1
1509,8,277,180,457,False,2,1
1510,9,244,171,415,False,2,1
1511,10,235,175,410,False,2,1
1512,11,199,180,379,False,2,1
1513,12,214,202,416,False,2,1
1514,13,235,301,536,False,2,1
1515,14,265,329,594,False,2,1
1516,15,250,289,539,False,2,1
1517,16,239,205,444,False,2,1
1518,17,180,153,333,False,2,1
1519,18,181,169,350,False,2,1
1520,19,140,127,267,False,2,1
1521,20,89,154,243,False,2,1
1522,21,59,111,170,False,2,1
1523,22,41,45,86,False,2,1
1524,23,13,16,29,False,2,1
1525,0,15,23,38,False,3,1
1526,1,9,19,28,False,3,1
1527,2,9,18,27,False,3,1
1528,3,10,14,24,False,3,1
1529,4,17,13,30,False,3,1
1530,5,129,69,198,False,3,1
1531,6,240,174,414,False,3,1
1532,7,358,183,541,False,3,1
1533,8,263,160,423,False,3,1
1534,9,228,157,385,False,3,1
1535,10,221,170,391,False,3,1
1536,11,199,218,417,False,3,1
1537,12,221,237,458,False,3,1
1538,13,215,269,484,False,3,1
1539,14,272,346,618,False,3,1
1540,15,219,308,527,False,3,1
1541,16,201,207,408,False,3,1
1542,17,204,155,359,False,3,1
1543,18,168,151,319,False,3,1
1544,19,113,125,238,False,3,1
1545,20,102,122,224,False,3,1
1546,21,72,77,149,False,3,1
1547,22,55,59,114,False,3,1
1548,23,26,30,56,False,3,1
1549,0,13,30,43,False,4,1
1550,1,13,25,38,False,4,1
1551,2,25,35,60,False,4,1
1552,3,12,18,30,False,4,1
1553,4,20,16,36,False,4,1
1554,5,141,64,205,False,4,1
1555,6,253,180,433,False,4,1
1556,7,374,200,574,False,4,1
1557,8,252,156,408,False,4,1
1558,9,220,175,395,False,4,1
1559,10,230,198,428,False,4,1
1560,11,243,216,459,False,4,1
1561,12,252,230,482,False,4,1
1562,13,251,296,547,False,4,1
1563,14,311,355,666,False,4,1
1564,15,221,285,506,False,4,1
1565,16,172,207,379,False,4,1
1566,17,150,163,313,False,4,1
1567,18,135,158,293,False,4,1
1568,19,99,104,203,False,4,1
1569,20,57,102,159,False,4,1
1570,21,60,67,127,False,4,1
1571,22,47,58,105,False,4,1
1572,23,48,61,109,False,4,1
1573,0,33,58,91,False,5,1
1574,1,33,57,90,False,5,1
1575,2,29,48,77,False,5,1
1576,3,23,37,60,False,5,1
1577,4,16,16,32,False,5,1
1578,5,25,21,46,False,5,1
1579,6,27,27,54,False,5,1
1580,7,58,36,94,False,5,1
1581,8,70,55,125,False,5,1
1582,9,110,79,189,False,5,1
1583,10,151,111,262,False,5,1
1584,11,165,136,301,False,5,1
1585,12,204,175,379,False,5,1
1586,13,151,173,324,False,5,1
1587,14,171,189,360,False,5,1
1588,15,143,198,341,False,5,1
1589,16,138,160,298,False,5,1
1590,17,156,156,312,False,5,1
1591,18,136,151,287,False,5,1
1592,19,94,110,204,False,5,1
1593,20,70,72,142,False,5,1
1594,21,50,65,115,False,5,1
1595,22,55,65,120,False,5,1
1596,23,57,73,130,False,5,1
1597,0,46,72,118,True,6,1
1598,1,24,41,65,True,6,1
1599,2,39,56,95,True,6,1
1600,3,19,44,63,True,6,1
1601,4,23,19,42,True,6,1
1602,5,23,18,41,True,6,1
1603,6,22,13,35,True,6,1
1604,7,31,27,58,True,6,1
1605,8,32,37,69,True,6,1
1606,9,106,51,157,True,6,1
1607,10,117,80,197,True,6,1
1608,11,150,127,277,True,6,1
1609,12,157,158,315,True,6,1
1610,13,167,183,350,True,6,1
1611,14,194,207,401,True,6,1
1612,15,155,219,374,True,6,1
1613,16,146,160,306,True,6,1
1614,17,169,152,321,True,6,1
1615,18,140,133,273,True,6,1
1616,19,104,142,246,True,6,1
1617,20,67,89,156,True,6,1
1618,21,65,68,133,True,6,1
1619,22,46,38,84,True,6,1
1620,23,22,24,46,True,6,1
1621,0,10,13,23,False,0,1
1622,1,9,11,20,False,0,1
1623,2,8,11,19,False,0,1
1624,3,10,9,19,False,0,1
1625,4,12,8,20,False,0,1
1626,5,122,73,195,False,0,1
1627,6,261,173,434,False,0,1
1628,7,575,240,815,False,0,1
1629,8,636,213,849,False,0,1
1630,9,607,172,779,False,0,1
1631,10,276,159,435,False,0,1
1632,11,236,166,402,False,0,1
1633,12,221,215,436,False,0,1
1634,13,191,259,450,False,0,1
1635,14,239,316,555,False,0,1
1636,15,238,297,535,False,0,1
1637,16,195,201,396,False,0,1
1638,17,178,133,311,False,0,1
1639,18,155,147,302,False,0,1
1640,19,134,147,281,False,0,1
1641,20,99,105,204,False,0,1
1642,21,72,51,123,False,0,1
1643,22,38,24,62,False,0,1
1644,23,14,9,23,False,0,1
1645,0,9,7,16,False,1,1
1646,1,5,3,8,False,1,1
1647,2,8,5,13,False,1,1
1648,3,8,6,14,False,1,1
1649,4,24,19,43,False,1,1
1650,5,130,77,207,False,1,1
1651,6,286,176,462,False,1,1
1652,7,375,212,587,False,1,1
1653,8,273,173,446,False,1,1
1654,9,220,192,412,False,1,1
1655,10,243,179,422,False,1,1
1656,11,212,189,401,False,1,1
1657,12,206,207,413,False,1,1
1658,13,219,263,482,False,1,1
1659,14,260,351,611,False,1,1
1660,15,241,319,560,False,1,1
1661,16,216,181,397,False,1,1
1662,17,176,174,350,False,1,1
1663,18,143,141,284,False,1,1
1664,19,104,108,212,False,1,1
1665,20,103,101,204,False,1,1
1666,21,59,57,116,False,1,1
1667,22,38,27,65,False,1,1
1668,23,17,12,29,False,1,1
1669,0,11,10,21,False,2,1
1670,1,5,3,8,False,2,1
1671,2,11,15,26,False,2,1
1672,3,7,18,25,False,2,1
1673,4,19,6,25,False,2,1
1674,5,123,77,200,False,2,1
1675,6,260,185,445,False,2,1
1676,7,340,206,546,False,2,1
1677,8,241,140,381,False,2,1
1678,9,199,160,359,False,2,1
1679,10,214,156,370,False,2,1
1680,11,204,189,393,False,2,1
1681,12,189,196,385,False,2,1
1682,13,196,235,431,False,2,1
1683,14,236,330,566,False,2,1
1684,15,228,288,516,False,2,1
1685,16,199,171,370,False,2,1
1686,17,170,149,319,False,2,1
1687,18,154,143,297,False,2,1
1688,19,110,162,272,False,2,1
1689,20,67,107,174,False,2,1
1690,21,75,79,154,False,2,1
1691,22,43,41,84,False,2,1
1692,23,22,31,53,False,2,1
1693,0,18,41,59,False,3,1
1694,1,9,23,32,False,3,1
1695,2,14,29,43,False,3,1
1696,3,8,26,34,False,3,1
1697,4,17,16,33,False,3,1
1698,5,120,67,187,False,3,1
1699,6,238,163,401,False,3,1
1700,7,398,183,581,False,3,1
1701,8,242,157,399,False,3,1
1702,9,241,181,422,False,3,1
1703,10,228,184,412,False,3,1
1704,11,193,183,376,False,3,1
1705,12,200,190,390,False,3,1
1706,13,223,241,464,False,3,1
1707,14,271,359,630,False,3,1
1708,15,217,269,486,False,3,1
1709,16,212,203,415,False,3,1
1710,17,213,191,404,False,3,1
1711,18,150,142,292,False,3,1
1712,19,116,121,237,False,3,1
1713,20,92,118,210,False,3,1
1714,21,54,100,154,False,3,1
1715,22,37,54,91,False,3,1
1716,23,21,21,42,False,3,1
1717,0,7,25,32,False,4,1
1718,1,7,24,31,False,4,1
1719,2,19,27,46,False,4,1
1720,3,9,10,19,False,4,1
1721,4,20,17,37,False,4,1
1722,5,133,62,195,False,4,1
1723,6,242,168,410,False,4,1
1724,7,351,199,550,False,4,1
1725,8,247,157,404,False,4,1
1726,9,218,162,380,False,4,1
1727,10,212,186,398,False,4,1
1728,11,218,218,436,False,4,1
1729,12,226,258,484,False,4,1
1730,13,266,286,552,False,4,1
1731,14,269,336,605,False,4,1
1732,15,219,285,504,False,4,1
1733,16,170,187,357,False,4,1
1734,17,137,130,267,False,4,1
1735,18,135,126,261,False,4,1
1736,19,71,63,134,False,4,1
1737,20,61,74,135,False,4,1
1738,21,51,74,125,False,4,1
1739,22,57,52,109,False,4,1
1740,23,44,62,106,False,4,1
1741,0,26,40,66,False,5,1
1742,1,20,28,48,False,5,1
1743,2,21,29,50,False,5,1
1744,3,16,36,52,False,5,1
1745,4,15,21,36,False,5,1
1746,5,22,23,45,False,5,1
1747,6,33,26,59,False,5,1
1748,7,42,30,72,False,5,1
1749,8,52,44,96,False,5,1
1750,9,112,76,188,False,5,1
1751,10,132,109,241,False,5,1
1752,11,147,118,265,False,5,1
1753,12,156,160,316,False,5,1
1754,13,184,173,357,False,5,1
1755,14,138,162,300,False,5,1
1756,15,151,190,341,False,5,1
1757,16,138,206,344,False,5,1
1758,17,133,132,265,False,5,1
1759,18,99,126,225,False,5,1
1760,19,90,105,195,False,5,1
1761,20,69,69,138,False,5,1
1762,21,60,66,126,False,5,1
1763,22,55,63,118,False,5,1
1764,23,38,66,104,False,5,1
1765,0,31,66,97,True,6,1
1766,1,39,59,98,True,6,1
1767,2,31,65,96,True,6,1
1768,3,16,34,50,True,6,1
1769,4,13,11,24,True,6,1
1770,5,23,14,37,True,6,1
1771,6,20,14,34,True,6,1
1772,7,29,21,50,True,6,1
1773,8,36,47,83,True,6,1
1774,9,95,54,149,True,6,1
1775,10,116,77,193,True,6,1
1776,11,151,130,281,True,6,1
1777,12,164,157,321,True,6,1
1778,13,178,184,362,True,6,1
1779,14,157,197,354,True,6,1
1780,15,145,205,350,True,6,1
1781,16,149,167,316,True,6,1
1782,17,138,144,282,True,6,1
1783,18,145,150,295,True,6,1
1784,19,111,141,252,True,6,1
1785,20,72,72,144,True,6,1
1786,21,39,69,108,True,6,1
1787,22,43,47,90,True,6,1
1788,23,20,22,42,True,6,1
1789,0,11,15,26,False,0,1
1790,1,8,14,22,False,0,1
1791,2,4,11,15,False,0,1
1792,3,8,14,22,False,0,1
1793,4,15,14,29,False,0,1
1794,5,125,73,198,False,0,1
1795,6,265,170,435,False,0,1
1796,7,382,209,591,False,0,1
1797,8,252,145,397,False,0,1
1798,9,222,178,400,False,0,1
1799,10,194,174,368,False,0,1
1800,11,219,200,419,False,0,1
1801,12,213,212,425,False,0,1
1802,13,234,231,465,False,0,1
1803,14,264,356,620,False,0,1
1804,15,250,343,593,False,0,1
1805,16,198,209,407,False,0,1
1806,17,169,161,330,False,0,1
1807,18,129,152,281,False,0,1
1808,19,124,132,256,False,0,1
1809,20,79,109,188,False,0,1
1810,21,83,85,168,False,0,1
1811,22,34,37,71,False,0,1
1812,23,17,19,36,False,0,1
1813,0,14,12,26,False,1,2
1814,1,8,7,15,False,1,2
1815,2,8,9,17,False,1,2
1816,3,9,10,19,False,1,2
1817,4,16,11,27,False,1,2
1818,5,130,72,202,False,1,2
1819,6,261,176,437,False,1,2
1820,7,377,206,583,False,1,2
1821,8,266,186,452,False,1,2
1822,9,232,159,391,False,1,2
1823,10,229,187,416,False,1,2
1824,11,207,230,437,False,1,2
1825,12,202,228,430,False,1,2
1826,13,218,261,479,False,1,2
1827,14,254,332,586,False,1,2
1828,15,223,278,501,False,1,2
1829,16,215,213,428,False,1,2
1830,17,218,180,398,False,1,2
1831,18,146,160,306,False,1,2
1832,19,110,124,234,False,1,2
1833,20,124,121,245,False,1,2
1834,21,67,113,180,False,1,2
1835,22,40,30,70,False,1,2
1836,23,29,25,54,False,1,2
1837,0,11,20,31,False,2,2
1838,1,20,20,40,False,2,2
1839,2,11,15,26,False,2,2
1840,3,9,7,16,False,2,2
1841,4,18,15,33,False,2,2
1842,5,127,67,194,False,2,2
1843,6,253,167,420,False,2,2
1844,7,337,191,528,False,2,2
1845,8,278,178,456,False,2,2
1846,9,190,161,351,False,2,2
1847,10,206,192,398,False,2,2
1848,11,197,192,389,False,2,2
1849,12,210,193,403,False,2,2
1850,13,230,283,513,False,2,2
1851,14,252,305,557,False,2,2
1852,15,206,282,488,False,2,2
1853,16,210,209,419,False,2,2
1854,17,175,143,318,False,2,2
1855,18,149,149,298,False,2,2
1856,19,118,112,230,False,2,2
1857,20,60,84,144,False,2,2
1858,21,59,96,155,False,2,2
1859,22,40,34,74,False,2,2
1860,23,10,25,35,False,2,2
1861,0,8,12,20,False,3,2
1862,1,9,16,25,False,3,2
1863,2,6,11,17,False,3,2
1864,3,11,11,22,False,3,2
1865,4,21,17,38,False,3,2
1866,5,112,65,177,False,3,2
1867,6,264,169,433,False,3,2
1868,7,371,235,606,False,3,2
1869,8,284,172,456,False,3,2
1870,9,208,156,364,False,3,2
1871,10,215,165,380,False,3,2
1872,11,231,201,432,False,3,2
1873,12,217,225,442,False,3,2
1874,13,222,224,446,False,3,2
1875,14,239,335,574,False,3,2
1876,15,219,291,510,False,3,2
1877,16,203,206,409,False,3,2
1878,17,176,176,352,False,3,2
1879,18,165,167,332,False,3,2
1880,19,117,100,217,False,3,2
1881,20,84,114,198,False,3,2
1882,21,51,86,137,False,3,2
1883,22,43,53,96,False,3,2
1884,23,30,36,66,False,3,2
1885,0,12,26,38,False,4,2
1886,1,16,23,39,False,4,2
1887,2,11,26,37,False,4,2
1888,3,14,15,29,False,4,2
1889,4,18,11,29,False,4,2
1890,5,122,61,183,False,4,2
1891,6,250,169,419,False,4,2
1892,7,394,188,582,False,4,2
1893,8,240,147,387,False,4,2
1894,9,220,160,380,False,4,2
1895,10,239,210,449,False,4,2
1896,11,244,196,440,False,4,2
1897,12,228,230,458,False,4,2
1898,13,228,283,511,False,4,2
1899,14,246,320,566,False,4,2
1900,15,198,266,464,False,4,2
1901,16,161,152,313,False,4,2
1902,17,127,154,281,False,4,2
1903,18,135,139,274,False,4,2
1904,19,90,104,194,False,4,2
1905,20,75,93,168,False,4,2
1906,21,45,73,118,False,4,2
1907,22,56,76,132,False,4,2
1908,23,31,50,81,False,4,2
1909,0,20,29,49,False,5,2
1910,1,12,35,47,False,5,2
1911,2,21,41,62,False,5,2
1912,3,19,27,46,False,5,2
1913,4,12,11,23,False,5,2
1914,5,28,21,49,False,5,2
1915,6,42,30,72,False,5,2
1916,7,76,40,116,False,5,2
1917,8,87,57,144,False,5,2
1918,9,101,90,191,False,5,2
1919,10,141,111,252,False,5,2
1920,11,152,131,283,False,5,2
1921,12,170,147,317,False,5,2
1922,13,149,176,325,False,5,2
1923,14,142,157,299,False,5,2
1924,15,137,172,309,False,5,2
1925,16,144,166,310,False,5,2
1926,17,113,145,258,False,5,2
1927,18,88,95,183,False,5,2
1928,19,75,83,158,False,5,2
1929,20,53,77,130,False,5,2
1930,21,51,77,128,False,5,2
1931,22,48,67,115,False,5,2
1932,23,30,60,90,False,5,2
1933,0,34,54,88,True,6,2
1934,1,31,51,82,True,6,2
1935,2,31,63,94,True,6,2
1936,3,24,38,62,True,6,2
1937,4,9,22,31,True,6,2
1938,5,20,15,35,True,6,2
1939,6,15,28,43,True,6,2
1940,7,34,22,56,True,6,2
1941,8,60,40,100,True,6,2
1942,9,105,64,169,True,6,2
1943,10,100,90,190,True,6,2
1944,11,155,137,292,True,6,2
1945,12,169,146,315,True,6,2
1946,13,161,188,349,True,6,2
1947,14,143,167,310,True,6,2
1948,15,159,175,334,True,6,2
1949,16,145,159,304,True,6,2
1950,17,161,145,306,True,6,2
1951,18,150,153,303,True,6,2
1952,19,118,138,256,True,6,2
1953,20,93,112,205,True,6,2
1954,21,52,76,128,True,6,2
1955,22,36,39,75,True,6,2
1956,23,18,15,33,True,6,2
1957,0,11,9,20,False,0,2
1958,1,5,11,16,False,0,2
1959,2,9,13,22,False,0,2
1960,3,5,8,13,False,0,2
1961,4,21,16,37,False,0,2
1962,5,115,59,174,False,0,2
1963,6,269,180,449,False,0,2
1964,7,389,195,584,False,0,2
1965,8,266,169,435,False,0,2
1966,9,233,169,402,False,0,2
1967,10,214,165,379,False,0,2
1968,11,140,144,284,False,0,2
1969,12,198,168,366,False,0,2
1970,13,210,252,462,False,0,2
1971,14,247,329,576,False,0,2
1972,15,229,320,549,False,0,2
1973,16,225,204,429,False,0,2
1974,17,169,137,306,False,0,2
1975,18,156,162,318,False,0,2
1976,19,125,132,257,False,0,2
1977,20,91,129,220,False,0,2
1978,21,57,86,143,False,0,2
1979,22,38,38,76,False,0,2
1980,23,23,20,43,False,0,2
1981,0,17,16,33,False,1,2
1982,1,4,5,9,False,1,2
1983,2,6,6,12,False,1,2
1984,3,5,8,13,False,1,2
1985,4,15,14,29,False,1,2
1986,5,122,68,190,False,1,2
1987,6,238,172,410,False,1,2
1988,7,367,207,574,False,1,2
1989,8,277,183,460,False,1,2
1990,9,225,159,384,False,1,2
1991,10,216,172,388,False,1,2
1992,11,237,177,414,False,1,2
1993,12,216,218,434,False,1,2
1994,13,211,259,470,False,1,2
1995,14,242,340,582,False,1,2
1996,15,236,302,538,False,1,2
1997,16,218,214,432,False,1,2
1998,17,166,157,323,False,1,2
1999,18,138,145,283,False,1,2
2000,19,106,144,250,False,1,2
2001,20,88,134,222,False,1,2
2002,21,59,101,160,False,1,2
2003,22,40,53,93,False,1,2
2004,23,19,15,34,False,1,2
2005,0,10,17,27,False,2,2
2006,1,8,10,18,False,2,2
2007,2,10,17,27,False,2,2
2008,3,11,11,22,False,2,2
2009,4,16,16,32,False,2,2
2010,5,119,63,182,False,2,2
2011,6,258,209,467,False,2,2
2012,7,424,190,614,False,2,2
2013,8,271,170,441,False,2,2
2014,9,184,155,339,False,2,2
2015,10,229,188,417,False,2,2
2016,11,216,185,401,False,2,2
2017,12,217,230,447,False,2,2
2018,13,238,252,490,False,2,2
2019,14,241,338,579,False,2,2
2020,15,231,282,513,False,2,2
2021,16,202,207,409,False,2,2
2022,17,201,152,353,False,2,2
2023,18,141,175,316,False,2,2
2024,19,117,114,231,False,2,2
2025,20,90,140,230,False,2,2
2026,21,52,95,147,False,2,2
2027,22,36,43,79,False,2,2
2028,23,29,29,58,False,2,2
2029,0,9,15,24,False,3,2
2030,1,4,12,16,False,3,2
2031,2,11,12,23,False,3,2
2032,3,5,12,17,False,3,2
2033,4,20,6,26,False,3,2
2034,5,114,78,192,False,3,2
2035,6,236,174,410,False,3,2
2036,7,369,218,587,False,3,2
2037,8,274,156,430,False,3,2
2038,9,218,191,409,False,3,2
2039,10,206,168,374,False,3,2
2040,11,212,187,399,False,3,2
2041,12,208,240,448,False,3,2
2042,13,226,254,480,False,3,2
2043,14,273,337,610,False,3,2
2044,15,198,252,450,False,3,2
2045,16,229,212,441,False,3,2
2046,17,192,179,371,False,3,2
2047,18,130,171,301,False,3,2
2048,19,121,174,295,False,3,2
2049,20,87,112,199,False,3,2
2050,21,62,344,406,False,3,2
2051,22,41,254,295,False,3,2
2052,23,16,100,116,False,3,2
2053,0,9,49,58,False,4,2
2054,1,14,43,57,False,4,2
2055,2,23,34,57,False,4,2
2056,3,11,13,24,False,4,2
2057,4,23,13,36,False,4,2
2058,5,116,64,180,False,4,2
2059,6,247,172,419,False,4,2
2060,7,339,180,519,False,4,2
2061,8,264,161,425,False,4,2
2062,9,211,223,434,False,4,2
2063,10,221,191,412,False,4,2
2064,11,237,214,451,False,4,2
2065,12,263,231,494,False,4,2
2066,13,251,283,534,False,4,2
2067,14,260,351,611,False,4,2
2068,15,201,273,474,False,4,2
2069,16,179,201,380,False,4,2
2070,17,180,154,334,False,4,2
2071,18,141,152,293,False,4,2
2072,19,101,120,221,False,4,2
2073,20,74,104,178,False,4,2
2074,21,70,85,155,False,4,2
2075,22,52,71,123,False,4,2
2076,23,42,59,101,False,4,2
2077,0,18,44,62,False,5,2
2078,1,27,48,75,False,5,2
2079,2,25,48,73,False,5,2
2080,3,19,38,57,False,5,2
2081,4,13,15,28,False,5,2
2082,5,28,19,47,False,5,2
2083,6,34,19,53,False,5,2
2084,7,66,38,104,False,5,2
2085,8,85,85,170,False,5,2
2086,9,155,94,249,False,5,2
2087,10,170,139,309,False,5,2
2088,11,185,148,333,False,5,2
2089,12,193,190,383,False,5,2
2090,13,199,202,401,False,5,2
2091,14,172,173,345,False,5,2
2092,15,127,161,288,False,5,2
2093,16,160,189,349,False,5,2
2094,17,128,151,279,False,5,2
2095,18,128,130,258,False,5,2
2096,19,72,98,170,False,5,2
2097,20,75,77,152,False,5,2
2098,21,57,64,121,False,5,2
2099,22,35,62,97,False,5,2
2100,23,38,69,107,False,5,2
2101,0,35,73,108,True,6,2
2102,1,45,80,125,True,6,2
2103,2,33,58,91,True,6,2
2104,3,30,41,71,True,6,2
2105,4,21,15,36,True,6,2
2106,5,14,12,26,True,6,2
2107,6,17,24,41,True,6,2
2108,7,60,23,83,True,6,2
2109,8,67,70,137,True,6,2
2110,9,125,80,205,True,6,2
2111,10,147,112,259,True,6,2
2112,11,150,143,293,True,6,2
2113,12,155,156,311,True,6,2
2114,13,178,243,421,True,6,2
2115,14,148,186,334,True,6,2
2116,15,127,220,347,True,6,2
2117,16,156,174,330,True,6,2
2118,17,139,124,263,True,6,2
2119,18,97,121,218,True,6,2
2120,19,133,153,286,True,6,2
2121,20,96,99,195,True,6,2
2122,21,50,74,124,True,6,2
2123,22,32,29,61,True,6,2
2124,23,12,23,35,True,6,2
2125,0,15,13,28,False,0,2
2126,1,9,22,31,False,0,2
2127,2,9,11,20,False,0,2
2128,3,6,11,17,False,0,2
2129,4,15,12,27,False,0,2
2130,5,121,73,194,False,0,2
2131,6,250,170,420,False,0,2
2132,7,370,181,551,False,0,2
2133,8,255,165,420,False,0,2
2134,9,221,145,366,False,0,2
2135,10,194,182,376,False,0,2
2136,11,201,186,387,False,0,2
2137,12,211,187,398,False,0,2
2138,13,229,248,477,False,0,2
2139,14,235,317,552,False,0,2
2140,15,259,291,550,False,0,2
2141,16,202,198,400,False,0,2
2142,17,199,165,364,False,0,2
2143,18,154,178,332,False,0,2
2144,19,110,128,238,False,0,2
2145,20,97,127,224,False,0,2
2146,21,45,65,110,False,0,2
2147,22,36,41,77,False,0,2
2148,23,19,27,46,False,0,2
2149,0,6,12,18,False,1,2
2150,1,6,10,16,False,1,2
2151,2,9,6,15,False,1,2
2152,3,3,6,9,False,1,2
2153,4,16,9,25,False,1,2
2154,5,130,62,192,False,1,2
2155,6,241,196,437,False,1,2
2156,7,360,203,563,False,1,2
2157,8,256,167,423,False,1,2
2158,9,231,175,406,False,1,2
2159,10,207,193,400,False,1,2
2160,11,231,191,422,False,1,2
2161,12,237,207,444,False,1,2
2162,13,233,246,479,False,1,2
2163,14,233,316,549,False,1,2
2164,15,247,285,532,False,1,2
2165,16,187,196,383,False,1,2
2166,17,201,174,375,False,1,2
2167,18,163,166,329,False,1,2
2168,19,134,123,257,False,1,2
2169,20,78,135,213,False,1,2
2170,21,71,92,163,False,1,2
2171,22,23,28,51,False,1,2
2172,23,22,19,41,False,1,2
2173,0,14,19,33,False,2,2
2174,1,12,14,26,False,2,2
2175,2,13,19,32,False,2,2
2176,3,3,7,10,False,2,2
2177,4,16,10,26,False,2,2
2178,5,105,73,178,False,2,2
2179,6,258,179,437,False,2,2
2180,7,346,210,556,False,2,2
2181,8,280,159,439,False,2,2
2182,9,242,184,426,False,2,2
2183,10,206,170,376,False,2,2
2184,11,208,212,420,False,2,2
2185,12,242,237,479,False,2,2
2186,13,247,304,551,False,2,2
2187,14,268,320,588,False,2,2
2188,15,234,311,545,False,2,2
2189,16,242,207,449,False,2,2
2190,17,181,155,336,False,2,2
2191,18,178,180,358,False,2,2
2192,19,134,158,292,False,2,2
2193,20,98,118,216,False,2,2
2194,21,66,106,172,False,2,2
2195,22,43,61,104,False,2,2
2196,23,19,29,48,False,2,2
2197,0,13,24,37,False,3,2
2198,1,6,13,19,False,3,2
2199,2,8,12,20,False,3,2
2200,3,6,7,13,False,3,2
2201,4,16,10,26,False,3,2
2202,5,135,71,206,False,3,2
2203,6,256,193,449,False,3,2
2204,7,390,215,605,False,3,2
2205,8,257,173,430,False,3,2
2206,9,159,123,282,False,3,2
2207,10,234,192,426,False,3,2
2208,11,260,200,460,False,3,2
2209,12,202,215,417,False,3,2
2210,13,232,294,526,False,3,2
2211,14,331,456,787,False,3,2
2212,15,262,318,580,False,3,2
2213,16,206,181,387,False,3,2
2214,17,223,177,400,False,3,2
2215,18,176,178,354,False,3,2
2216,19,132,160,292,False,3,2
2217,20,93,124,217,False,3,2
2218,21,63,82,145,False,3,2
2219,22,46,65,111,False,3,2
2220,23,18,28,46,False,3,2
2221,0,14,35,49,False,4,2
2222,1,9,28,37,False,4,2
2223,2,13,26,39,False,4,2
2224,3,12,18,30,False,4,2
2225,4,23,9,32,False,4,2
2226,5,123,78,201,False,4,2
2227,6,229,164,393,False,4,2
2228,7,364,194,558,False,4,2
2229,8,270,160,430,False,4,2
2230,9,222,188,410,False,4,2
2231,10,230,196,426,False,4,2
2232,11,287,231,518,False,4,2
2233,12,276,265,541,False,4,2
2234,13,292,297,589,False,4,2
2235,14,258,303,561,False,4,2
2236,15,210,299,509,False,4,2
2237,16,186,178,364,False,4,2
2238,17,172,165,337,False,4,2
2239,18,141,137,278,False,4,2
2240,19,102,97,199,False,4,2
2241,20,82,106,188,False,4,2
2242,21,64,73,137,False,4,2
2243,22,40,56,96,False,4,2
2244,23,28,51,79,False,4,2
2245,0,21,76,97,False,5,2
2246,1,23,32,55,False,5,2
2247,2,24,56,80,False,5,2
2248,3,19,21,40,False,5,2
2249,4,14,15,29,False,5,2
2250,5,31,19,50,False,5,2
2251,6,34,36,70,False,5,2
2252,7,37,34,71,False,5,2
2253,8,59,58,117,False,5,2
2254,9,118,72,190,False,5,2
2255,10,113,91,204,False,5,2
2256,11,180,110,290,False,5,2
2257,12,145,142,287,False,5,2
2258,13,131,147,278,False,5,2
2259,14,155,163,318,False,5,2
2260,15,117,127,244,False,5,2
2261,16,125,108,233,False,5,2
2262,17,129,114,243,False,5,2
2263,18,81,75,156,False,5,2
2264,19,72,73,145,False,5,2
2265,20,42,70,112,False,5,2
2266,21,46,51,97,False,5,2
2267,22,38,33,71,False,5,2
2268,23,33,52,85,False,5,2
2269,0,20,27,47,True,6,2
2270,1,25,45,70,True,6,2
2271,2,22,50,72,True,6,2
2272,3,17,53,70,True,6,2
2273,4,16,19,35,True,6,2
2274,5,19,19,38,True,6,2
2275,6,28,25,53,True,6,2
2276,7,33,21,54,True,6,2
2277,8,37,37,74,True,6,2
2278,9,94,59,153,True,6,2
2279,10,88,68,156,True,6,2
2280,11,104,100,204,True,6,2
2281,12,124,138,262,True,6,2
2282,13,165,128,293,True,6,2
2283,14,138,150,288,True,6,2
2284,15,104,205,309,True,6,2
2285,16,136,162,298,True,6,2
2286,17,97,96,193,True,6,2
2287,18,97,105,202,True,6,2
2288,19,144,123,267,True,6,2
2289,20,68,91,159,True,6,2
2290,21,33,55,88,True,6,2
2291,22,35,51,86,True,6,2
2292,23,16,25,41,True,6,2
2293,0,11,13,24,False,0,2
2294,1,8,11,19,False,0,2
2295,2,8,15,23,False,0,2
2296,3,7,11,18,False,0,2
2297,4,17,11,28,False,0,2
2298,5,85,41,126,False,0,2
2299,6,156,115,271,False,0,2
2300,7,206,114,320,False,0,2
2301,8,190,144,334,False,0,2
2302,9,169,121,290,False,0,2
2303,10,186,143,329,False,0,2
2304,11,267,195,462,False,0,2
2305,12,272,193,465,False,0,2
2306,13,262,210,472,False,0,2
2307,14,297,243,540,False,0,2
2308,15,162,204,366,False,0,2
2309,16,157,127,284,False,0,2
2310,17,132,114,246,False,0,2
2311,18,92,109,201,False,0,2
2312,19,86,78,164,False,0,2
2313,20,73,82,155,False,0,2
2314,21,46,49,95,False,0,2
2315,22,33,36,69,False,0,2
2316,23,21,22,43,False,0,2
2317,0,11,20,31,False,1,2
2318,1,6,9,15,False,1,2
2319,2,9,7,16,False,1,2
2320,3,2,8,10,False,1,2
2321,4,15,6,21,False,1,2
2322,5,90,45,135,False,1,2
2323,6,140,119,259,False,1,2
2324,7,153,104,257,False,1,2
2325,8,195,108,303,False,1,2
2326,9,184,126,310,False,1,2
2327,10,192,152,344,False,1,2
2328,11,205,152,357,False,1,2
2329,12,177,167,344,False,1,2
2330,13,177,227,404,False,1,2
2331,14,220,235,455,False,1,2
2332,15,161,188,349,False,1,2
2333,16,146,142,288,False,1,2
2334,17,121,120,241,False,1,2
2335,18,89,108,197,False,1,2
2336,19,92,100,192,False,1,2
2337,20,79,70,149,False,1,2
2338,21,48,61,109,False,1,2
2339,22,29,41,70,False,1,2
2340,23,26,25,51,False,1,2
2341,0,9,17,26,False,2,2
2342,1,14,34,48,False,2,2
2343,2,9,13,22,False,2,2
2344,3,6,21,27,False,2,2
2345,4,16,9,25,False,2,2
2346,5,75,39,114,False,2,2
2347,6,121,90,211,False,2,2
2348,7,140,75,215,False,2,2
2349,8,120,127,247,False,2,2
2350,9,132,125,257,False,2,2
2351,10,291,213,504,False,2,2
2352,11,374,244,618,False,2,2
2353,12,159,156,315,False,2,2
2354,13,130,138,268,False,2,2
2355,14,118,135,253,False,2,2
2356,15,98,122,220,False,2,2
2357,16,109,108,217,False,2,2
2358,17,95,103,198,False,2,2
2359,18,79,92,171,False,2,2
2360,19,80,86,166,False,2,2
2361,20,57,56,113,False,2,2
2362,21,42,44,86,False,2,2
2363,22,38,42,80,False,2,2
2364,23,27,36,63,False,2,2
2365,0,11,17,28,True,3,2
2366,1,13,22,35,True,3,2
2367,2,11,20,31,True,3,2
2368,3,8,14,22,True,3,2
2369,4,8,6,14,True,3,2
2370,5,19,13,32,True,3,2
2371,6,17,26,43,True,3,2
2372,7,24,12,36,True,3,2
2373,8,35,20,55,True,3,2
2374,9,55,27,82,True,3,2
2375,10,100,47,147,True,3,2
2376,11,102,94,196,True,3,2
2377,12,94,96,190,True,3,2
2378,13,104,116,220,True,3,2
2379,14,109,147,256,True,3,2
2380,15,88,113,201,True,3,2
2381,16,93,107,200,True,3,2
2382,17,69,97,166,True,3,2
2383,18,77,82,159,True,3,2
2384,19,71,68,139,True,3,2
2385,20,54,56,110,True,3,2
2386,21,30,45,75,True,3,2
2387,22,24,32,56,True,3,2
2388,23,29,33,62,True,3,2
2389,0,7,36,43,True,4,2
2390,1,8,19,27,True,4,2
2391,2,5,22,27,True,4,2
2392,3,10,15,25,True,4,2
2393,4,9,9,18,True,4,2
2394,5,10,8,18,True,4,2
2395,6,21,15,36,True,4,2
2396,7,27,17,44,True,4,2
2397,8,29,15,44,True,4,2
2398,9,58,41,99,True,4,2
2399,10,75,62,137,True,4,2
2400,11,107,69,176,True,4,2
2401,12,95,102,197,True,4,2
2402,13,114,126,240,True,4,2
2403,14,118,129,247,True,4,2
2404,15,90,124,214,True,4,2
2405,16,82,136,218,True,4,2
2406,17,76,99,175,True,4,2
2407,18,68,91,159,True,4,2
2408,19,67,86,153,True,4,2
2409,20,51,91,142,True,4,2
2410,21,40,44,84,True,4,2
2411,22,32,38,70,True,4,2
2412,23,31,48,79,True,4,2
2413,0,19,26,45,False,5,2
2414,1,9,18,27,False,5,2
2415,2,11,35,46,False,5,2
2416,3,8,19,27,False,5,2
2417,4,7,9,16,False,5,2
2418,5,19,13,32,False,5,2
2419,6,22,16,38,False,5,2
2420,7,33,21,54,False,5,2
2421,8,39,36,75,False,5,2
2422,9,83,71,154,False,5,2
2423,10,98,117,215,False,5,2
2424,11,115,136,251,False,5,2
2425,12,114,101,215,False,5,2
2426,13,111,115,226,False,5,2
2427,14,95,111,206,False,5,2
2428,15,88,115,203,False,5,2
2429,16,102,112,214,False,5,2
2430,17,88,67,155,False,5,2
2431,18,69,61,130,False,5,2
2432,19,69,70,139,False,5,2
2433,20,75,57,132,False,5,2
2434,21,38,49,87,False,5,2
2435,22,36,54,90,False,5,2
2436,23,38,55,93,False,5,2
2437,0,24,29,53,True,6,2
2438,1,24,40,64,True,6,2
2439,2,32,39,71,True,6,2
2440,3,13,31,44,True,6,2
2441,4,21,14,35,True,6,2
2442,5,24,18,42,True,6,2
2443,6,18,9,27,True,6,2
2444,7,18,20,38,True,6,2
2445,8,46,30,76,True,6,2
2446,9,70,43,113,True,6,2
2447,10,77,58,135,True,6,2
2448,11,72,95,167,True,6,2
2449,12,131,139,270,True,6,2
2450,13,100,97,197,True,6,2
2451,14,117,180,297,True,6,2
2452,15,92,99,191,True,6,2
2453,16,107,91,198,True,6,2
2454,17,104,98,202,True,6,2
2455,18,91,123,214,True,6,2
2456,19,76,81,157,True,6,2
2457,20,49,54,103,True,6,2
2458,21,42,59,101,True,6,2
2459,22,26,30,56,True,6,2
2460,23,11,15,26,True,6,2
2461,0,16,21,37,True,0,2
2462,1,7,14,21,True,0,2
2463,2,9,27,36,True,0,2
2464,3,9,8,17,True,0,2
2465,4,13,9,22,True,0,2
2466,5,25,12,37,True,0,2
2467,6,25,13,38,True,0,2
2468,7,36,32,68,True,0,2
2469,8,59,28,87,True,0,2
2470,9,79,60,139,True,0,2
2471,10,99,88,187,True,0,2
2472,11,110,108,218,True,0,2
2473,12,138,125,263,True,0,2
2474,13,130,159,289,True,0,2
2475,14,130,168,298,True,0,2
2476,15,122,127,249,True,0,2
2477,16,139,148,287,True,0,2
2478,17,125,144,269,True,0,2
2479,18,116,117,233,True,0,2
2480,19,67,78,145,True,0,2
2481,20,60,62,122,True,0,2
2482,21,38,56,94,True,0,2
2483,22,25,25,50,True,0,2
2484,23,17,7,24,True,0,2
2485,0,7,13,20,False,1,2
2486,1,4,6,10,False,1,2
2487,2,6,9,15,False,1,2
2488,3,18,12,30,False,1,2
2489,4,123,63,186,False,1,2
2490,5,196,145,341,False,1,2
2491,6,240,147,387,False,1,2
2492,7,253,147,400,False,1,2
2493,8,213,150,363,False,1,2
2494,9,203,170,373,False,1,2
2495,10,213,190,403,False,1,2
2496,11,220,210,430,False,1,2
2497,12,208,229,437,False,1,2
2498,13,226,283,509,False,1,2
2499,14,211,276,487,False,1,2
2500,15,163,172,335,False,1,2
2501,16,150,116,266,False,1,2
2502,17,105,133,238,False,1,2
2503,18,93,103,196,False,1,2
2504,19,70,85,155,False,1,2
2505,20,47,73,120,False,1,2
2506,21,39,49,88,False,1,2
2507,22,15,23,38,False,1,2
2508,23,12,13,25,False,1,2
2509,0,10,17,27,False,2,2
2510,1,6,19,25,False,2,2
2511,2,3,7,10,False,2,2
2512,3,19,10,29,False,2,2
2513,4,110,50,160,False,2,2
2514,5,196,141,337,False,2,2
2515,6,235,157,392,False,2,2
2516,7,241,126,367,False,2,2
2517,8,183,128,311,False,2,2
2518,9,191,170,361,False,2,2
2519,10,212,170,382,False,2,2
2520,11,186,187,373,False,2,2
2521,12,194,252,446,False,2,2
2522,13,236,267,503,False,2,2
2523,14,197,249,446,False,2,2
2524,15,184,180,364,False,2,2
2525,16,140,137,277,False,2,2
2526,17,135,142,277,False,2,2
2527,18,94,117,211,False,2,2
2528,19,91,103,194,False,2,2
2529,20,58,80,138,False,2,2
2530,21,45,40,85,False,2,2
2531,22,29,28,57,False,2,2
2532,23,19,20,39,False,2,2
2533,0,18,22,40,False,3,2
2534,1,10,8,18,False,3,2
2535,2,6,12,18,False,3,2
2536,3,23,18,41,False,3,2
2537,4,98,55,153,False,3,2
2538,5,194,139,333,False,3,2
2539,6,265,163,428,False,3,2
2540,7,242,134,376,False,3,2
2541,8,202,149,351,False,3,2
2542,9,205,163,368,False,3,2
2543,10,209,175,384,False,3,2
2544,11,166,209,375,False,3,2
2545,12,204,210,414,False,3,2
2546,13,231,276,507,False,3,2
2547,14,186,255,441,False,3,2
2548,15,107,131,238,False,3,2
2549,16,163,160,323,False,3,2
2550,17,124,140,264,False,3,2
2551,18,96,120,216,False,3,2
2552,19,93,104,197,False,3,2
2553,20,60,87,147,False,3,2
2554,21,34,52,86,False,3,2
2555,22,23,35,58,False,3,2
2556,23,11,13,24,False,3,2
2557,0,9,24,33,False,4,3
2558,1,12,24,36,False,4,3
2559,2,8,16,24,False,4,3
2560,3,22,10,32,False,4,3
2561,4,119,48,167,False,4,3
2562,5,194,134,328,False,4,3
2563,6,255,130,385,False,4,3
2564,7,238,163,401,False,4,3
2565,8,196,162,358,False,4,3
2566,9,231,176,407,False,4,3
2567,10,230,203,433,False,4,3
2568,11,218,200,418,False,4,3
2569,12,207,235,442,False,4,3
2570,13,240,277,517,False,4,3
2571,14,183,244,427,False,4,3
2572,15,147,181,328,False,4,3
2573,16,125,142,267,False,4,3
2574,17,125,131,256,False,4,3
2575,18,98,82,180,False,4,3
2576,19,68,72,140,False,4,3
2577,20,51,51,102,False,4,3
2578,21,43,66,109,False,4,3
2579,22,27,53,80,False,4,3
2580,23,17,36,53,False,4,3
2581,0,21,34,55,False,5,3
2582,1,21,41,62,False,5,3
2583,2,15,21,36,False,5,3
2584,3,13,6,19,False,5,3
2585,4,30,10,40,False,5,3
2586,5,42,37,79,False,5,3
2587,6,45,33,78,False,5,3
2588,7,63,51,114,False,5,3
2589,8,113,68,181,False,5,3
2590,9,116,100,216,False,5,3
2591,10,144,129,273,False,5,3
2592,11,179,157,336,False,5,3
2593,12,142,152,294,False,5,3
2594,13,159,186,345,False,5,3
2595,14,146,152,298,False,5,3
2596,15,133,163,296,False,5,3
2597,16,142,155,297,False,5,3
2598,17,101,107,208,False,5,3
2599,18,90,92,182,False,5,3
2600,19,60,65,125,False,5,3
2601,20,43,60,103,False,5,3
2602,21,45,65,110,False,5,3
2603,22,36,58,94,False,5,3
2604,23,26,39,65,False,5,3
2605,0,34,59,93,True,6,3
2606,1,38,55,93,True,6,3
2607,2,19,43,62,True,6,3
2608,3,16,14,30,True,6,3
2609,4,18,27,45,True,6,3
2610,5,19,20,39,True,6,3
2611,6,27,17,44,True,6,3
2612,7,28,32,60,True,6,3
2613,8,91,47,138,True,6,3
2614,9,103,86,189,True,6,3
2615,10,151,143,294,True,6,3
2616,11,156,178,334,True,6,3
2617,12,193,165,358,True,6,3
2618,13,156,209,365,True,6,3
2619,14,142,234,376,True,6,3
2620,15,160,202,362,True,6,3
2621,16,151,143,294,True,6,3
2622,17,154,126,280,True,6,3
2623,18,129,146,275,True,6,3
2624,19,95,119,214,True,6,3
2625,20,63,71,134,True,6,3
2626,21,44,33,77,True,6,3
2627,22,20,20,40,True,6,3
2628,23,12,14,26,True,6,3
2629,0,6,9,15,False,0,3
2630,1,9,9,18,False,0,3
2631,2,7,9,16,False,0,3
2632,3,18,10,28,False,0,3
2633,4,117,64,181,False,0,3
2634,5,222,152,374,False,0,3
2635,6,393,215,608,False,0,3
2636,7,272,172,444,False,0,3
2637,8,206,185,391,False,0,3
2638,9,215,192,407,False,0,3
2639,10,228,171,399,False,0,3
2640,11,207,217,424,False,0,3
2641,12,225,248,473,False,0,3
2642,13,275,324,599,False,0,3
2643,14,246,298,544,False,0,3
2644,15,179,196,375,False,0,3
2645,16,189,152,341,False,0,3
2646,17,148,150,298,False,0,3
2647,18,124,141,265,False,0,3
2648,19,94,129,223,False,0,3
2649,20,75,75,150,False,0,3
2650,21,35,35,70,False,0,3
2651,22,11,27,38,False,0,3
2652,23,7,5,12,False,0,3
2653,0,2,6,8,False,1,3
2654,1,9,11,20,False,1,3
2655,2,8,7,15,False,1,3
2656,3,22,13,35,False,1,3
2657,4,120,52,172,False,1,3
2658,5,249,169,418,False,1,3
2659,6,393,195,588,False,1,3
2660,7,252,185,437,False,1,3
2661,8,232,184,416,False,1,3
2662,9,223,175,398,False,1,3
2663,10,228,182,410,False,1,3
2664,11,218,201,419,False,1,3
2665,12,240,267,507,False,1,3
2666,13,267,316,583,False,1,3
2667,14,251,298,549,False,1,3
2668,15,215,211,426,False,1,3
2669,16,171,166,337,False,1,3
2670,17,155,160,315,False,1,3
2671,18,115,129,244,False,1,3
2672,19,105,121,226,False,1,3
2673,20,61,83,144,False,1,3
2674,21,46,38,84,False,1,3
2675,22,20,35,55,False,1,3
2676,23,13,16,29,False,1,3
2677,0,6,19,25,False,2,3
2678,1,7,11,18,False,2,3
2679,2,7,9,16,False,2,3
2680,3,22,9,31,False,2,3
2681,4,110,61,171,False,2,3
2682,5,257,178,435,False,2,3
2683,6,394,207,601,False,2,3
2684,7,270,167,437,False,2,3
2685,8,226,177,403,False,2,3
2686,9,210,181,391,False,2,3
2687,10,201,185,386,False,2,3
2688,11,217,193,410,False,2,3
2689,12,220,223,443,False,2,3
2690,13,285,375,660,False,2,3
2691,14,244,331,575,False,2,3
2692,15,212,241,453,False,2,3
2693,16,218,182,400,False,2,3
2694,17,159,196,355,False,2,3
2695,18,139,155,294,False,2,3
2696,19,62,88,150,False,2,3
2697,20,61,86,147,False,2,3
2698,21,48,43,91,False,2,3
2699,22,24,26,50,False,2,3
2700,23,8,17,25,False,2,3
2701,0,10,17,27,False,3,3
2702,1,7,10,17,False,3,3
2703,2,7,12,19,False,3,3
2704,3,17,9,26,False,3,3
2705,4,122,64,186,False,3,3
2706,5,244,200,444,False,3,3
2707,6,404,210,614,False,3,3
2708,7,263,150,413,False,3,3
2709,8,240,190,430,False,3,3
2710,9,218,187,405,False,3,3
2711,10,219,192,411,False,3,3
2712,11,227,249,476,False,3,3
2713,12,239,250,489,False,3,3
2714,13,255,334,589,False,3,3
2715,14,249,267,516,False,3,3
2716,15,210,222,432,False,3,3
2717,16,210,205,415,False,3,3
2718,17,149,190,339,False,3,3
2719,18,154,156,310,False,3,3
2720,19,93,119,212,False,3,3
2721,20,71,93,164,False,3,3
2722,21,36,45,81,False,3,3
2723,22,20,35,55,False,3,3
2724,23,10,27,37,False,3,3
2725,0,5,29,34,False,4,3
2726,1,7,20,27,False,4,3
2727,2,13,8,21,False,4,3
2728,3,20,10,30,False,4,3
2729,4,105,62,167,False,4,3
2730,5,262,173,435,False,4,3
2731,6,371,207,578,False,4,3
2732,7,250,138,388,False,4,3
2733,8,218,178,396,False,4,3
2734,9,222,196,418,False,4,3
2735,10,223,196,419,False,4,3
2736,11,255,226,481,False,4,3
2737,12,254,276,530,False,4,3
2738,13,301,330,631,False,4,3
2739,14,228,291,519,False,4,3
2740,15,207,210,417,False,4,3
2741,16,164,179,343,False,4,3
2742,17,127,154,281,False,4,3
2743,18,123,103,226,False,4,3
2744,19,71,106,177,False,4,3
2745,20,74,67,141,False,4,3
2746,21,51,58,109,False,4,3
2747,22,36,75,111,False,4,3
2748,23,22,51,73,False,4,3
2749,0,22,41,63,False,5,3
2750,1,20,46,66,False,5,3
2751,2,14,20,34,False,5,3
2752,3,13,13,26,False,5,3
2753,4,30,14,44,False,5,3
2754,5,42,33,75,False,5,3
2755,6,57,43,100,False,5,3
2756,7,82,50,132,False,5,3
2757,8,116,108,224,False,5,3
2758,9,137,140,277,False,5,3
2759,10,180,151,331,False,5,3
2760,11,169,167,336,False,5,3
2761,12,189,172,361,False,5,3
2762,13,171,167,338,False,5,3
2763,14,142,175,317,False,5,3
2764,15,148,140,288,False,5,3
2765,16,116,131,247,False,5,3
2766,17,115,132,247,False,5,3
2767,18,93,95,188,False,5,3
2768,19,80,76,156,False,5,3
2769,20,42,68,110,False,5,3
2770,21,58,54,112,False,5,3
2771,22,34,53,87,False,5,3
2772,23,34,58,92,False,5,3
2773,0,28,56,84,True,6,3
2774,1,26,59,85,True,6,3
2775,2,14,47,61,True,6,3
2776,3,10,22,32,True,6,3
2777,4,20,14,34,True,6,3
2778,5,17,21,38,True,6,3
2779,6,33,20,53,True,6,3
2780,7,54,36,90,True,6,3
2781,8,83,62,145,True,6,3
2782,9,120,91,211,True,6,3
2783,10,186,153,339,True,6,3
2784,11,137,181,318,True,6,3
2785,12,171,236,407,True,6,3
2786,13,175,193,368,True,6,3
2787,14,140,178,318,True,6,3
2788,15,193,174,367,True,6,3
2789,16,154,161,315,True,6,3
2790,17,165,143,308,True,6,3
2791,18,120,157,277,True,6,3
2792,19,90,123,213,True,6,3
2793,20,80,63,143,True,6,3
2794,21,33,41,74,True,6,3
2795,22,18,20,38,True,6,3
2796,23,11,14,25,True,6,3
2797,0,10,10,20,False,0,3
2798,1,6,9,15,False,0,3
2799,2,8,8,16,False,0,3
2800,3,12,17,29,False,0,3
2801,4,131,71,202,False,0,3
2802,5,242,182,424,False,0,3
2803,6,388,211,599,False,0,3
2804,7,284,177,461,False,0,3
2805,8,223,158,381,False,0,3
2806,9,195,172,367,False,0,3
2807,10,196,171,367,False,0,3
2808,11,250,222,472,False,0,3
2809,12,220,250,470,False,0,3
2810,13,257,333,590,False,0,3
2811,14,234,301,535,False,0,3
2812,15,224,204,428,False,0,3
2813,16,199,149,348,False,0,3
2814,17,144,160,304,False,0,3
2815,18,95,94,189,False,0,3
2816,19,127,123,250,False,0,3
2817,20,66,89,155,False,0,3
2818,21,44,41,85,False,0,3
2819,22,20,16,36,False,0,3
2820,23,6,11,17,False,0,3
2821,0,6,8,14,False,1,3
2822,1,6,7,13,False,1,3
2823,2,8,8,16,False,1,3
2824,3,25,11,36,False,1,3
2825,4,115,75,190,False,1,3
2826,5,260,207,467,False,1,3
2827,6,405,212,617,False,1,3
2828,7,277,162,439,False,1,3
2829,8,208,160,368,False,1,3
2830,9,208,188,396,False,1,3
2831,10,229,248,477,False,1,3
2832,11,239,226,465,False,1,3
2833,12,232,257,489,False,1,3
2834,13,285,343,628,False,1,3
2835,14,248,308,556,False,1,3
2836,15,202,230,432,False,1,3
2837,16,228,166,394,False,1,3
2838,17,161,167,328,False,1,3
2839,18,132,134,266,False,1,3
2840,19,95,121,216,False,1,3
2841,20,59,82,141,False,1,3
2842,21,36,65,101,False,1,3
2843,22,16,19,35,False,1,3
2844,23,11,14,25,False,1,3
2845,0,4,19,23,False,2,3
2846,1,10,8,18,False,2,3
2847,2,5,11,16,False,2,3
2848,3,14,13,27,False,2,3
2849,4,100,71,171,False,2,3
2850,5,265,182,447,False,2,3
2851,6,365,202,567,False,2,3
2852,7,273,176,449,False,2,3
2853,8,229,178,407,False,2,3
2854,9,225,364,589,False,2,3
2855,10,224,394,618,False,2,3
2856,11,208,227,435,False,2,3
2857,12,230,253,483,False,2,3
2858,13,270,331,601,False,2,3
2859,14,229,286,515,False,2,3
2860,15,271,222,493,False,2,3
2861,16,193,146,339,False,2,3
2862,17,169,165,334,False,2,3
2863,18,130,151,281,False,2,3
2864,19,92,140,232,False,2,3
2865,20,85,90,175,False,2,3
2866,21,36,42,78,False,2,3
2867,22,18,23,41,False,2,3
2868,23,13,19,32,False,2,3
2869,0,6,17,23,False,3,3
2870,1,12,36,48,False,3,3
2871,2,8,26,34,False,3,3
2872,3,23,34,57,False,3,3
2873,4,122,71,193,False,3,3
2874,5,267,193,460,False,3,3
2875,6,435,222,657,False,3,3
2876,7,302,191,493,False,3,3
2877,8,241,185,426,False,3,3
2878,9,230,180,410,False,3,3
2879,10,209,198,407,False,3,3
2880,11,221,239,460,False,3,3
2881,12,198,264,462,False,3,3
2882,13,304,311,615,False,3,3
2883,14,238,318,556,False,3,3
2884,15,213,240,453,False,3,3
2885,16,206,199,405,False,3,3
2886,17,161,157,318,False,3,3
2887,18,112,137,249,False,3,3
2888,19,84,126,210,False,3,3
2889,20,59,67,126,False,3,3
2890,21,39,50,89,False,3,3
2891,22,27,36,63,False,3,3
2892,23,23,32,55,False,3,3
2893,0,9,27,36,False,4,3
2894,1,13,25,38,False,4,3
2895,2,5,27,32,False,4,3
2896,3,22,9,31,False,4,3
2897,4,117,69,186,False,4,3
2898,5,255,176,431,False,4,3
2899,6,384,210,594,False,4,3
2900,7,244,150,394,False,4,3
2901,8,220,184,404,False,4,3
2902,9,247,218,465,False,4,3
2903,10,266,208,474,False,4,3
2904,11,265,207,472,False,4,3
2905,12,282,300,582,False,4,3
2906,13,311,383,694,False,4,3
2907,14,224,302,526,False,4,3
2908,15,175,174,349,False,4,3
2909,16,147,145,292,False,4,3
2910,17,136,168,304,False,4,3
2911,18,98,119,217,False,4,3
2912,19,103,119,222,False,4,3
2913,20,61,65,126,False,4,3
2914,21,49,56,105,False,4,3
2915,22,49,48,97,False,4,3
2916,23,30,41,71,False,4,3
2917,0,27,59,86,False,5,3
2918,1,20,39,59,False,5,3
2919,2,10,26,36,False,5,3
2920,3,13,13,26,False,5,3
2921,4,27,13,40,False,5,3
2922,5,37,27,64,False,5,3
2923,6,37,38,75,False,5,3
2924,7,90,73,163,False,5,3
2925,8,138,113,251,False,5,3
2926,9,149,150,299,False,5,3
2927,10,190,166,356,False,5,3
2928,11,174,169,343,False,5,3
2929,12,162,181,343,False,5,3
2930,13,179,173,352,False,5,3
2931,14,175,176,351,False,5,3
2932,15,141,168,309,False,5,3
2933,16,130,135,265,False,5,3
2934,17,124,102,226,False,5,3
2935,18,95,107,202,False,5,3
2936,19,86,87,173,False,5,3
2937,20,61,57,118,False,5,3
2938,21,50,87,137,False,5,3
2939,22,42,65,107,False,5,3
2940,23,42,57,99,False,5,3
2941,0,39,72,111,True,6,3
2942,1,33,55,88,True,6,3
2943,2,18,43,61,True,6,3
2944,3,13,17,30,True,6,3
2945,4,17,9,26,True,6,3
2946,5,23,12,35,True,6,3
2947,6,38,19,57,True,6,3
2948,7,63,44,107,True,6,3
2949,8,129,70,199,True,6,3
2950,9,155,121,276,True,6,3
2951,10,161,170,331,True,6,3
2952,11,176,185,361,True,6,3
2953,12,203,221,424,True,6,3
2954,13,200,193,393,True,6,3
2955,14,155,214,369,True,6,3
2956,15,171,162,333,True,6,3
2957,16,166,190,356,True,6,3
2958,17,128,136,264,True,6,3
2959,18,113,155,268,True,6,3
2960,19,90,98,188,True,6,3
2961,20,52,55,107,True,6,3
2962,21,49,47,96,True,6,3
2963,22,16,19,35,True,6,3
2964,23,10,11,21,True,6,3
2965,0,5,10,15,False,0,3
2966,1,8,7,15,False,0,3
2967,2,6,14,20,False,0,3
2968,3,24,9,33,False,0,3
2969,4,130,60,190,False,0,3
2970,5,270,178,448,False,0,3
2971,6,407,214,621,False,0,3
2972,7,282,166,448,False,0,3
2973,8,249,204,453,False,0,3
2974,9,207,161,368,False,0,3
2975,10,242,189,431,False,0,3
2976,11,202,205,407,False,0,3
2977,12,225,280,505,False,0,3
2978,13,296,347,643,False,0,3
2979,14,249,272,521,False,0,3
2980,15,211,204,415,False,0,3
2981,16,172,154,326,False,0,3
2982,17,143,170,313,False,0,3
2983,18,136,135,271,False,0,3
2984,19,108,129,237,False,0,3
2985,20,84,99,183,False,0,3
2986,21,35,33,68,False,0,3
2987,22,22,26,48,False,0,3
2988,23,6,7,13,False,0,3
2989,0,4,9,13,False,1,3
2990,1,7,6,13,False,1,3
2991,2,7,7,14,False,1,3
2992,3,20,11,31,False,1,3
2993,4,136,76,212,False,1,3
2994,5,271,185,456,False,1,3
2995,6,437,202,639,False,1,3
2996,7,308,196,504,False,1,3
2997,8,203,195,398,False,1,3
2998,9,223,175,398,False,1,3
2999,10,203,216,419,False,1,3
3000,11,259,217,476,False,1,3
3001,12,240,302,542,False,1,3
3002,13,283,318,601,False,1,3
3003,14,241,300,541,False,1,3
3004,15,240,207,447,False,1,3
3005,16,204,189,393,False,1,3
3006,17,161,188,349,False,1,3
3007,18,140,153,293,False,1,3
3008,19,116,128,244,False,1,3
3009,20,75,99,174,False,1,3
3010,21,42,45,87,False,1,3
3011,22,21,43,64,False,1,3
3012,23,19,23,42,False,1,3
3013,0,10,15,25,False,2,3
3014,1,14,17,31,False,2,3
3015,2,11,17,28,False,2,3
3016,3,20,9,29,False,2,3
3017,4,127,66,193,False,2,3
3018,5,270,167,437,False,2,3
3019,6,409,214,623,False,2,3
3020,7,256,160,416,False,2,3
3021,8,236,171,407,False,2,3
3022,9,228,180,408,False,2,3
3023,10,232,227,459,False,2,3
3024,11,235,221,456,False,2,3
3025,12,261,282,543,False,2,3
3026,13,292,334,626,False,2,3
3027,14,246,293,539,False,2,3
3028,15,245,229,474,False,2,3
3029,16,176,177,353,False,2,3
3030,17,173,171,344,False,2,3
3031,18,125,132,257,False,2,3
3032,19,96,147,243,False,2,3
3033,20,55,95,150,False,2,3
3034,21,23,27,50,False,2,3
3035,22,19,19,38,False,2,3
3036,23,11,17,28,False,2,3
3037,0,7,9,16,False,3,3
3038,1,6,6,12,False,3,3
3039,2,3,17,20,False,3,3
3040,3,26,9,35,False,3,3
3041,4,133,68,201,False,3,3
3042,5,258,173,431,False,3,3
3043,6,384,221,605,False,3,3
3044,7,280,153,433,False,3,3
3045,8,177,132,309,False,3,3
3046,9,227,180,407,False,3,3
3047,10,216,195,411,False,3,3
3048,11,215,224,439,False,3,3
3049,12,239,263,502,False,3,3
3050,13,294,323,617,False,3,3
3051,14,211,294,505,False,3,3
3052,15,230,216,446,False,3,3
3053,16,209,187,396,False,3,3
3054,17,161,183,344,False,3,3
3055,18,123,167,290,False,3,3
3056,19,104,138,242,False,3,3
3057,20,101,77,178,False,3,3
3058,21,40,118,158,False,3,3
3059,22,28,38,66,False,3,3
3060,23,20,22,42,False,3,3
3061,0,11,29,40,False,4,3
3062,1,14,23,37,False,4,3
3063,2,12,17,29,False,4,3
3064,3,21,14,35,False,4,3
3065,4,124,68,192,False,4,3
3066,5,243,191,434,False,4,3
3067,6,356,191,547,False,4,3
3068,7,274,194,468,False,4,3
3069,8,206,163,369,False,4,3
3070,9,250,204,454,False,4,3
3071,10,247,218,465,False,4,3
3072,11,253,242,495,False,4,3
3073,12,273,313,586,False,4,3
3074,13,297,328,625,False,4,3
3075,14,225,269,494,False,4,3
3076,15,165,170,335,False,4,3
3077,16,159,159,318,False,4,3
3078,17,137,155,292,False,4,3
3079,18,95,137,232,False,4,3
3080,19,83,92,175,False,4,3
3081,20,57,79,136,False,4,3
3082,21,53,62,115,False,4,3
3083,22,38,44,82,False,4,3
3084,23,21,43,64,False,4,3
3085,0,25,45,70,False,5,3
3086,1,22,40,62,False,5,3
3087,2,13,25,38,False,5,3
3088,3,11,11,22,False,5,3
3089,4,30,17,47,False,5,3
3090,5,31,25,56,False,5,3
3091,6,27,21,48,False,5,3
3092,7,66,67,133,False,5,3
3093,8,134,86,220,False,5,3
3094,9,158,103,261,False,5,3
3095,10,183,150,333,False,5,3
3096,11,175,146,321,False,5,3
3097,12,185,198,383,False,5,3
3098,13,133,189,322,False,5,3
3099,14,152,174,326,False,5,3
3100,15,166,204,370,False,5,3
3101,16,140,132,272,False,5,3
3102,17,116,139,255,False,5,3
3103,18,148,128,276,False,5,3
3104,19,72,76,148,False,5,3
3105,20,57,67,124,False,5,3
3106,21,32,54,86,False,5,3
3107,22,32,60,92,False,5,3
3108,23,34,60,94,False,5,3
3109,0,31,49,80,True,6,3
3110,1,28,52,80,True,6,3
3111,2,15,36,51,True,6,3
3112,3,16,16,32,True,6,3
3113,4,15,19,34,True,6,3
3114,5,17,20,37,True,6,3
3115,6,32,22,54,True,6,3
3116,7,59,43,102,True,6,3
3117,8,118,65,183,True,6,3
3118,9,148,116,264,True,6,3
3119,10,155,153,308,True,6,3
3120,11,175,177,352,True,6,3
3121,12,181,218,399,True,6,3
3122,13,189,214,403,True,6,3
3123,14,176,219,395,True,6,3
3124,15,167,187,354,True,6,3
3125,16,166,161,327,True,6,3
3126,17,182,189,371,True,6,3
3127,18,141,164,305,True,6,3
3128,19,100,122,222,True,6,3
3129,20,71,85,156,True,6,3
3130,21,51,39,90,True,6,3
3131,22,22,26,48,True,6,3
3132,23,10,13,23,True,6,3
3133,0,9,11,20,False,0,3
3134,1,7,8,15,False,0,3
3135,2,4,6,10,False,0,3
3136,3,20,11,31,False,0,3
3137,4,135,67,202,False,0,3
3138,5,265,170,435,False,0,3
3139,6,387,214,601,False,0,3
3140,7,288,183,471,False,0,3
3141,8,236,192,428,False,0,3
3142,9,172,172,344,False,0,3
3143,10,215,215,430,False,0,3
3144,11,211,222,433,False,0,3
3145,12,212,224,436,False,0,3
3146,13,253,307,560,False,0,3
3147,14,215,290,505,False,0,3
3148,15,200,182,382,False,0,3
3149,16,187,152,339,False,0,3
3150,17,150,178,328,False,0,3
3151,18,132,127,259,False,0,3
3152,19,105,130,235,False,0,3
3153,20,63,84,147,False,0,3
3154,21,39,42,81,False,0,3
3155,22,13,12,25,False,0,3
3156,23,9,13,22,False,0,3
3157,0,6,5,11,False,1,3
3158,1,5,8,13,False,1,3
3159,2,6,13,19,False,1,3
3160,3,19,11,30,False,1,3
3161,4,121,69,190,False,1,3
3162,5,241,168,409,False,1,3
3163,6,362,220,582,False,1,3
3164,7,292,170,462,False,1,3
3165,8,211,177,388,False,1,3
3166,9,224,190,414,False,1,3
3167,10,210,230,440,False,1,3
3168,11,229,195,424,False,1,3
3169,12,179,202,381,False,1,3
3170,13,261,322,583,False,1,3
3171,14,209,303,512,False,1,3
3172,15,169,188,357,False,1,3
3173,16,217,208,425,False,1,3
3174,17,164,153,317,False,1,3
3175,18,124,151,275,False,1,3
3176,19,113,117,230,False,1,3
3177,20,71,96,167,False,1,3
3178,21,40,42,82,False,1,3
3179,22,15,23,38,False,1,3
3180,23,16,28,44,False,1,3
3181,0,13,13,26,False,2,3
3182,1,7,14,21,False,2,3
3183,2,7,14,21,False,2,3
3184,3,22,12,34,False,2,3
3185,4,104,74,178,False,2,3
3186,5,280,168,448,False,2,3
3187,6,377,211,588,False,2,3
3188,7,262,157,419,False,2,3
3189,8,225,176,401,False,2,3
3190,9,228,200,428,False,2,3
3191,10,255,182,437,False,2,3
3192,11,222,243,465,False,2,3
3193,12,225,249,474,False,2,3
3194,13,278,364,642,False,2,3
3195,14,234,273,507,False,2,3
3196,15,223,197,420,False,2,3
3197,16,170,152,322,False,2,3
3198,17,165,147,312,False,2,3
3199,18,138,144,282,False,2,3
3200,19,100,132,232,False,2,3
3201,20,98,92,190,False,2,3
3202,21,41,60,101,False,2,3
3203,22,32,29,61,False,2,3
3204,23,11,11,22,False,2,3
3205,0,7,17,24,False,3,3
3206,1,9,20,29,False,3,3
3207,2,8,27,35,False,3,3
3208,3,12,27,39,False,3,3
3209,4,132,46,178,False,3,3
3210,5,274,172,446,False,3,3
3211,6,370,192,562,False,3,3
3212,7,232,176,408,False,3,3
3213,8,238,177,415,False,3,3
3214,9,213,185,398,False,3,3
3215,10,191,203,394,False,3,3
3216,11,226,242,468,False,3,3
3217,12,235,254,489,False,3,3
3218,13,259,315,574,False,3,3
3219,14,231,277,508,False,3,3
3220,15,227,190,417,False,3,3
3221,16,203,169,372,False,3,3
3222,17,150,170,320,False,3,3
3223,18,137,154,291,False,3,3
3224,19,115,126,241,False,3,3
3225,20,84,93,177,False,3,3
3226,21,40,67,107,False,3,3
3227,22,20,32,52,False,3,3
3228,23,16,23,39,False,3,3
3229,0,16,27,43,False,4,3
3230,1,13,23,36,False,4,3
3231,2,8,23,31,False,4,3
3232,3,20,12,32,False,4,3
3233,4,118,61,179,False,4,3
3234,5,246,163,409,False,4,3
3235,6,364,190,554,False,4,3
3236,7,262,165,427,False,4,3
3237,8,235,173,408,False,4,3
3238,9,254,221,475,False,4,3
3239,10,253,223,476,False,4,3
3240,11,260,241,501,False,4,3
3241,12,281,310,591,False,4,3
3242,13,276,344,620,False,4,3
3243,14,243,304,547,False,4,3
3244,15,199,183,382,False,4,3
3245,16,193,193,386,False,4,3
3246,17,152,165,317,False,4,3
3247,18,110,109,219,False,4,3
3248,19,81,108,189,False,4,3
3249,20,88,82,170,False,4,3
3250,21,64,67,131,False,4,3
3251,22,50,62,112,False,4,3
3252,23,26,84,110,False,4,3
3253,0,31,51,82,False,5,3
3254,1,19,33,52,False,5,3
3255,2,8,17,25,False,5,3
3256,3,13,13,26,False,5,3
3257,4,32,13,45,False,5,3
3258,5,37,33,70,False,5,3
3259,6,68,36,104,False,5,3
3260,7,153,58,211,False,5,3
3261,8,170,77,247,False,5,3
3262,9,169,98,267,False,5,3
3263,10,167,152,319,False,5,3
3264,11,179,153,332,False,5,3
3265,12,150,165,315,False,5,3
3266,13,166,163,329,False,5,3
3267,14,185,147,332,False,5,3
3268,15,165,192,357,False,5,3
3269,16,162,144,306,False,5,3
3270,17,134,141,275,False,5,3
3271,18,108,105,213,False,5,3
3272,19,95,99,194,False,5,3
3273,20,78,78,156,False,5,3
3274,21,76,82,158,False,5,3
3275,22,42,76,118,False,5,3
3276,23,34,59,93,False,5,3
3277,0,28,51,79,True,6,4
3278,1,35,70,105,True,6,4
3279,2,30,55,85,True,6,4
3280,3,10,25,35,True,6,4
3281,4,23,21,44,True,6,4
3282,5,26,21,47,True,6,4
3283,6,30,23,53,True,6,4
3284,7,52,36,88,True,6,4
3285,8,121,76,197,True,6,4
3286,9,110,107,217,True,6,4
3287,10,163,140,303,True,6,4
3288,11,171,156,327,True,6,4
3289,12,172,193,365,True,6,4
3290,13,182,173,355,True,6,4
3291,14,173,201,374,True,6,4
3292,15,178,183,361,True,6,4
3293,16,156,157,313,True,6,4
3294,17,145,124,269,True,6,4
3295,18,125,156,281,True,6,4
3296,19,86,102,188,True,6,4
3297,20,62,68,130,True,6,4
3298,21,34,48,82,True,6,4
3299,22,21,21,42,True,6,4
3300,23,9,16,25,True,6,4
3301,0,8,11,19,False,0,4
3302,1,5,14,19,False,0,4
3303,2,6,8,14,False,0,4
3304,3,21,18,39,False,0,4
3305,4,140,69,209,False,0,4
3306,5,261,168,429,False,0,4
3307,6,380,211,591,False,0,4
3308,7,291,176,467,False,0,4
3309,8,259,171,430,False,0,4
3310,9,200,159,359,False,0,4
3311,10,207,201,408,False,0,4
3312,11,218,226,444,False,0,4
3313,12,237,261,498,False,0,4
3314,13,270,349,619,False,0,4
3315,14,261,352,613,False,0,4
3316,15,229,222,451,False,0,4
3317,16,204,163,367,False,0,4
3318,17,128,151,279,False,0,4
3319,18,120,123,243,False,0,4
3320,19,90,132,222,False,0,4
3321,20,77,75,152,False,0,4
3322,21,32,38,70,False,0,4
3323,22,20,20,40,False,0,4
3324,23,10,17,27,False,0,4
3325,0,3,11,14,False,1,4
3326,1,11,10,21,False,1,4
3327,2,9,8,17,False,1,4
3328,3,14,14,28,False,1,4
3329,4,137,68,205,False,1,4
3330,5,260,195,455,False,1,4
3331,6,439,233,672,False,1,4
3332,7,288,161,449,False,1,4
3333,8,197,188,385,False,1,4
3334,9,236,181,417,False,1,4
3335,10,228,220,448,False,1,4
3336,11,228,220,448,False,1,4
3337,12,257,255,512,False,1,4
3338,13,258,316,574,False,1,4
3339,14,248,310,558,False,1,4
3340,15,235,217,452,False,1,4
3341,16,197,194,391,False,1,4
3342,17,140,186,326,False,1,4
3343,18,132,124,256,False,1,4
3344,19,98,124,222,False,1,4
3345,20,69,99,168,False,1,4
3346,21,48,42,90,False,1,4
3347,22,24,32,56,False,1,4
3348,23,14,23,37,False,1,4
3349,0,18,22,40,False,2,4
3350,1,10,14,24,False,2,4
3351,2,10,21,31,False,2,4
3352,3,18,12,30,False,2,4
3353,4,140,70,210,False,2,4
3354,5,253,189,442,False,2,4
3355,6,395,210,605,False,2,4
3356,7,266,170,436,False,2,4
3357,8,247,180,427,False,2,4
3358,9,228,198,426,False,2,4
3359,10,260,212,472,False,2,4
3360,11,243,223,466,False,2,4
3361,12,235,299,534,False,2,4
3362,13,282,324,606,False,2,4
3363,14,255,329,584,False,2,4
3364,15,209,240,449,False,2,4
3365,16,196,169,365,False,2,4
3366,17,144,149,293,False,2,4
3367,18,133,150,283,False,2,4
3368,19,89,102,191,False,2,4
3369,20,64,94,158,False,2,4
3370,21,43,61,104,False,2,4
3371,22,33,62,95,False,2,4
3372,23,15,29,44,False,2,4
3373,0,17,23,40,True,3,4
3374,1,16,36,52,True,3,4
3375,2,15,24,39,True,3,4
3376,3,11,11,22,True,3,4
3377,4,17,10,27,True,3,4
3378,5,27,25,52,True,3,4
3379,6,49,34,83,True,3,4
3380,7,84,65,149,True,3,4
3381,8,100,71,171,True,3,4
3382,9,117,98,215,True,3,4
3383,10,149,114,263,True,3,4
3384,11,175,149,324,True,3,4
3385,12,160,180,340,True,3,4
3386,13,134,152,286,True,3,4
3387,14,144,192,336,True,3,4
3388,15,147,164,311,True,3,4
3389,16,153,141,294,True,3,4
3390,17,123,170,293,True,3,4
3391,18,147,168,315,True,3,4
3392,19,81,104,185,True,3,4
3393,20,76,80,156,True,3,4
3394,21,42,63,105,True,3,4
3395,22,23,35,58,True,3,4
3396,23,11,44,55,True,3,4
3397,0,7,40,47,False,4,4
3398,1,7,20,27,False,4,4
3399,2,10,14,24,False,4,4
3400,3,17,17,34,False,4,4
3401,4,87,51,138,False,4,4
3402,5,150,121,271,False,4,4
3403,6,216,124,340,False,4,4
3404,7,202,145,347,False,4,4
3405,8,215,159,374,False,4,4
3406,9,206,176,382,False,4,4
3407,10,226,198,424,False,4,4
3408,11,226,196,422,False,4,4
3409,12,243,228,471,False,4,4
3410,13,209,273,482,False,4,4
3411,14,180,261,441,False,4,4
3412,15,163,158,321,False,4,4
3413,16,125,151,276,False,4,4
3414,17,128,126,254,False,4,4
3415,18,86,113,199,False,4,4
3416,19,75,103,178,False,4,4
3417,20,60,89,149,False,4,4
3418,21,42,57,99,False,4,4
3419,22,35,47,82,False,4,4
3420,23,20,35,55,False,4,4
3421,0,20,37,57,False,5,4
3422,1,14,43,57,False,5,4
3423,2,12,27,39,False,5,4
3424,3,16,18,34,False,5,4
3425,4,24,14,38,False,5,4
3426,5,41,32,73,False,5,4
3427,6,48,36,84,False,5,4
3428,7,74,63,137,False,5,4
3429,8,115,104,219,False,5,4
3430,9,124,108,232,False,5,4
3431,10,151,132,283,False,5,4
3432,11,140,146,286,False,5,4
3433,12,160,135,295,False,5,4
3434,13,118,163,281,False,5,4
3435,14,145,139,284,False,5,4
3436,15,137,160,297,False,5,4
3437,16,116,132,248,False,5,4
3438,17,93,139,232,False,5,4
3439,18,84,102,186,False,5,4
3440,19,84,80,164,False,5,4
3441,20,95,85,180,False,5,4
3442,21,52,82,134,False,5,4
3443,22,38,64,102,False,5,4
3444,23,31,52,83,False,5,4
3445,0,25,48,73,True,6,4
3446,1,23,41,64,True,6,4
3447,2,24,40,64,True,6,4
3448,3,14,23,37,True,6,4
3449,4,19,20,39,True,6,4
3450,5,22,13,35,True,6,4
3451,6,36,25,61,True,6,4
3452,7,58,51,109,True,6,4
3453,8,113,97,210,True,6,4
3454,9,137,119,256,True,6,4
3455,10,136,132,268,True,6,4
3456,11,137,158,295,True,6,4
3457,12,175,175,350,True,6,4
3458,13,155,157,312,True,6,4
3459,14,151,213,364,True,6,4
3460,15,183,165,348,True,6,4
3461,16,134,163,297,True,6,4
3462,17,162,178,340,True,6,4
3463,18,130,166,296,True,6,4
3464,19,136,128,264,True,6,4
3465,20,79,82,161,True,6,4
3466,21,44,56,100,True,6,4
3467,22,20,29,49,True,6,4
3468,23,12,18,30,True,6,4
3469,0,8,12,20,False,0,4
3470,1,9,17,26,False,0,4
3471,2,8,5,13,False,0,4
3472,3,13,7,20,False,0,4
3473,4,143,72,215,False,0,4
3474,5,266,163,429,False,0,4
3475,6,366,230,596,False,0,4
3476,7,291,173,464,False,0,4
3477,8,229,184,413,False,0,4
3478,9,218,178,396,False,0,4
3479,10,219,204,423,False,0,4
3480,11,200,224,424,False,0,4
3481,12,214,254,468,False,0,4
3482,13,232,351,583,False,0,4
3483,14,225,289,514,False,0,4
3484,15,212,180,392,False,0,4
3485,16,171,184,355,False,0,4
3486,17,128,155,283,False,0,4
3487,18,129,143,272,False,0,4
3488,19,96,121,217,False,0,4
3489,20,103,110,213,False,0,4
3490,21,55,55,110,False,0,4
3491,22,25,25,50,False,0,4
3492,23,17,16,33,False,0,4
3493,0,11,13,24,False,1,4
3494,1,15,18,33,False,1,4
3495,2,11,12,23,False,1,4
3496,3,21,17,38,False,1,4
3497,4,127,57,184,False,1,4
3498,5,259,176,435,False,1,4
3499,6,351,206,557,False,1,4
3500,7,275,169,444,False,1,4
3501,8,221,180,401,False,1,4
3502,9,213,170,383,False,1,4
3503,10,231,223,454,False,1,4
3504,11,226,224,450,False,1,4
3505,12,223,255,478,False,1,4
3506,13,265,334,599,False,1,4
3507,14,236,321,557,False,1,4
3508,15,196,204,400,False,1,4
3509,16,198,200,398,False,1,4
3510,17,135,172,307,False,1,4
3511,18,136,156,292,False,1,4
3512,19,110,115,225,False,1,4
3513,20,79,82,161,False,1,4
3514,21,45,49,94,False,1,4
3515,22,16,20,36,False,1,4
3516,23,8,21,29,False,1,4
3517,0,8,14,22,False,2,4
3518,1,6,8,14,False,2,4
3519,2,6,12,18,False,2,4
3520,3,14,12,26,False,2,4
3521,4,122,69,191,False,2,4
3522,5,255,172,427,False,2,4
3523,6,337,271,608,False,2,4
3524,7,275,175,450,False,2,4
3525,8,246,187,433,False,2,4
3526,9,229,187,416,False,2,4
3527,10,203,214,417,False,2,4
3528,11,220,231,451,False,2,4
3529,12,232,288,520,False,2,4
3530,13,279,352,631,False,2,4
3531,14,225,275,500,False,2,4
3532,15,195,188,383,False,2,4
3533,16,198,157,355,False,2,4
3534,17,146,168,314,False,2,4
3535,18,122,146,268,False,2,4
3536,19,119,127,246,False,2,4
3537,20,72,94,166,False,2,4
3538,21,40,49,89,False,2,4
3539,22,16,24,40,False,2,4
3540,23,9,13,22,False,2,4
3541,0,5,8,13,False,3,4
3542,1,8,14,22,False,3,4
3543,2,7,14,21,False,3,4
3544,3,20,16,36,False,3,4
3545,4,124,60,184,False,3,4
3546,5,241,170,411,False,3,4
3547,6,358,223,581,False,3,4
3548,7,283,186,469,False,3,4
3549,8,251,189,440,False,3,4
3550,9,225,178,403,False,3,4
3551,10,230,200,430,False,3,4
3552,11,214,220,434,False,3,4
3553,12,255,295,550,False,3,4
3554,13,282,321,603,False,3,4
3555,14,257,317,574,False,3,4
3556,15,206,199,405,False,3,4
3557,16,189,157,346,False,3,4
3558,17,161,163,324,False,3,4
3559,18,139,141,280,False,3,4
3560,19,131,132,263,False,3,4
3561,20,74,86,160,False,3,4
3562,21,49,52,101,False,3,4
3563,22,22,36,58,False,3,4
3564,23,15,36,51,False,3,4
3565,0,20,32,52,False,4,4
3566,1,15,25,40,False,4,4
3567,2,10,14,24,False,4,4
3568,3,15,13,28,False,4,4
3569,4,144,70,214,False,4,4
3570,5,241,152,393,False,4,4
3571,6,373,211,584,False,4,4
3572,7,273,185,458,False,4,4
3573,8,235,164,399,False,4,4
3574,9,269,227,496,False,4,4
3575,10,278,213,491,False,4,4
3576,11,277,250,527,False,4,4
3577,12,269,322,591,False,4,4
3578,13,291,353,644,False,4,4
3579,14,218,288,506,False,4,4
3580,15,176,202,378,False,4,4
3581,16,157,150,307,False,4,4
3582,17,154,137,291,False,4,4
3583,18,112,129,241,False,4,4
3584,19,95,104,199,False,4,4
3585,20,69,77,146,False,4,4
3586,21,50,59,109,False,4,4
3587,22,58,62,120,False,4,4
3588,23,25,36,61,False,4,4
3589,0,24,41,65,False,5,4
3590,1,22,26,48,False,5,4
3591,2,12,13,25,False,5,4
3592,3,12,10,22,False,5,4
3593,4,33,18,51,False,5,4
3594,5,34,32,66,False,5,4
3595,6,41,40,81,False,5,4
3596,7,59,53,112,False,5,4
3597,8,129,99,228,False,5,4
3598,9,147,125,272,False,5,4
3599,10,176,164,340,False,5,4
3600,11,171,172,343,False,5,4
3601,12,169,183,352,False,5,4
3602,13,112,110,222,False,5,4
3603,14,156,177,333,False,5,4
3604,15,117,134,251,False,5,4
3605,16,136,145,281,False,5,4
3606,17,115,126,241,False,5,4
3607,18,90,125,215,False,5,4
3608,19,87,81,168,False,5,4
3609,20,53,64,117,False,5,4
3610,21,37,40,77,False,5,4
3611,22,55,53,108,False,5,4
3612,23,44,60,104,False,5,4
3613,0,33,54,87,True,6,4
3614,1,19,53,72,True,6,4
3615,2,22,36,58,True,6,4
3616,3,14,17,31,True,6,4
3617,4,19,9,28,True,6,4
3618,5,16,16,32,True,6,4
3619,6,26,8,34,True,6,4
3620,7,35,43,78,True,6,4
3621,8,89,76,165,True,6,4
3622,9,119,76,195,True,6,4
3623,10,134,137,271,True,6,4
3624,11,147,143,290,True,6,4
3625,12,150,164,314,True,6,4
3626,13,154,182,336,True,6,4
3627,14,126,162,288,True,6,4
3628,15,162,142,304,True,6,4
3629,16,158,170,328,True,6,4
3630,17,127,139,266,True,6,4
3631,18,110,144,254,True,6,4
3632,19,97,107,204,True,6,4
3633,20,65,82,147,True,6,4
3634,21,47,53,100,True,6,4
3635,22,32,44,76,True,6,4
3636,23,18,30,48,True,6,4
3637,0,18,21,39,True,0,4
3638,1,18,24,42,True,0,4
3639,2,14,21,35,True,0,4
3640,3,4,8,12,True,0,4
3641,4,20,10,30,True,0,4
3642,5,18,14,32,True,0,4
3643,6,35,24,59,True,0,4
3644,7,66,38,104,True,0,4
3645,8,80,80,160,True,0,4
3646,9,118,98,216,True,0,4
3647,10,126,120,246,True,0,4
3648,11,149,145,294,True,0,4
3649,12,183,164,347,True,0,4
3650,13,187,189,376,True,0,4
3651,14,172,204,376,True,0,4
3652,15,189,223,412,True,0,4
3653,16,168,154,322,True,0,4
3654,17,157,166,323,True,0,4
3655,18,222,165,387,True,0,4
3656,19,142,149,291,True,0,4
3657,20,73,101,174,True,0,4
3658,21,84,74,158,True,0,4
3659,22,39,62,101,True,0,4
3660,23,34,41,75,True,0,4
3661,0,28,48,76,True,1,4
3662,1,23,44,67,True,1,4
3663,2,28,50,78,True,1,4
3664,3,18,11,29,True,1,4
3665,4,58,35,93,True,1,4
3666,5,88,60,148,True,1,4
3667,6,147,68,215,True,1,4
3668,7,294,72,366,True,1,4
3669,8,503,92,595,True,1,4
3670,9,288,70,358,True,1,4
3671,10,159,212,371,True,1,4
3672,11,149,442,591,True,1,4
3673,12,133,244,377,True,1,4
3674,13,122,187,309,True,1,4
3675,14,127,169,296,True,1,4
3676,15,139,151,290,True,1,4
3677,16,126,127,253,True,1,4
3678,17,106,151,257,True,1,4
3679,18,121,119,240,True,1,4
3680,19,85,81,166,True,1,4
3681,20,98,79,177,True,1,4
3682,21,49,128,177,True,1,4
3683,22,45,70,115,True,1,4
3684,23,32,51,83,True,1,4
3685,0,22,54,76,False,2,4
3686,1,21,51,72,False,2,4
3687,2,12,25,37,False,2,4
3688,3,19,20,39,False,2,4
3689,4,132,64,196,False,2,4
3690,5,222,172,394,False,2,4
3691,6,355,179,534,False,2,4
3692,7,247,159,406,False,2,4
3693,8,226,185,411,False,2,4
3694,9,233,202,435,False,2,4
3695,10,220,175,395,False,2,4
3696,11,217,208,425,False,2,4
3697,12,223,235,458,False,2,4
3698,13,242,344,586,False,2,4
3699,14,235,296,531,False,2,4
3700,15,200,192,392,False,2,4
3701,16,172,169,341,False,2,4
3702,17,150,156,306,False,2,4
3703,18,136,130,266,False,2,4
3704,19,109,101,210,False,2,4
3705,20,88,71,159,False,2,4
3706,21,47,44,91,False,2,4
3707,22,23,23,46,False,2,4
3708,23,11,14,25,False,2,4
3709,0,9,7,16,False,3,4
3710,1,9,7,16,False,3,4
3711,2,10,11,21,False,3,4
3712,3,19,19,38,False,3,4
3713,4,109,63,172,False,3,4
3714,5,238,170,408,False,3,4
3715,6,353,237,590,False,3,4
3716,7,295,164,459,False,3,4
3717,8,194,175,369,False,3,4
3718,9,263,183,446,False,3,4
3719,10,223,205,428,False,3,4
3720,11,252,260,512,False,3,4
3721,12,236,288,524,False,3,4
3722,13,305,365,670,False,3,4
3723,14,240,308,548,False,3,4
3724,15,204,194,398,False,3,4
3725,16,186,168,354,False,3,4
3726,17,128,162,290,False,3,4
3727,18,128,129,257,False,3,4
3728,19,87,124,211,False,3,4
3729,20,83,89,172,False,3,4
3730,21,45,59,104,False,3,4
3731,22,18,27,45,False,3,4
3732,23,12,19,31,False,3,4
3733,0,8,15,23,False,4,4
3734,1,9,17,26,False,4,4
3735,2,6,14,20,False,4,4
3736,3,21,18,39,False,4,4
3737,4,132,62,194,False,4,4
3738,5,247,174,421,False,4,4
3739,6,356,226,582,False,4,4
3740,7,266,153,419,False,4,4
3741,8,263,198,461,False,4,4
3742,9,220,227,447,False,4,4
3743,10,222,241,463,False,4,4
3744,11,233,248,481,False,4,4
3745,12,291,274,565,False,4,4
3746,13,285,362,647,False,4,4
3747,14,220,317,537,False,4,4
3748,15,182,193,375,False,4,4
3749,16,144,157,301,False,4,4
3750,17,145,143,288,False,4,4
3751,18,115,116,231,False,4,4
3752,19,93,124,217,False,4,4
3753,20,62,71,133,False,4,4
3754,21,47,65,112,False,4,4
3755,22,27,44,71,False,4,4
3756,23,8,18,26,False,4,4
3757,0,21,33,54,False,5,4
3758,1,17,36,53,False,5,4
3759,2,9,28,37,False,5,4
3760,3,5,8,13,False,5,4
3761,4,32,19,51,False,5,4
3762,5,40,28,68,False,5,4
3763,6,48,39,87,False,5,4
3764,7,79,69,148,False,5,4
3765,8,100,78,178,False,5,4
3766,9,161,140,301,False,5,4
3767,10,176,131,307,False,5,4
3768,11,202,149,351,False,5,4
3769,12,156,192,348,False,5,4
3770,13,194,189,383,False,5,4
3771,14,134,194,328,False,5,4
3772,15,143,171,314,False,5,4
3773,16,147,173,320,False,5,4
3774,17,124,107,231,False,5,4
3775,18,100,98,198,False,5,4
3776,19,66,89,155,False,5,4
3777,20,59,85,144,False,5,4
3778,21,42,57,99,False,5,4
3779,22,46,64,110,False,5,4
3780,23,40,48,88,False,5,4
3781,0,19,48,67,True,6,4
3782,1,28,56,84,True,6,4
3783,2,22,30,52,True,6,4
3784,3,6,23,29,True,6,4
3785,4,17,16,33,True,6,4
3786,5,26,18,44,True,6,4
3787,6,31,15,46,True,6,4
3788,7,42,31,73,True,6,4
3789,8,124,68,192,True,6,4
3790,9,125,65,190,True,6,4
3791,10,145,119,264,True,6,4
3792,11,202,193,395,True,6,4
3793,12,184,199,383,True,6,4
3794,13,168,205,373,True,6,4
3795,14,146,234,380,True,6,4
3796,15,175,200,375,True,6,4
3797,16,110,112,222,True,6,4
3798,17,131,137,268,True,6,4
3799,18,138,167,305,True,6,4
3800,19,90,135,225,True,6,4
3801,20,74,87,161,True,6,4
3802,21,41,53,94,True,6,4
3803,22,18,15,33,True,6,4
3804,23,15,18,33,True,6,4
3805,0,5,9,14,False,0,4
3806,1,8,10,18,False,0,4
3807,2,5,13,18,False,0,4
3808,3,20,14,34,False,0,4
3809,4,151,63,214,False,0,4
3810,5,255,182,437,False,0,4
3811,6,417,220,637,False,0,4
3812,7,287,194,481,False,0,4
3813,8,218,177,395,False,0,4
3814,9,240,192,432,False,0,4
3815,10,252,214,466,False,0,4
3816,11,218,225,443,False,0,4
3817,12,210,280,490,False,0,4
3818,13,289,344,633,False,0,4
3819,14,219,297,516,False,0,4
3820,15,171,204,375,False,0,4
3821,16,174,158,332,False,0,4
3822,17,150,196,346,False,0,4
3823,18,134,144,278,False,0,4
3824,19,99,122,221,False,0,4
3825,20,95,96,191,False,0,4
3826,21,42,41,83,False,0,4
3827,22,15,25,40,False,0,4
3828,23,10,16,26,False,0,4
3829,0,9,9,18,False,1,4
3830,1,11,6,17,False,1,4
3831,2,6,10,16,False,1,4
3832,3,22,13,35,False,1,4
3833,4,131,64,195,False,1,4
3834,5,283,187,470,False,1,4
3835,6,417,211,628,False,1,4
3836,7,267,170,437,False,1,4
3837,8,236,208,444,False,1,4
3838,9,211,207,418,False,1,4
3839,10,221,222,443,False,1,4
3840,11,201,236,437,False,1,4
3841,12,212,232,444,False,1,4
3842,13,265,357,622,False,1,4
3843,14,222,279,501,False,1,4
3844,15,183,194,377,False,1,4
3845,16,159,183,342,False,1,4
3846,17,168,170,338,False,1,4
3847,18,110,142,252,False,1,4
3848,19,108,113,221,False,1,4
3849,20,96,101,197,False,1,4
3850,21,44,56,100,False,1,4
3851,22,20,31,51,False,1,4
3852,23,20,21,41,False,1,4
3853,0,6,18,24,False,2,4
3854,1,10,14,24,False,2,4
3855,2,5,10,15,False,2,4
3856,3,19,15,34,False,2,4
3857,4,129,69,198,False,2,4
3858,5,260,191,451,False,2,4
3859,6,367,217,584,False,2,4
3860,7,246,184,430,False,2,4
3861,8,233,180,413,False,2,4
3862,9,231,193,424,False,2,4
3863,10,238,235,473,False,2,4
3864,11,214,219,433,False,2,4
3865,12,222,259,481,False,2,4
3866,13,288,361,649,False,2,4
3867,14,236,283,519,False,2,4
3868,15,200,205,405,False,2,4
3869,16,176,177,353,False,2,4
3870,17,164,171,335,False,2,4
3871,18,152,154,306,False,2,4
3872,19,111,147,258,False,2,4
3873,20,94,109,203,False,2,4
3874,21,44,82,126,False,2,4
3875,22,21,32,53,False,2,4
3876,23,14,24,38,False,2,4
3877,0,15,28,43,False,3,4
3878,1,16,21,37,False,3,4
3879,2,8,12,20,False,3,4
3880,3,17,13,30,False,3,4
3881,4,133,56,189,False,3,4
3882,5,237,179,416,False,3,4
3883,6,364,196,560,False,3,4
3884,7,265,178,443,False,3,4
3885,8,198,172,370,False,3,4
3886,9,221,189,410,False,3,4
3887,10,235,223,458,False,3,4
3888,11,234,217,451,False,3,4
3889,12,200,249,449,False,3,4
3890,13,281,355,636,False,3,4
3891,14,241,243,484,False,3,4
3892,15,191,198,389,False,3,4
3893,16,172,188,360,False,3,4
3894,17,158,178,336,False,3,4
3895,18,141,153,294,False,3,4
3896,19,115,125,240,False,3,4
3897,20,81,113,194,False,3,4
3898,21,47,69,116,False,3,4
3899,22,22,38,60,False,3,4
3900,23,15,29,44,False,3,4
3901,0,7,33,40,False,4,4
3902,1,15,22,37,False,4,4
3903,2,9,16,25,False,4,4
3904,3,20,14,34,False,4,4
3905,4,131,62,193,False,4,4
3906,5,244,182,426,False,4,4
3907,6,356,234,590,False,4,4
3908,7,271,184,455,False,4,4
3909,8,244,207,451,False,4,4
3910,9,247,223,470,False,4,4
3911,10,205,212,417,False,4,4
3912,11,247,246,493,False,4,4
3913,12,256,304,560,False,4,4
3914,13,311,331,642,False,4,4
3915,14,212,280,492,False,4,4
3916,15,174,209,383,False,4,4
3917,16,143,147,290,False,4,4
3918,17,139,148,287,False,4,4
3919,18,118,125,243,False,4,4
3920,19,92,106,198,False,4,4
3921,20,90,96,186,False,4,4
3922,21,42,65,107,False,4,4
3923,22,52,51,103,False,4,4
3924,23,25,100,125,False,4,4
3925,0,19,133,152,False,5,4
3926,1,18,47,65,False,5,4
3927,2,13,27,40,False,5,4
3928,3,7,13,20,False,5,4
3929,4,31,25,56,False,5,4
3930,5,32,30,62,False,5,4
3931,6,40,40,80,False,5,4
3932,7,65,56,121,False,5,4
3933,8,139,93,232,False,5,4
3934,9,146,129,275,False,5,4
3935,10,170,168,338,False,5,4
3936,11,181,161,342,False,5,4
3937,12,210,190,400,False,5,4
3938,13,148,189,337,False,5,4
3939,14,132,170,302,False,5,4
3940,15,151,176,327,False,5,4
3941,16,127,144,271,False,5,4
3942,17,126,130,256,False,5,4
3943,18,96,99,195,False,5,4
3944,19,76,87,163,False,5,4
3945,20,50,58,108,False,5,4
3946,21,57,72,129,False,5,4
3947,22,44,74,118,False,5,4
3948,23,47,56,103,False,5,4
3949,0,30,70,100,True,6,4
3950,1,27,64,91,True,6,4
3951,2,22,46,68,True,6,4
3952,3,14,12,26,True,6,4
3953,4,32,15,47,True,6,4
3954,5,30,17,47,True,6,4
3955,6,54,27,81,True,6,4
3956,7,54,43,97,True,6,4
3957,8,84,63,147,True,6,4
3958,9,130,100,230,True,6,4
3959,10,139,126,265,True,6,4
3960,11,165,162,327,True,6,4
3961,12,162,165,327,True,6,4
3962,13,159,173,332,True,6,4
3963,14,165,212,377,True,6,4
3964,15,179,202,381,True,6,4
3965,16,176,144,320,True,6,4
3966,17,152,166,318,True,6,4
3967,18,177,192,369,True,6,4
3968,19,115,129,244,True,6,4
3969,20,74,89,163,True,6,4
3970,21,44,76,120,True,6,4
3971,22,24,36,60,True,6,4
3972,23,9,20,29,True,6,4
3973,0,6,10,16,False,0,4
3974,1,4,6,10,False,0,4
3975,2,6,10,16,False,0,4
3976,3,12,12,24,False,0,4
3977,4,136,70,206,False,0,4
3978,5,244,171,415,False,0,4
3979,6,368,226,594,False,0,4
3980,7,282,165,447,False,0,4
3981,8,254,178,432,False,0,4
3982,9,224,205,429,False,0,4
3983,10,243,224,467,False,0,4
3984,11,233,216,449,False,0,4
3985,12,242,279,521,False,0,4
3986,13,274,356,630,False,0,4
3987,14,242,296,538,False,0,4
3988,15,221,218,439,False,0,4
3989,16,175,163,338,False,0,4
3990,17,133,162,295,False,0,4
3991,18,143,133,276,False,0,4
3992,19,92,111,203,False,0,4
3993,20,60,79,139,False,0,4
3994,21,30,46,76,False,0,4
3995,22,22,36,58,False,0,4
3996,23,8,20,28,False,0,4
3997,0,7,13,20,False,1,4
3998,1,13,13,26,False,1,4
3999,2,6,11,17,False,1,4
4000,3,20,13,33,False,1,4
4001,4,147,72,219,False,1,4
4002,5,242,186,428,False,1,4
4003,6,425,209,634,False,1,4
4004,7,279,155,434,False,1,4
4005,8,229,196,425,False,1,4
4006,9,245,191,436,False,1,4
4007,10,252,231,483,False,1,4
4008,11,208,248,456,False,1,4
4009,12,257,259,516,False,1,4
4010,13,258,348,606,False,1,4
4011,14,238,404,642,False,1,4
4012,15,192,214,406,False,1,4
4013,16,164,176,340,False,1,4
4014,17,139,186,325,False,1,4
4015,18,129,129,258,False,1,4
4016,19,117,124,241,False,1,4
4017,20,81,114,195,False,1,4
4018,21,58,55,113,False,1,4
4019,22,26,40,66,False,1,4
4020,23,16,30,46,False,1,4
4021,0,9,16,25,False,2,5
4022,1,11,16,27,False,2,5
4023,2,7,12,19,False,2,5
4024,3,19,15,34,False,2,5
4025,4,125,71,196,False,2,5
4026,5,239,159,398,False,2,5
4027,6,368,226,594,False,2,5
4028,7,297,183,480,False,2,5
4029,8,269,183,452,False,2,5
4030,9,215,178,393,False,2,5
4031,10,217,194,411,False,2,5
4032,11,227,236,463,False,2,5
4033,12,247,275,522,False,2,5
4034,13,252,364,616,False,2,5
4035,14,232,293,525,False,2,5
4036,15,222,212,434,False,2,5
4037,16,199,174,373,False,2,5
4038,17,152,155,307,False,2,5
4039,18,127,166,293,False,2,5
4040,19,95,128,223,False,2,5
4041,20,63,83,146,False,2,5
4042,21,46,52,98,False,2,5
4043,22,25,32,57,False,2,5
4044,23,11,21,32,False,2,5
4045,0,7,14,21,False,3,5
4046,1,9,13,22,False,3,5
4047,2,8,8,16,False,3,5
4048,3,18,15,33,False,3,5
4049,4,130,57,187,False,3,5
4050,5,233,173,406,False,3,5
4051,6,427,214,641,False,3,5
4052,7,311,182,493,False,3,5
4053,8,244,200,444,False,3,5
4054,9,232,193,425,False,3,5
4055,10,253,215,468,False,3,5
4056,11,215,240,455,False,3,5
4057,12,237,279,516,False,3,5
4058,13,263,354,617,False,3,5
4059,14,243,296,539,False,3,5
4060,15,226,209,435,False,3,5
4061,16,185,174,359,False,3,5
4062,17,147,189,336,False,3,5
4063,18,131,173,304,False,3,5
4064,19,102,124,226,False,3,5
4065,20,90,105,195,False,3,5
4066,21,39,66,105,False,3,5
4067,22,30,37,67,False,3,5
4068,23,18,46,64,False,3,5
4069,0,18,23,41,False,4,5
4070,1,12,19,31,False,4,5
4071,2,11,20,31,False,4,5
4072,3,26,13,39,False,4,5
4073,4,117,71,188,False,4,5
4074,5,235,163,398,False,4,5
4075,6,334,242,576,False,4,5
4076,7,242,194,436,False,4,5
4077,8,246,187,433,False,4,5
4078,9,249,218,467,False,4,5
4079,10,233,250,483,False,4,5
4080,11,218,259,477,False,4,5
4081,12,250,293,543,False,4,5
4082,13,288,372,660,False,4,5
4083,14,203,252,455,False,4,5
4084,15,176,211,387,False,4,5
4085,16,132,153,285,False,4,5
4086,17,151,163,314,False,4,5
4087,18,124,120,244,False,4,5
4088,19,110,95,205,False,4,5
4089,20,105,121,226,False,4,5
4090,21,61,83,144,False,4,5
4091,22,69,73,142,False,4,5
4092,23,37,60,97,False,4,5
4093,0,26,60,86,False,5,5
4094,1,31,56,87,False,5,5
4095,2,21,28,49,False,5,5
4096,3,27,16,43,False,5,5
4097,4,42,100,142,False,5,5
4098,5,38,35,73,False,5,5
4099,6,59,61,120,False,5,5
4100,7,67,68,135,False,5,5
4101,8,111,112,223,False,5,5
4102,9,147,132,279,False,5,5
4103,10,157,138,295,False,5,5
4104,11,151,154,305,False,5,5
4105,12,143,164,307,False,5,5
4106,13,159,164,323,False,5,5
4107,14,137,149,286,False,5,5
4108,15,141,147,288,False,5,5
4109,16,167,141,308,False,5,5
4110,17,119,129,248,False,5,5
4111,18,101,127,228,False,5,5
4112,19,88,89,177,False,5,5
4113,20,93,82,175,False,5,5
4114,21,68,70,138,False,5,5
4115,22,56,70,126,False,5,5
4116,23,30,54,84,False,5,5
4117,0,30,53,83,True,6,5
4118,1,31,69,100,True,6,5
4119,2,22,44,66,True,6,5
4120,3,11,20,31,True,6,5
4121,4,13,15,28,True,6,5
4122,5,21,23,44,True,6,5
4123,6,48,30,78,True,6,5
4124,7,46,48,94,True,6,5
4125,8,111,59,170,True,6,5
4126,9,163,116,279,True,6,5
4127,10,155,143,298,True,6,5
4128,11,158,190,348,True,6,5
4129,12,175,190,365,True,6,5
4130,13,145,220,365,True,6,5
4131,14,159,223,382,True,6,5
4132,15,172,181,353,True,6,5
4133,16,162,180,342,True,6,5
4134,17,198,184,382,True,6,5
4135,18,144,221,365,True,6,5
4136,19,141,138,279,True,6,5
4137,20,94,113,207,True,6,5
4138,21,49,71,120,True,6,5
4139,22,27,31,58,True,6,5
4140,23,10,18,28,True,6,5
4141,0,10,16,26,False,0,5
4142,1,6,10,16,False,0,5
4143,2,10,12,22,False,0,5
4144,3,16,6,22,False,0,5
4145,4,138,64,202,False,0,5
4146,5,233,178,411,False,0,5
4147,6,405,215,620,False,0,5
4148,7,286,200,486,False,0,5
4149,8,245,170,415,False,0,5
4150,9,244,197,441,False,0,5
4151,10,208,234,442,False,0,5
4152,11,221,234,455,False,0,5
4153,12,238,269,507,False,0,5
4154,13,261,347,608,False,0,5
4155,14,242,264,506,False,0,5
4156,15,186,217,403,False,0,5
4157,16,183,181,364,False,0,5
4158,17,169,146,315,False,0,5
4159,18,130,155,285,False,0,5
4160,19,103,122,225,False,0,5
4161,20,69,103,172,False,0,5
4162,21,44,51,95,False,0,5
4163,22,27,24,51,False,0,5
4164,23,12,24,36,False,0,5
4165,0,6,13,19,False,1,5
4166,1,8,19,27,False,1,5
4167,2,8,10,18,False,1,5
4168,3,23,12,35,False,1,5
4169,4,141,68,209,False,1,5
4170,5,249,172,421,False,1,5
4171,6,358,210,568,False,1,5
4172,7,283,177,460,False,1,5
4173,8,244,185,429,False,1,5
4174,9,222,195,417,False,1,5
4175,10,223,208,431,False,1,5
4176,11,236,205,441,False,1,5
4177,12,260,257,517,False,1,5
4178,13,271,362,633,False,1,5
4179,14,197,286,483,False,1,5
4180,15,192,199,391,False,1,5
4181,16,169,169,338,False,1,5
4182,17,137,160,297,False,1,5
4183,18,135,115,250,False,1,5
4184,19,108,122,230,False,1,5
4185,20,69,103,172,False,1,5
4186,21,39,58,97,False,1,5
4187,22,21,20,41,False,1,5
4188,23,17,24,41,False,1,5
4189,0,14,20,34,False,2,5
4190,1,11,18,29,False,2,5
4191,2,6,12,18,False,2,5
4192,3,15,14,29,False,2,5
4193,4,136,74,210,False,2,5
4194,5,245,182,427,False,2,5
4195,6,360,207,567,False,2,5
4196,7,273,217,490,False,2,5
4197,8,222,176,398,False,2,5
4198,9,219,186,405,False,2,5
4199,10,240,232,472,False,2,5
4200,11,231,206,437,False,2,5
4201,12,247,252,499,False,2,5
4202,13,283,384,667,False,2,5
4203,14,237,290,527,False,2,5
4204,15,200,193,393,False,2,5
4205,16,168,149,317,False,2,5
4206,17,138,134,272,False,2,5
4207,18,139,159,298,False,2,5
4208,19,98,129,227,False,2,5
4209,20,77,104,181,False,2,5
4210,21,48,42,90,False,2,5
4211,22,44,35,79,False,2,5
4212,23,17,68,85,False,2,5
4213,0,16,23,39,False,3,5
4214,1,11,20,31,False,3,5
4215,2,7,15,22,False,3,5
4216,3,14,15,29,False,3,5
4217,4,146,62,208,False,3,5
4218,5,213,170,383,False,3,5
4219,6,385,201,586,False,3,5
4220,7,270,174,444,False,3,5
4221,8,241,195,436,False,3,5
4222,9,242,182,424,False,3,5
4223,10,239,230,469,False,3,5
4224,11,250,232,482,False,3,5
4225,12,244,245,489,False,3,5
4226,13,242,354,596,False,3,5
4227,14,227,280,507,False,3,5
4228,15,204,198,402,False,3,5
4229,16,143,177,320,False,3,5
4230,17,164,168,332,False,3,5
4231,18,126,125,251,False,3,5
4232,19,109,131,240,False,3,5
4233,20,77,100,177,False,3,5
4234,21,54,52,106,False,3,5
4235,22,26,32,58,False,3,5
4236,23,11,34,45,False,3,5
4237,0,24,17,41,False,4,5
4238,1,13,27,40,False,4,5
4239,2,10,22,32,False,4,5
4240,3,24,12,36,False,4,5
4241,4,128,62,190,False,4,5
4242,5,211,185,396,False,4,5
4243,6,361,205,566,False,4,5
4244,7,276,189,465,False,4,5
4245,8,241,193,434,False,4,5
4246,9,228,201,429,False,4,5
4247,10,244,191,435,False,4,5
4248,11,266,243,509,False,4,5
4249,12,267,295,562,False,4,5
4250,13,269,367,636,False,4,5
4251,14,214,278,492,False,4,5
4252,15,178,206,384,False,4,5
4253,16,151,130,281,False,4,5
4254,17,126,137,263,False,4,5
4255,18,133,121,254,False,4,5
4256,19,94,92,186,False,4,5
4257,20,76,95,171,False,4,5
4258,21,63,81,144,False,4,5
4259,22,36,55,91,False,4,5
4260,23,32,54,86,False,4,5
4261,0,33,46,79,False,5,5
4262,1,28,39,67,False,5,5
4263,2,21,34,55,False,5,5
4264,3,8,5,13,False,5,5
4265,4,29,21,50,False,5,5
4266,5,37,24,61,False,5,5
4267,6,49,36,85,False,5,5
4268,7,68,61,129,False,5,5
4269,8,165,95,260,False,5,5
4270,9,166,109,275,False,5,5
4271,10,178,141,319,False,5,5
4272,11,191,210,401,False,5,5
4273,12,168,173,341,False,5,5
4274,13,162,180,342,False,5,5
4275,14,148,165,313,False,5,5
4276,15,135,154,289,False,5,5
4277,16,108,123,231,False,5,5
4278,17,108,118,226,False,5,5
4279,18,85,93,178,False,5,5
4280,19,60,76,136,False,5,5
4281,20,61,77,138,False,5,5
4282,21,54,58,112,False,5,5
4283,22,55,64,119,False,5,5
4284,23,31,44,75,False,5,5
4285,0,28,47,75,True,6,5
4286,1,28,60,88,True,6,5
4287,2,15,50,65,True,6,5
4288,3,22,19,41,True,6,5
4289,4,26,15,41,True,6,5
4290,5,16,14,30,True,6,5
4291,6,32,22,54,True,6,5
4292,7,56,39,95,True,6,5
4293,8,78,61,139,True,6,5
4294,9,120,83,203,True,6,5
4295,10,153,100,253,True,6,5
4296,11,128,168,296,True,6,5
4297,12,170,182,352,True,6,5
4298,13,165,179,344,True,6,5
4299,14,155,164,319,True,6,5
4300,15,164,176,340,True,6,5
4301,16,145,131,276,True,6,5
4302,17,183,139,322,True,6,5
4303,18,138,137,275,True,6,5
4304,19,98,138,236,True,6,5
4305,20,66,93,159,True,6,5
4306,21,52,66,118,True,6,5
4307,22,30,31,61,True,6,5
4308,23,16,20,36,True,6,5
4309,0,10,19,29,False,0,5
4310,1,9,13,22,False,0,5
4311,2,8,14,22,False,0,5
4312,3,18,15,33,False,0,5
4313,4,151,74,225,False,0,5
4314,5,244,176,420,False,0,5
4315,6,391,216,607,False,0,5
4316,7,273,172,445,False,0,5
4317,8,246,186,432,False,0,5
4318,9,235,208,443,False,0,5
4319,10,247,237,484,False,0,5
4320,11,244,248,492,False,0,5
4321,12,227,293,520,False,0,5
4322,13,261,343,604,False,0,5
4323,14,232,308,540,False,0,5
4324,15,178,201,379,False,0,5
4325,16,153,165,318,False,0,5
4326,17,125,131,256,False,0,5
4327,18,101,124,225,False,0,5
4328,19,85,108,193,False,0,5
4329,20,78,88,166,False,0,5
4330,21,77,72,149,False,0,5
4331,22,34,43,77,False,0,5
4332,23,25,23,48,False,0,5
4333,0,12,17,29,False,1,5
4334,1,12,15,27,False,1,5
4335,2,10,18,28,False,1,5
4336,3,22,18,40,False,1,5
4337,4,153,68,221,False,1,5
4338,5,247,196,443,False,1,5
4339,6,389,205,594,False,1,5
4340,7,292,199,491,False,1,5
4341,8,227,178,405,False,1,5
4342,9,244,184,428,False,1,5
4343,10,251,251,502,False,1,5
4344,11,238,235,473,False,1,5
4345,12,234,295,529,False,1,5
4346,13,300,354,654,False,1,5
4347,14,223,293,516,False,1,5
4348,15,186,183,369,False,1,5
4349,16,156,153,309,False,1,5
4350,17,154,168,322,False,1,5
4351,18,139,140,279,False,1,5
4352,19,109,114,223,False,1,5
4353,20,67,102,169,False,1,5
4354,21,50,80,130,False,1,5
4355,22,23,33,56,False,1,5
4356,23,14,24,38,False,1,5
4357,0,11,19,30,False,2,5
4358,1,7,15,22,False,2,5
4359,2,9,16,25,False,2,5
4360,3,22,13,35,False,2,5
4361,4,141,71,212,False,2,5
4362,5,248,176,424,False,2,5
4363,6,366,205,571,False,2,5
4364,7,259,192,451,False,2,5
4365,8,227,168,395,False,2,5
4366,9,224,193,417,False,2,5
4367,10,259,212,471,False,2,5
4368,11,240,245,485,False,2,5
4369,12,259,283,542,False,2,5
4370,13,305,365,670,False,2,5
4371,14,214,261,475,False,2,5
4372,15,216,193,409,False,2,5
4373,16,171,177,348,False,2,5
4374,17,129,167,296,False,2,5
4375,18,117,140,257,False,2,5
4376,19,96,129,225,False,2,5
4377,20,73,228,301,False,2,5
4378,21,49,67,116,False,2,5
4379,22,23,33,56,False,2,5
4380,23,28,34,62,False,2,5
4381,0,21,32,53,False,3,5
4382,1,9,16,25,False,3,5
4383,2,9,14,23,False,3,5
4384,3,23,14,37,False,3,5
4385,4,136,61,197,False,3,5
4386,5,232,153,385,False,3,5
4387,6,337,199,536,False,3,5
4388,7,280,197,477,False,3,5
4389,8,288,206,494,False,3,5
4390,9,229,199,428,False,3,5
4391,10,248,232,480,False,3,5
4392,11,231,230,461,False,3,5
4393,12,246,276,522,False,3,5
4394,13,282,328,610,False,3,5
4395,14,214,296,510,False,3,5
4396,15,174,198,372,False,3,5
4397,16,175,142,317,False,3,5
4398,17,120,152,272,False,3,5
4399,18,128,121,249,False,3,5
4400,19,106,110,216,False,3,5
4401,20,82,313,395,False,3,5
4402,21,56,325,381,False,3,5
4403,22,44,152,196,False,3,5
4404,23,14,107,121,False,3,5
4405,0,21,86,107,False,4,5
4406,1,12,64,76,False,4,5
4407,2,13,49,62,False,4,5
4408,3,26,19,45,False,4,5
4409,4,135,61,196,False,4,5
4410,5,236,159,395,False,4,5
4411,6,353,199,552,False,4,5
4412,7,263,198,461,False,4,5
4413,8,232,211,443,False,4,5
4414,9,262,227,489,False,4,5
4415,10,261,234,495,False,4,5
4416,11,215,241,456,False,4,5
4417,12,257,349,606,False,4,5
4418,13,252,341,593,False,4,5
4419,14,193,279,472,False,4,5
4420,15,126,175,301,False,4,5
4421,16,160,150,310,False,4,5
4422,17,125,139,264,False,4,5
4423,18,103,109,212,False,4,5
4424,19,60,89,149,False,4,5
4425,20,54,78,132,False,4,5
4426,21,52,69,121,False,4,5
4427,22,39,56,95,False,4,5
4428,23,37,44,81,False,4,5
4429,0,23,34,57,False,5,5
4430,1,22,43,65,False,5,5
4431,2,18,34,52,False,5,5
4432,3,12,16,28,False,5,5
4433,4,29,21,50,False,5,5
4434,5,40,24,64,False,5,5
4435,6,49,31,80,False,5,5
4436,7,75,53,128,False,5,5
4437,8,114,80,194,False,5,5
4438,9,166,128,294,False,5,5
4439,10,179,121,300,False,5,5
4440,11,165,162,327,False,5,5
4441,12,171,172,343,False,5,5
4442,13,142,133,275,False,5,5
4443,14,177,157,334,False,5,5
4444,15,126,150,276,False,5,5
4445,16,124,128,252,False,5,5
4446,17,101,114,215,False,5,5
4447,18,95,81,176,False,5,5
4448,19,77,96,173,False,5,5
4449,20,49,68,117,False,5,5
4450,21,61,67,128,False,5,5
4451,22,49,63,112,False,5,5
4452,23,38,56,94,False,5,5
4453,0,48,54,102,True,6,5
4454,1,31,57,88,True,6,5
4455,2,18,36,54,True,6,5
4456,3,17,33,50,True,6,5
4457,4,16,14,30,True,6,5
4458,5,22,14,36,True,6,5
4459,6,31,17,48,True,6,5
4460,7,47,52,99,True,6,5
4461,8,94,58,152,True,6,5
4462,9,126,92,218,True,6,5
4463,10,152,133,285,True,6,5
4464,11,152,164,316,True,6,5
4465,12,169,182,351,True,6,5
4466,13,186,183,369,True,6,5
4467,14,136,202,338,True,6,5
4468,15,154,165,319,True,6,5
4469,16,172,173,345,True,6,5
4470,17,153,130,283,True,6,5
4471,18,149,156,305,True,6,5
4472,19,97,137,234,True,6,5
4473,20,72,91,163,True,6,5
4474,21,56,72,128,True,6,5
4475,22,35,44,79,True,6,5
4476,23,15,29,44,True,6,5
4477,0,7,15,22,False,0,5
4478,1,6,14,20,False,0,5
4479,2,10,16,26,False,0,5
4480,3,17,14,31,False,0,5
4481,4,152,65,217,False,0,5
4482,5,256,190,446,False,0,5
4483,6,363,205,568,False,0,5
4484,7,307,192,499,False,0,5
4485,8,244,175,419,False,0,5
4486,9,243,184,427,False,0,5
4487,10,230,213,443,False,0,5
4488,11,248,230,478,False,0,5
4489,12,267,295,562,False,0,5
4490,13,288,362,650,False,0,5
4491,14,298,300,598,False,0,5
4492,15,201,200,401,False,0,5
4493,16,175,176,351,False,0,5
4494,17,142,149,291,False,0,5
4495,18,138,121,259,False,0,5
4496,19,82,86,168,False,0,5
4497,20,49,216,265,False,0,5
4498,21,46,192,238,False,0,5
4499,22,26,71,97,False,0,5
4500,23,24,48,72,False,0,5
4501,0,12,28,40,False,1,5
4502,1,6,22,28,False,1,5
4503,2,11,33,44,False,1,5
4504,3,20,33,53,False,1,5
4505,4,155,71,226,False,1,5
4506,5,239,171,410,False,1,5
4507,6,355,190,545,False,1,5
4508,7,318,198,516,False,1,5
4509,8,245,191,436,False,1,5
4510,9,225,203,428,False,1,5
4511,10,249,199,448,False,1,5
4512,11,244,222,466,False,1,5
4513,12,231,290,521,False,1,5
4514,13,277,322,599,False,1,5
4515,14,246,266,512,False,1,5
4516,15,178,187,365,False,1,5
4517,16,168,169,337,False,1,5
4518,17,121,152,273,False,1,5
4519,18,129,130,259,False,1,5
4520,19,107,115,222,False,1,5
4521,20,88,83,171,False,1,5
4522,21,74,59,133,False,1,5
4523,22,39,35,74,False,1,5
4524,23,26,28,54,False,1,5
4525,0,17,44,61,False,2,5
4526,1,10,26,36,False,2,5
4527,2,9,16,25,False,2,5
4528,3,25,20,45,False,2,5
4529,4,136,63,199,False,2,5
4530,5,226,149,375,False,2,5
4531,6,326,163,489,False,2,5
4532,7,278,170,448,False,2,5
4533,8,251,183,434,False,2,5
4534,9,227,177,404,False,2,5
4535,10,237,227,464,False,2,5
4536,11,262,192,454,False,2,5
4537,12,274,284,558,False,2,5
4538,13,223,328,551,False,2,5
4539,14,219,248,467,False,2,5
4540,15,197,188,385,False,2,5
4541,16,199,167,366,False,2,5
4542,17,145,163,308,False,2,5
4543,18,137,135,272,False,2,5
4544,19,107,103,210,False,2,5
4545,20,78,75,153,False,2,5
4546,21,53,71,124,False,2,5
4547,22,28,32,60,False,2,5
4548,23,17,35,52,False,2,5
4549,0,14,26,40,False,3,5
4550,1,13,23,36,False,3,5
4551,2,5,17,22,False,3,5
4552,3,16,14,30,False,3,5
4553,4,137,58,195,False,3,5
4554,5,205,165,370,False,3,5
4555,6,327,184,511,False,3,5
4556,7,280,158,438,False,3,5
4557,8,215,166,381,False,3,5
4558,9,228,195,423,False,3,5
4559,10,236,195,431,False,3,5
4560,11,273,217,490,False,3,5
4561,12,239,238,477,False,3,5
4562,13,251,361,612,False,3,5
4563,14,200,275,475,False,3,5
4564,15,198,168,366,False,3,5
4565,16,170,150,320,False,3,5
4566,17,119,134,253,False,3,5
4567,18,112,119,231,False,3,5
4568,19,107,111,218,False,3,5
4569,20,90,89,179,False,3,5
4570,21,79,62,141,False,3,5
4571,22,34,31,65,False,3,5
4572,23,29,30,59,False,3,5
4573,0,20,21,41,False,4,5
4574,1,11,19,30,False,4,5
4575,2,9,21,30,False,4,5
4576,3,22,12,34,False,4,5
4577,4,130,57,187,False,4,5
4578,5,213,142,355,False,4,5
4579,6,326,169,495,False,4,5
4580,7,263,160,423,False,4,5
4581,8,223,170,393,False,4,5
4582,9,256,200,456,False,4,5
4583,10,237,202,439,False,4,5
4584,11,246,239,485,False,4,5
4585,12,231,269,500,False,4,5
4586,13,301,352,653,False,4,5
4587,14,249,282,531,False,4,5
4588,15,201,171,372,False,4,5
4589,16,186,151,337,False,4,5
4590,17,115,124,239,False,4,5
4591,18,97,111,208,False,4,5
4592,19,79,88,167,False,4,5
4593,20,65,96,161,False,4,5
4594,21,52,87,139,False,4,5
4595,22,52,62,114,False,4,5
4596,23,25,43,68,False,4,5
4597,0,19,30,49,False,5,5
4598,1,24,33,57,False,5,5
4599,2,13,28,41,False,5,5
4600,3,14,16,30,False,5,5
4601,4,21,14,35,False,5,5
4602,5,44,27,71,False,5,5
4603,6,46,47,93,False,5,5
4604,7,69,58,127,False,5,5
4605,8,131,75,206,False,5,5
4606,9,171,140,311,False,5,5
4607,10,181,148,329,False,5,5
4608,11,227,174,401,False,5,5
4609,12,194,204,398,False,5,5
4610,13,151,167,318,False,5,5
4611,14,114,156,270,False,5,5
4612,15,130,126,256,False,5,5
4613,16,136,135,271,False,5,5
4614,17,92,108,200,False,5,5
4615,18,90,93,183,False,5,5
4616,19,60,84,144,False,5,5
4617,20,45,53,98,False,5,5
4618,21,52,58,110,False,5,5
4619,22,42,73,115,False,5,5
4620,23,26,60,86,False,5,5
4621,0,41,42,83,True,6,5
4622,1,34,60,94,True,6,5
4623,2,13,28,41,True,6,5
4624,3,12,7,19,True,6,5
4625,4,11,10,21,True,6,5
4626,5,18,17,35,True,6,5
4627,6,37,17,54,True,6,5
4628,7,37,32,69,True,6,5
4629,8,86,58,144,True,6,5
4630,9,111,81,192,True,6,5
4631,10,164,129,293,True,6,5
4632,11,149,161,310,True,6,5
4633,12,204,180,384,True,6,5
4634,13,146,186,332,True,6,5
4635,14,129,174,303,True,6,5
4636,15,157,165,322,True,6,5
4637,16,150,144,294,True,6,5
4638,17,140,148,288,True,6,5
4639,18,127,148,275,True,6,5
4640,19,88,122,210,True,6,5
4641,20,39,71,110,True,6,5
4642,21,51,55,106,True,6,5
4643,22,38,32,70,True,6,5
4644,23,20,15,35,True,6,5
4645,0,8,12,20,False,0,5
4646,1,5,11,16,False,0,5
4647,2,2,14,16,False,0,5
4648,3,16,14,30,False,0,5
4649,4,142,58,200,False,0,5
4650,5,226,158,384,False,0,5
4651,6,297,177,474,False,0,5
4652,7,307,174,481,False,0,5
4653,8,220,175,395,False,0,5
4654,9,232,160,392,False,0,5
4655,10,211,192,403,False,0,5
4656,11,240,208,448,False,0,5
4657,12,233,261,494,False,0,5
4658,13,256,320,576,False,0,5
4659,14,198,255,453,False,0,5
4660,15,166,191,357,False,0,5
4661,16,133,142,275,False,0,5
4662,17,116,114,230,False,0,5
4663,18,111,106,217,False,0,5
4664,19,69,79,148,False,0,5
4665,20,60,64,124,False,0,5
4666,21,42,59,101,False,0,5
4667,22,45,38,83,False,0,5
4668,23,17,21,38,False,0,5
4669,0,18,19,37,False,1,5
4670,1,5,13,18,False,1,5
4671,2,8,10,18,False,1,5
4672,3,13,10,23,False,1,5
4673,4,134,60,194,False,1,5
4674,5,206,146,352,False,1,5
4675,6,316,172,488,False,1,5
4676,7,254,170,424,False,1,5
4677,8,253,179,432,False,1,5
4678,9,224,192,416,False,1,5
4679,10,231,181,412,False,1,5
4680,11,245,239,484,False,1,5
4681,12,255,245,500,False,1,5
4682,13,291,339,630,False,1,5
4683,14,259,429,688,False,1,5
4684,15,173,197,370,False,1,5
4685,16,174,147,321,False,1,5
4686,17,157,146,303,False,1,5
4687,18,146,127,273,False,1,5
4688,19,119,114,233,False,1,5
4689,20,73,89,162,False,1,5
4690,21,35,45,80,False,1,5
4691,22,22,24,46,False,1,5
4692,23,18,30,48,False,1,5
4693,0,14,16,30,False,2,5
4694,1,7,9,16,False,2,5
4695,2,14,19,33,False,2,5
4696,3,16,9,25,False,2,5
4697,4,128,65,193,False,2,5
4698,5,209,148,357,False,2,5
4699,6,316,156,472,False,2,5
4700,7,236,180,416,False,2,5
4701,8,256,185,441,False,2,5
4702,9,216,163,379,False,2,5
4703,10,263,239,502,False,2,5
4704,11,231,210,441,False,2,5
4705,12,222,260,482,False,2,5
4706,13,236,281,517,False,2,5
4707,14,210,262,472,False,2,5
4708,15,203,213,416,False,2,5
4709,16,165,154,319,False,2,5
4710,17,132,119,251,False,2,5
4711,18,123,110,233,False,2,5
4712,19,88,104,192,False,2,5
4713,20,68,67,135,False,2,5
4714,21,43,56,99,False,2,5
4715,22,32,28,60,False,2,5
4716,23,23,30,53,False,2,5
4717,0,11,22,33,False,3,5
4718,1,5,12,17,False,3,5
4719,2,9,19,28,False,3,5
4720,3,16,12,28,False,3,5
4721,4,123,63,186,False,3,5
4722,5,217,152,369,False,3,5
4723,6,317,177,494,False,3,5
4724,7,292,162,454,False,3,5
4725,8,232,162,394,False,3,5
4726,9,243,209,452,False,3,5
4727,10,222,176,398,False,3,5
4728,11,245,219,464,False,3,5
4729,12,234,271,505,False,3,5
4730,13,277,329,606,False,3,5
4731,14,227,287,514,False,3,5
4732,15,204,226,430,False,3,5
4733,16,172,185,357,False,3,5
4734,17,145,140,285,False,3,5
4735,18,163,131,294,False,3,5
4736,19,102,102,204,False,3,5
4737,20,55,79,134,False,3,5
4738,21,42,72,114,False,3,5
4739,22,40,56,96,False,3,5
4740,23,24,36,60,False,3,5
4741,0,10,17,27,False,4,6
4742,1,11,14,25,False,4,6
4743,2,7,18,25,False,4,6
4744,3,15,15,30,False,4,6
4745,4,132,59,191,False,4,6
4746,5,189,115,304,False,4,6
4747,6,268,161,429,False,4,6
4748,7,268,157,425,False,4,6
4749,8,235,180,415,False,4,6
4750,9,234,216,450,False,4,6
4751,10,247,220,467,False,4,6
4752,11,252,233,485,False,4,6
4753,12,245,271,516,False,4,6
4754,13,252,316,568,False,4,6
4755,14,180,225,405,False,4,6
4756,15,152,182,334,False,4,6
4757,16,117,148,265,False,4,6
4758,17,113,107,220,False,4,6
4759,18,96,106,202,False,4,6
4760,19,73,68,141,False,4,6
4761,20,51,55,106,False,4,6
4762,21,43,49,92,False,4,6
4763,22,35,41,76,False,4,6
4764,23,30,31,61,False,4,6
4765,0,18,24,42,False,5,6
4766,1,14,25,39,False,5,6
4767,2,15,27,42,False,5,6
4768,3,11,18,29,False,5,6
4769,4,27,24,51,False,5,6
4770,5,46,26,72,False,5,6
4771,6,42,30,72,False,5,6
4772,7,61,54,115,False,5,6
4773,8,102,86,188,False,5,6
4774,9,179,101,280,False,5,6
4775,10,148,119,267,False,5,6
4776,11,155,156,311,False,5,6
4777,12,161,184,345,False,5,6
4778,13,139,171,310,False,5,6
4779,14,133,140,273,False,5,6
4780,15,113,146,259,False,5,6
4781,16,116,126,242,False,5,6
4782,17,93,100,193,False,5,6
4783,18,100,92,192,False,5,6
4784,19,65,72,137,False,5,6
4785,20,44,53,97,False,5,6
4786,21,36,46,82,False,5,6
4787,22,59,64,123,False,5,6
4788,23,30,54,84,False,5,6
4789,0,38,47,85,True,6,6
4790,1,19,41,60,True,6,6
4791,2,10,30,40,True,6,6
4792,3,15,18,33,True,6,6
4793,4,17,14,31,True,6,6
4794,5,22,19,41,True,6,6
4795,6,26,20,46,True,6,6
4796,7,30,34,64,True,6,6
4797,8,69,42,111,True,6,6
4798,9,94,73,167,True,6,6
4799,10,132,102,234,True,6,6
4800,11,135,134,269,True,6,6
4801,12,178,148,326,True,6,6
4802,13,174,199,373,True,6,6
4803,14,132,180,312,True,6,6
4804,15,153,135,288,True,6,6
4805,16,123,128,251,True,6,6
4806,17,142,120,262,True,6,6
4807,18,132,145,277,True,6,6
4808,19,69,97,166,True,6,6
4809,20,64,65,129,True,6,6
4810,21,45,63,108,True,6,6
4811,22,32,37,69,True,6,6
4812,23,20,22,42,True,6,6
4813,0,11,15,26,False,0,6
4814,1,6,12,18,False,0,6
4815,2,5,14,19,False,0,6
4816,3,17,11,28,False,0,6
4817,4,129,52,181,False,0,6
4818,5,192,135,327,False,0,6
4819,6,233,141,374,False,0,6
4820,7,239,144,383,False,0,6
4821,8,195,152,347,False,0,6
4822,9,236,165,401,False,0,6
4823,10,208,190,398,False,0,6
4824,11,208,187,395,False,0,6
4825,12,232,214,446,False,0,6
4826,13,237,291,528,False,0,6
4827,14,177,248,425,False,0,6
4828,15,174,157,331,False,0,6
4829,16,135,124,259,False,0,6
4830,17,96,141,237,False,0,6
4831,18,118,88,206,False,0,6
4832,19,85,92,177,False,0,6
4833,20,67,86,153,False,0,6
4834,21,43,47,90,False,0,6
4835,22,34,28,62,False,0,6
4836,23,21,23,44,False,0,6
4837,0,13,11,24,False,1,6
4838,1,10,21,31,False,1,6
4839,2,6,11,17,False,1,6
4840,3,15,15,30,False,1,6
4841,4,111,50,161,False,1,6
4842,5,176,128,304,False,1,6
4843,6,241,138,379,False,1,6
4844,7,233,138,371,False,1,6
4845,8,211,146,357,False,1,6
4846,9,226,180,406,False,1,6
4847,10,212,202,414,False,1,6
4848,11,234,202,436,False,1,6
4849,12,198,239,437,False,1,6
4850,13,225,261,486,False,1,6
4851,14,190,222,412,False,1,6
4852,15,150,152,302,False,1,6
4853,16,156,131,287,False,1,6
4854,17,114,131,245,False,1,6
4855,18,108,111,219,False,1,6
4856,19,106,94,200,False,1,6
4857,20,55,86,141,False,1,6
4858,21,41,68,109,False,1,6
4859,22,32,32,64,False,1,6
4860,23,24,27,51,False,1,6
4861,0,16,18,34,False,2,6
4862,1,11,21,32,False,2,6
4863,2,2,10,12,False,2,6
4864,3,16,14,30,False,2,6
4865,4,110,49,159,False,2,6
4866,5,181,121,302,False,2,6
4867,6,246,152,398,False,2,6
4868,7,225,132,357,False,2,6
4869,8,216,156,372,False,2,6
4870,9,236,204,440,False,2,6
4871,10,210,186,396,False,2,6
4872,11,241,217,458,False,2,6
4873,12,207,243,450,False,2,6
4874,13,216,270,486,False,2,6
4875,14,180,198,378,False,2,6
4876,15,169,167,336,False,2,6
4877,16,160,155,315,False,2,6
4878,17,117,127,244,False,2,6
4879,18,105,88,193,False,2,6
4880,19,74,81,155,False,2,6
4881,20,54,62,116,False,2,6
4882,21,58,62,120,False,2,6
4883,22,36,33,69,False,2,6
4884,23,22,20,42,False,2,6
4885,0,12,26,38,False,3,6
4886,1,3,16,19,False,3,6
4887,2,2,18,20,False,3,6
4888,3,14,9,23,False,3,6
4889,4,120,53,173,False,3,6
4890,5,172,117,289,False,3,6
4891,6,211,132,343,False,3,6
4892,7,223,133,356,False,3,6
4893,8,195,164,359,False,3,6
4894,9,198,169,367,False,3,6
4895,10,220,178,398,False,3,6
4896,11,202,158,360,False,3,6
4897,12,195,228,423,False,3,6
4898,13,215,236,451,False,3,6
4899,14,183,217,400,False,3,6
4900,15,153,157,310,False,3,6
4901,16,142,125,267,False,3,6
4902,17,121,124,245,False,3,6
4903,18,105,105,210,False,3,6
4904,19,68,69,137,False,3,6
4905,20,44,49,93,False,3,6
4906,21,43,71,114,False,3,6
4907,22,23,32,55,False,3,6
4908,23,12,25,37,False,3,6
4909,0,11,23,34,False,4,6
4910,1,7,19,26,False,4,6
4911,2,8,14,22,False,4,6
4912,3,15,8,23,False,4,6
4913,4,104,44,148,False,4,6
4914,5,164,124,288,False,4,6
4915,6,211,131,342,False,4,6
4916,7,177,128,305,False,4,6
4917,8,178,145,323,False,4,6
4918,9,204,160,364,False,4,6
4919,10,224,195,419,False,4,6
4920,11,182,195,377,False,4,6
4921,12,196,225,421,False,4,6
4922,13,199,257,456,False,4,6
4923,14,176,180,356,False,4,6
4924,15,137,137,274,False,4,6
4925,16,111,124,235,False,4,6
4926,17,97,99,196,False,4,6
4927,18,83,78,161,False,4,6
4928,19,76,88,164,False,4,6
4929,20,58,56,114,False,4,6
4930,21,36,47,83,False,4,6
4931,22,33,44,77,False,4,6
4932,23,17,29,46,False,4,6
4933,0,15,28,43,False,5,6
4934,1,11,31,42,False,5,6
4935,2,8,23,31,False,5,6
4936,3,15,11,26,False,5,6
4937,4,16,14,30,False,5,6
4938,5,28,29,57,False,5,6
4939,6,39,30,69,False,5,6
4940,7,51,39,90,False,5,6
4941,8,107,65,172,False,5,6
4942,9,127,88,215,False,5,6
4943,10,126,104,230,False,5,6
4944,11,123,114,237,False,5,6
4945,12,136,138,274,False,5,6
4946,13,115,154,269,False,5,6
4947,14,101,137,238,False,5,6
4948,15,127,138,265,False,5,6
4949,16,99,83,182,False,5,6
4950,17,85,78,163,False,5,6
4951,18,95,81,176,False,5,6
4952,19,57,80,137,False,5,6
4953,20,57,57,114,False,5,6
4954,21,38,56,94,False,5,6
4955,22,33,42,75,False,5,6
4956,23,26,48,74,False,5,6
4957,0,24,46,70,True,6,6
4958,1,26,42,68,True,6,6
4959,2,15,35,50,True,6,6
4960,3,23,12,35,True,6,6
4961,4,16,17,33,True,6,6
4962,5,17,21,38,True,6,6
4963,6,28,17,45,True,6,6
4964,7,26,31,57,True,6,6
4965,8,62,43,105,True,6,6
4966,9,87,69,156,True,6,6
4967,10,106,89,195,True,6,6
4968,11,123,110,233,True,6,6
4969,12,139,156,295,True,6,6
4970,13,131,131,262,True,6,6
4971,14,111,144,255,True,6,6
4972,15,115,137,252,True,6,6
4973,16,135,114,249,True,6,6
4974,17,123,133,256,True,6,6
4975,18,132,132,264,True,6,6
4976,19,62,54,116,True,6,6
4977,20,56,53,109,True,6,6
4978,21,42,51,93,True,6,6
4979,22,36,52,88,True,6,6
4980,23,15,26,41,True,6,6
4981,0,9,18,27,True,0,6
4982,1,9,14,23,True,0,6
4983,2,6,11,17,True,0,6
4984,3,11,13,24,True,0,6
4985,4,85,39,124,True,0,6
4986,5,137,105,242,True,0,6
4987,6,175,95,270,True,0,6
4988,7,161,120,281,True,0,6
4989,8,166,133,299,True,0,6
4990,9,193,149,342,True,0,6
4991,10,204,170,374,True,0,6
4992,11,211,218,429,True,0,6
4993,12,213,214,427,True,0,6
4994,13,186,248,434,True,0,6
4995,14,151,181,332,True,0,6
4996,15,131,144,275,True,0,6
4997,16,128,117,245,True,0,6
4998,17,117,106,223,True,0,6
4999,18,83,89,172,True,0,6
5000,19,59,69,128,True,0,6
5001,20,67,70,137,True,0,6
5002,21,34,45,79,True,0,6
5003,22,31,25,56,True,0,6
5004,23,23,16,39,True,0,6
5005,0,8,15,23,True,1,6
5006,1,6,11,17,True,1,6
5007,2,8,9,17,True,1,6
5008,3,15,9,24,True,1,6
5009,4,89,37,126,True,1,6
5010,5,127,85,212,True,1,6
5011,6,170,123,293,True,1,6
5012,7,163,120,283,True,1,6
5013,8,190,134,324,True,1,6
5014,9,206,146,352,True,1,6
5015,10,189,144,333,True,1,6
5016,11,199,207,406,True,1,6
5017,12,213,223,436,True,1,6
5018,13,171,250,421,True,1,6
5019,14,137,187,324,True,1,6
5020,15,149,149,298,True,1,6
5021,16,163,123,286,True,1,6
5022,17,110,111,221,True,1,6
5023,18,92,102,194,True,1,6
5024,19,68,81,149,True,1,6
5025,20,54,68,122,True,1,6
5026,21,33,38,71,True,1,6
5027,22,14,27,41,True,1,6
5028,23,15,20,35,True,1,6
5029,0,10,18,28,True,2,6
5030,1,9,15,24,True,2,6
5031,2,9,12,21,True,2,6
5032,3,14,14,28,True,2,6
5033,4,74,38,112,True,2,6
5034,5,125,83,208,True,2,6
5035,6,140,96,236,True,2,6
5036,7,160,113,273,True,2,6
5037,8,132,115,247,True,2,6
5038,9,198,121,319,True,2,6
5039,10,186,133,319,True,2,6
5040,11,186,158,344,True,2,6
5041,12,200,212,412,True,2,6
5042,13,177,203,380,True,2,6
5043,14,156,184,340,True,2,6
5044,15,146,154,300,True,2,6
5045,16,144,111,255,True,2,6
5046,17,100,110,210,True,2,6
5047,18,99,144,243,True,2,6
5048,19,83,100,183,True,2,6
5049,20,50,65,115,True,2,6
5050,21,40,40,80,True,2,6
5051,22,27,28,55,True,2,6
5052,23,19,24,43,True,2,6
5053,0,10,24,34,True,3,6
5054,1,9,18,27,True,3,6
5055,2,5,11,16,True,3,6
5056,3,7,12,19,True,3,6
5057,4,83,21,104,True,3,6
5058,5,135,99,234,True,3,6
5059,6,139,97,236,True,3,6
5060,7,129,104,233,True,3,6
5061,8,150,118,268,True,3,6
5062,9,144,127,271,True,3,6
5063,10,198,163,361,True,3,6
5064,11,214,178,392,True,3,6
5065,12,184,203,387,True,3,6
5066,13,182,227,409,True,3,6
5067,14,143,193,336,True,3,6
5068,15,137,145,282,True,3,6
5069,16,107,121,228,True,3,6
5070,17,112,108,220,True,3,6
5071,18,103,89,192,True,3,6
5072,19,71,71,142,True,3,6
5073,20,46,61,107,True,3,6
5074,21,49,51,100,True,3,6
5075,22,21,31,52,True,3,6
5076,23,23,22,45,True,3,6
5077,0,16,8,24,True,4,6
5078,1,12,15,27,True,4,6
5079,2,18,12,30,True,4,6
5080,3,13,20,33,True,4,6
5081,4,69,32,101,True,4,6
5082,5,115,78,193,True,4,6
5083,6,161,82,243,True,4,6
5084,7,141,94,235,True,4,6
5085,8,174,136,310,True,4,6
5086,9,183,130,313,True,4,6
5087,10,201,163,364,True,4,6
5088,11,184,168,352,True,4,6
5089,12,179,183,362,True,4,6
5090,13,200,213,413,True,4,6
5091,14,154,169,323,True,4,6
5092,15,147,146,293,True,4,6
5093,16,115,139,254,True,4,6
5094,17,105,109,214,True,4,6
5095,18,91,102,193,True,4,6
5096,19,81,74,155,True,4,6
5097,20,62,71,133,True,4,6
5098,21,45,61,106,True,4,6
5099,22,38,36,74,True,4,6
5100,23,26,29,55,True,4,6
5101,0,25,38,63,True,5,6
5102,1,7,41,48,True,5,6
5103,2,6,16,22,True,5,6
5104,3,12,9,21,True,5,6
5105,4,8,12,20,True,5,6
5106,5,38,22,60,True,5,6
5107,6,40,42,82,True,5,6
5108,7,44,31,75,True,5,6
5109,8,82,79,161,True,5,6
5110,9,125,72,197,True,5,6
5111,10,139,90,229,True,5,6
5112,11,126,140,266,True,5,6
5113,12,137,145,282,True,5,6
5114,13,106,135,241,True,5,6
5115,14,118,120,238,True,5,6
5116,15,114,99,213,True,5,6
5117,16,103,87,190,True,5,6
5118,17,96,90,186,True,5,6
5119,18,76,67,143,True,5,6
5120,19,56,66,122,True,5,6
5121,20,51,62,113,True,5,6
5122,21,47,50,97,True,5,6
5123,22,49,42,91,True,5,6
5124,23,14,36,50,True,5,6
5125,0,24,41,65,True,6,6
5126,1,35,45,80,True,6,6
5127,2,16,23,39,True,6,6
5128,3,10,14,24,True,6,6
5129,4,15,15,30,True,6,6
5130,5,24,19,43,True,6,6
5131,6,20,10,30,True,6,6
5132,7,40,28,68,True,6,6
5133,8,44,40,84,True,6,6
5134,9,110,69,179,True,6,6
5135,10,117,91,208,True,6,6
5136,11,116,106,222,True,6,6
5137,12,154,136,290,True,6,6
5138,13,127,154,281,True,6,6
5139,14,121,171,292,True,6,6
5140,15,131,130,261,True,6,6
5141,16,112,135,247,True,6,6
5142,17,121,110,231,True,6,6
5143,18,100,128,228,True,6,6
5144,19,79,90,169,True,6,6
5145,20,49,71,120,True,6,6
5146,21,33,49,82,True,6,6
5147,22,26,31,57,True,6,6
5148,23,17,27,44,True,6,6
5149,0,11,14,25,True,0,6
5150,1,2,15,17,True,0,6
5151,2,7,13,20,True,0,6
5152,3,10,13,23,True,0,6
5153,4,74,38,112,True,0,6
5154,5,109,83,192,True,0,6
5155,6,144,91,235,True,0,6
5156,7,137,104,241,True,0,6
5157,8,136,103,239,True,0,6
5158,9,184,117,301,True,0,6
5159,10,157,119,276,True,0,6
5160,11,160,135,295,True,0,6
5161,12,176,173,349,True,0,6
5162,13,178,224,402,True,0,6
5163,14,136,175,311,True,0,6
5164,15,130,143,273,True,0,6
5165,16,133,118,251,True,0,6
5166,17,106,115,221,True,0,6
5167,18,105,96,201,True,0,6
5168,19,72,101,173,True,0,6
5169,20,71,74,145,True,0,6
5170,21,47,50,97,True,0,6
5171,22,31,34,65,True,0,6
5172,23,18,24,42,True,0,6
5173,0,15,14,29,True,1,6
5174,1,6,9,15,True,1,6
5175,2,6,7,13,True,1,6
5176,3,12,6,18,True,1,6
5177,4,62,33,95,True,1,6
5178,5,103,79,182,True,1,6
5179,6,129,82,211,True,1,6
5180,7,144,107,251,True,1,6
5181,8,152,119,271,True,1,6
5182,9,151,122,273,True,1,6
5183,10,197,159,356,True,1,6
5184,11,172,148,320,True,1,6
5185,12,174,190,364,True,1,6
5186,13,198,201,399,True,1,6
5187,14,158,189,347,True,1,6
5188,15,149,163,312,True,1,6
5189,16,121,136,257,True,1,6
5190,17,109,118,227,True,1,6
5191,18,79,97,176,True,1,6
5192,19,83,91,174,True,1,6
5193,20,65,70,135,True,1,6
5194,21,40,43,83,True,1,6
5195,22,26,32,58,True,1,6
5196,23,18,18,36,True,1,6
5197,0,9,17,26,True,2,6
5198,1,8,20,28,True,2,6
5199,2,9,12,21,True,2,6
5200,3,13,12,25,True,2,6
5201,4,58,33,91,True,2,6
5202,5,113,96,209,True,2,6
5203,6,133,85,218,True,2,6
5204,7,123,104,227,True,2,6
5205,8,138,131,269,True,2,6
5206,9,142,136,278,True,2,6
5207,10,192,140,332,True,2,6
5208,11,159,153,312,True,2,6
5209,12,160,197,357,True,2,6
5210,13,168,201,369,True,2,6
5211,14,141,156,297,True,2,6
5212,15,131,127,258,True,2,6
5213,16,107,110,217,True,2,6
5214,17,105,105,210,True,2,6
5215,18,97,86,183,True,2,6
5216,19,94,97,191,True,2,6
5217,20,66,85,151,True,2,6
5218,21,59,51,110,True,2,6
5219,22,27,33,60,True,2,6
5220,23,26,25,51,True,2,6
5221,0,12,20,32,True,3,6
5222,1,12,11,23,True,3,6
5223,2,9,19,28,True,3,6
5224,3,15,15,30,True,3,6
5225,4,61,36,97,True,3,6
5226,5,99,77,176,True,3,6
5227,6,119,74,193,True,3,6
5228,7,134,89,223,True,3,6
5229,8,144,113,257,True,3,6
5230,9,164,115,279,True,3,6
5231,10,162,134,296,True,3,6
5232,11,164,139,303,True,3,6
5233,12,166,180,346,True,3,6
5234,13,150,185,335,True,3,6
5235,14,155,165,320,True,3,6
5236,15,129,147,276,True,3,6
5237,16,149,133,282,True,3,6
5238,17,110,116,226,True,3,6
5239,18,89,105,194,True,3,6
5240,19,67,71,138,True,3,6
5241,20,58,54,112,True,3,6
5242,21,35,57,92,True,3,6
5243,22,23,29,52,True,3,6
5244,23,24,25,49,True,3,6
5245,0,16,25,41,True,4,6
5246,1,5,25,30,True,4,6
5247,2,7,10,17,True,4,6
5248,3,12,11,23,True,4,6
5249,4,78,39,117,True,4,6
5250,5,114,87,201,True,4,6
5251,6,126,87,213,True,4,6
5252,7,123,105,228,True,4,6
5253,8,136,115,251,True,4,6
5254,9,161,120,281,True,4,6
5255,10,180,136,316,True,4,6
5256,11,168,170,338,True,4,6
5257,12,194,178,372,True,4,6
5258,13,179,216,395,True,4,6
5259,14,147,187,334,True,4,6
5260,15,121,142,263,True,4,6
5261,16,124,141,265,True,4,6
5262,17,96,96,192,True,4,6
5263,18,82,72,154,True,4,6
5264,19,111,91,202,True,4,6
5265,20,54,64,118,True,4,6
5266,21,53,70,123,True,4,6
5267,22,38,56,94,True,4,6
5268,23,24,36,60,True,4,6
5269,0,10,20,30,True,5,6
5270,1,10,34,44,True,5,6
5271,2,10,22,32,True,5,6
5272,3,15,13,28,True,5,6
5273,4,19,16,35,True,5,6
5274,5,32,19,51,True,5,6
5275,6,29,26,55,True,5,6
5276,7,55,48,103,True,5,6
5277,8,80,68,148,True,5,6
5278,9,127,87,214,True,5,6
5279,10,100,97,197,True,5,6
5280,11,118,119,237,True,5,6
5281,12,131,129,260,True,5,6
5282,13,83,128,211,True,5,6
5283,14,113,107,220,True,5,6
5284,15,110,99,209,True,5,6
5285,16,103,113,216,True,5,6
5286,17,77,94,171,True,5,6
5287,18,71,79,150,True,5,6
5288,19,64,71,135,True,5,6
5289,20,63,61,124,True,5,6
5290,21,37,51,88,True,5,6
5291,22,46,57,103,True,5,6
5292,23,27,32,59,True,5,6
5293,0,19,45,64,True,6,6
5294,1,14,43,57,True,6,6
5295,2,18,21,39,True,6,6
5296,3,12,23,35,True,6,6
5297,4,22,14,36,True,6,6
5298,5,18,22,40,True,6,6
5299,6,28,17,45,True,6,6
5300,7,29,29,58,True,6,6
5301,8,56,41,97,True,6,6
5302,9,80,83,163,True,6,6
5303,10,116,100,216,True,6,6
5304,11,110,113,223,True,6,6
5305,12,115,129,244,True,6,6
5306,13,114,110,224,True,6,6
5307,14,103,128,231,True,6,6
5308,15,281,114,395,True,6,6
5309,16,97,122,219,True,6,6
5310,17,112,148,260,True,6,6
5311,18,92,115,207,True,6,6
5312,19,120,116,236,True,6,6
5313,20,63,85,148,True,6,6
5314,21,38,52,90,True,6,6
5315,22,27,42,69,True,6,6
5316,23,16,24,40,True,6,6
5317,0,10,24,34,True,0,6
5318,1,11,9,20,True,0,6
5319,2,2,10,12,True,0,6
5320,3,12,11,23,True,0,6
5321,4,55,44,99,True,0,6
5322,5,106,87,193,True,0,6
5323,6,114,89,203,True,0,6
5324,7,142,95,237,True,0,6
5325,8,132,122,254,True,0,6
5326,9,162,139,301,True,0,6
5327,10,184,151,335,True,0,6
5328,11,172,150,322,True,0,6
5329,12,185,177,362,True,0,6
5330,13,162,213,375,True,0,6
5331,14,149,159,308,True,0,6
5332,15,138,136,274,True,0,6
5333,16,123,128,251,True,0,6
5334,17,105,94,199,True,0,6
5335,18,95,112,207,True,0,6
5336,19,89,92,181,True,0,6
5337,20,55,55,110,True,0,6
5338,21,40,44,84,True,0,6
5339,22,32,35,67,True,0,6
5340,23,21,22,43,True,0,6
5341,0,6,10,16,True,1,6
5342,1,11,25,36,True,1,6
5343,2,14,13,27,True,1,6
5344,3,15,13,28,True,1,6
5345,4,66,36,102,True,1,6
5346,5,107,91,198,True,1,6
5347,6,130,89,219,True,1,6
5348,7,154,91,245,True,1,6
5349,8,136,116,252,True,1,6
5350,9,151,149,300,True,1,6
5351,10,185,161,346,True,1,6
5352,11,172,165,337,True,1,6
5353,12,192,200,392,True,1,6
5354,13,176,205,381,True,1,6
5355,14,130,184,314,True,1,6
5356,15,145,148,293,True,1,6
5357,16,144,140,284,True,1,6
5358,17,109,103,212,True,1,6
5359,18,110,113,223,True,1,6
5360,19,106,90,196,True,1,6
5361,20,69,62,131,True,1,6
5362,21,49,47,96,True,1,6
5363,22,27,40,67,True,1,6
5364,23,14,25,39,True,1,6
5365,0,8,21,29,True,2,6
5366,1,11,14,25,True,2,6
5367,2,7,14,21,True,2,6
5368,3,16,9,25,True,2,6
5369,4,63,33,96,True,2,6
5370,5,110,71,181,True,2,6
5371,6,125,80,205,True,2,6
5372,7,134,98,232,True,2,6
5373,8,168,122,290,True,2,6
5374,9,179,116,295,True,2,6
5375,10,171,148,319,True,2,6
5376,11,184,156,340,True,2,6
5377,12,187,191,378,True,2,6
5378,13,175,229,404,True,2,6
5379,14,155,202,357,True,2,6
5380,15,157,150,307,True,2,6
5381,16,125,113,238,True,2,6
5382,17,109,98,207,True,2,6
5383,18,92,94,186,True,2,6
5384,19,84,72,156,True,2,6
5385,20,57,66,123,True,2,6
5386,21,43,54,97,True,2,6
5387,22,30,34,64,True,2,6
5388,23,20,22,42,True,2,6
5389,0,13,18,31,True,3,6
5390,1,7,10,17,True,3,6
5391,2,8,7,15,True,3,6
5392,3,9,6,15,True,3,6
5393,4,67,35,102,True,3,6
5394,5,114,75,189,True,3,6
5395,6,127,96,223,True,3,6
5396,7,145,102,247,True,3,6
5397,8,156,104,260,True,3,6
5398,9,157,145,302,True,3,6
5399,10,182,146,328,True,3,6
5400,11,158,168,326,True,3,6
5401,12,182,213,395,True,3,6
5402,13,161,213,374,True,3,6
5403,14,138,203,341,True,3,6
5404,15,147,146,293,True,3,6
5405,16,120,120,240,True,3,6
5406,17,121,135,256,True,3,6
5407,18,102,91,193,True,3,6
5408,19,76,100,176,True,3,6
5409,20,52,80,132,True,3,6
5410,21,41,56,97,True,3,6
5411,22,37,45,82,True,3,6
5412,23,19,25,44,True,3,6
5413,0,13,20,33,True,4,6
5414,1,11,23,34,True,4,6
5415,2,4,13,17,True,4,6
5416,3,12,11,23,True,4,6
5417,4,60,42,102,True,4,6
5418,5,112,64,176,True,4,6
5419,6,123,90,213,True,4,6
5420,7,147,76,223,True,4,6
5421,8,151,119,270,True,4,6
5422,9,188,139,327,True,4,6
5423,10,161,164,325,True,4,6
5424,11,196,186,382,True,4,6
5425,12,189,207,396,True,4,6
5426,13,166,233,399,True,4,6
5427,14,168,185,353,True,4,6
5428,15,141,165,306,True,4,6
5429,16,139,117,256,True,4,6
5430,17,108,110,218,True,4,6
5431,18,97,87,184,True,4,6
5432,19,85,97,182,True,4,6
5433,20,76,58,134,True,4,6
5434,21,40,50,90,True,4,6
5435,22,35,53,88,True,4,6
5436,23,25,36,61,True,4,6
5437,0,18,40,58,True,5,6
5438,1,18,42,60,True,5,6
5439,2,15,16,31,True,5,6
5440,3,7,9,16,True,5,6
5441,4,12,7,19,True,5,6
5442,5,30,33,63,True,5,6
5443,6,28,26,54,True,5,6
5444,7,73,38,111,True,5,6
5445,8,85,55,140,True,5,6
5446,9,127,81,208,True,5,6
5447,10,114,107,221,True,5,6
5448,11,150,134,284,True,5,6
5449,12,157,148,305,True,5,6
5450,13,129,165,294,True,5,6
5451,14,115,158,273,True,5,6
5452,15,109,124,233,True,5,6
5453,16,111,135,246,True,5,6
5454,17,105,90,195,True,5,6
5455,18,90,84,174,True,5,6
5456,19,56,73,129,True,5,6
5457,20,61,81,142,True,5,6
5458,21,35,55,90,True,5,6
5459,22,42,57,99,True,5,6
5460,23,31,33,64,True,5,6
5461,0,23,42,65,True,6,6
5462,1,24,48,72,True,6,6
5463,2,20,36,56,True,6,6
5464,3,15,20,35,True,6,6
5465,4,11,11,22,True,6,6
5466,5,17,17,34,True,6,6
5467,6,29,13,42,True,6,6
5468,7,34,38,72,True,6,6
5469,8,71,57,128,True,6,6
5470,9,105,73,178,True,6,6
5471,10,125,100,225,True,6,6
5472,11,144,132,276,True,6,6
5473,12,171,169,340,True,6,6
5474,13,168,200,368,True,6,6
5475,14,125,152,277,True,6,6
5476,15,162,172,334,True,6,6
5477,16,143,141,284,True,6,6
5478,17,130,120,250,True,6,6
5479,18,113,158,271,True,6,6
5480,19,97,88,185,True,6,6
5481,20,65,86,151,True,6,6
5482,21,38,59,97,True,6,6
5483,22,32,38,70,True,6,6
5484,23,21,26,47,True,6,6
5485,0,7,15,22,False,0,7
5486,1,5,13,18,False,0,7
5487,2,4,11,15,False,0,7
5488,3,16,7,23,False,0,7
5489,4,92,49,141,False,0,7
5490,5,136,116,252,False,0,7
5491,6,202,111,313,False,0,7
5492,7,230,125,355,False,0,7
5493,8,190,131,321,False,0,7
5494,9,210,173,383,False,0,7
5495,10,238,182,420,False,0,7
5496,11,229,218,447,False,0,7
5497,12,238,211,449,False,0,7
5498,13,216,280,496,False,0,7
5499,14,179,243,422,False,0,7
5500,15,161,161,322,False,0,7
5501,16,137,130,267,False,0,7
5502,17,109,135,244,False,0,7
5503,18,108,103,211,False,0,7
5504,19,85,75,160,False,0,7
5505,20,83,81,164,False,0,7
5506,21,37,48,85,False,0,7
5507,22,23,36,59,False,0,7
5508,23,11,14,25,False,0,7
5509,0,4,11,15,False,1,7
5510,1,1,9,10,False,1,7
5511,2,7,5,12,False,1,7
5512,3,15,18,33,False,1,7
5513,4,90,47,137,False,1,7
5514,5,137,106,243,False,1,7
5515,6,195,108,303,False,1,7
5516,7,157,106,263,False,1,7
5517,8,187,129,316,False,1,7
5518,9,219,161,380,False,1,7
5519,10,199,182,381,False,1,7
5520,11,198,191,389,False,1,7
5521,12,210,214,424,False,1,7
5522,13,193,301,494,False,1,7
5523,14,172,216,388,False,1,7
5524,15,177,177,354,False,1,7
5525,16,137,129,266,False,1,7
5526,17,123,128,251,False,1,7
5527,18,105,121,226,False,1,7
5528,19,104,95,199,False,1,7
5529,20,69,74,143,False,1,7
5530,21,49,50,99,False,1,7
5531,22,29,39,68,False,1,7
5532,23,15,34,49,False,1,7
5533,0,7,18,25,False,2,7
5534,1,8,16,24,False,2,7
5535,2,6,9,15,False,2,7
5536,3,15,12,27,False,2,7
5537,4,89,47,136,False,2,7
5538,5,131,101,232,False,2,7
5539,6,184,106,290,False,2,7
5540,7,186,127,313,False,2,7
5541,8,188,140,328,False,2,7
5542,9,187,134,321,False,2,7
5543,10,204,169,373,False,2,7
5544,11,217,196,413,False,2,7
5545,12,163,217,380,False,2,7
5546,13,190,269,459,False,2,7
5547,14,165,225,390,False,2,7
5548,15,153,184,337,False,2,7
5549,16,147,136,283,False,2,7
5550,17,116,122,238,False,2,7
5551,18,106,101,207,False,2,7
5552,19,96,97,193,False,2,7
5553,20,69,96,165,False,2,7
5554,21,62,46,108,False,2,7
5555,22,11,19,30,False,2,7
5556,23,12,26,38,False,2,7
5557,0,6,15,21,False,3,7
5558,1,5,11,16,False,3,7
5559,2,6,14,20,False,3,7
5560,3,9,9,18,False,3,7
5561,4,102,42,144,False,3,7
5562,5,145,106,251,False,3,7
5563,6,196,108,304,False,3,7
5564,7,181,117,298,False,3,7
5565,8,180,114,294,False,3,7
5566,9,199,139,338,False,3,7
5567,10,181,146,327,False,3,7
5568,11,190,187,377,False,3,7
5569,12,206,207,413,False,3,7
5570,13,211,253,464,False,3,7
5571,14,189,231,420,False,3,7
5572,15,184,159,343,False,3,7
5573,16,159,159,318,False,3,7
5574,17,124,128,252,False,3,7
5575,18,127,131,258,False,3,7
5576,19,90,95,185,False,3,7
5577,20,64,83,147,False,3,7
5578,21,39,50,89,False,3,7
5579,22,20,27,47,False,3,7
5580,23,20,21,41,False,3,7
5581,0,13,73,86,False,4,7
5582,1,11,25,36,False,4,7
5583,2,4,11,15,False,4,7
5584,3,12,15,27,False,4,7
5585,4,86,42,128,False,4,7
5586,5,139,106,245,False,4,7
5587,6,208,115,323,False,4,7
5588,7,200,144,344,False,4,7
5589,8,191,164,355,False,4,7
5590,9,215,158,373,False,4,7
5591,10,214,173,387,False,4,7
5592,11,203,204,407,False,4,7
5593,12,203,224,427,False,4,7
5594,13,210,268,478,False,4,7
5595,14,168,221,389,False,4,7
5596,15,145,172,317,False,4,7
5597,16,137,123,260,False,4,7
5598,17,139,120,259,False,4,7
5599,18,100,115,215,False,4,7
5600,19,70,79,149,False,4,7
5601,20,64,67,131,False,4,7
5602,21,41,51,92,False,4,7
5603,22,31,37,68,False,4,7
5604,23,16,38,54,False,4,7
5605,0,19,30,49,False,5,7
5606,1,15,33,48,False,5,7
5607,2,15,15,30,False,5,7
5608,3,11,9,20,False,5,7
5609,4,19,20,39,False,5,7
5610,5,34,23,57,False,5,7
5611,6,40,21,61,False,5,7
5612,7,56,47,103,False,5,7
5613,8,99,77,176,False,5,7
5614,9,132,91,223,False,5,7
5615,10,157,105,262,False,5,7
5616,11,156,137,293,False,5,7
5617,12,135,169,304,False,5,7
5618,13,137,149,286,False,5,7
5619,14,125,123,248,False,5,7
5620,15,116,134,250,False,5,7
5621,16,127,125,252,False,5,7
5622,17,109,116,225,False,5,7
5623,18,88,110,198,False,5,7
5624,19,72,89,161,False,5,7
5625,20,70,75,145,False,5,7
5626,21,55,90,145,False,5,7
5627,22,47,55,102,False,5,7
5628,23,34,51,85,False,5,7
5629,0,21,42,63,True,6,7
5630,1,30,48,78,True,6,7
5631,2,22,27,49,True,6,7
5632,3,10,25,35,True,6,7
5633,4,16,15,31,True,6,7
5634,5,19,14,33,True,6,7
5635,6,31,11,42,True,6,7
5636,7,31,27,58,True,6,7
5637,8,87,43,130,True,6,7
5638,9,111,81,192,True,6,7
5639,10,132,119,251,True,6,7
5640,11,202,138,340,True,6,7
5641,12,153,162,315,True,6,7
5642,13,145,210,355,True,6,7
5643,14,158,195,353,True,6,7
5644,15,137,191,328,True,6,7
5645,16,125,130,255,True,6,7
5646,17,128,123,251,True,6,7
5647,18,161,146,307,True,6,7
5648,19,112,128,240,True,6,7
5649,20,67,67,134,True,6,7
5650,21,42,67,109,True,6,7
5651,22,24,31,55,True,6,7
5652,23,14,36,50,True,6,7
5653,0,6,13,19,False,0,7
5654,1,7,9,16,False,0,7
5655,2,5,13,18,False,0,7
5656,3,18,11,29,False,0,7
5657,4,121,60,181,False,0,7
5658,5,221,139,360,False,0,7
5659,6,314,148,462,False,0,7
5660,7,232,149,381,False,0,7
5661,8,243,169,412,False,0,7
5662,9,230,165,395,False,0,7
5663,10,220,184,404,False,0,7
5664,11,205,213,418,False,0,7
5665,12,215,242,457,False,0,7
5666,13,216,334,550,False,0,7
5667,14,198,284,482,False,0,7
5668,15,185,195,380,False,0,7
5669,16,164,134,298,False,0,7
5670,17,130,143,273,False,0,7
5671,18,120,121,241,False,0,7
5672,19,86,95,181,False,0,7
5673,20,64,137,201,False,0,7
5674,21,32,108,140,False,0,7
5675,22,11,25,36,False,0,7
5676,23,18,25,43,False,0,7
5677,0,8,13,21,False,1,7
5678,1,3,8,11,False,1,7
5679,2,1,9,10,False,1,7
5680,3,17,21,38,False,1,7
5681,4,129,61,190,False,1,7
5682,5,210,135,345,False,1,7
5683,6,308,170,478,False,1,7
5684,7,247,161,408,False,1,7
5685,8,242,175,417,False,1,7
5686,9,214,165,379,False,1,7
5687,10,233,182,415,False,1,7
5688,11,225,202,427,False,1,7
5689,12,244,257,501,False,1,7
5690,13,271,343,614,False,1,7
5691,14,228,250,478,False,1,7
5692,15,188,189,377,False,1,7
5693,16,166,161,327,False,1,7
5694,17,149,139,288,False,1,7
5695,18,112,125,237,False,1,7
5696,19,100,103,203,False,1,7
5697,20,67,104,171,False,1,7
5698,21,40,58,98,False,1,7
5699,22,24,39,63,False,1,7
5700,23,15,18,33,False,1,7
5701,0,14,25,39,False,2,7
5702,1,9,24,33,False,2,7
5703,2,5,9,14,False,2,7
5704,3,22,13,35,False,2,7
5705,4,113,76,189,False,2,7
5706,5,228,124,352,False,2,7
5707,6,277,148,425,False,2,7
5708,7,233,156,389,False,2,7
5709,8,219,174,393,False,2,7
5710,9,221,171,392,False,2,7
5711,10,234,209,443,False,2,7
5712,11,222,200,422,False,2,7
5713,12,246,261,507,False,2,7
5714,13,260,349,609,False,2,7
5715,14,191,258,449,False,2,7
5716,15,159,187,346,False,2,7
5717,16,153,170,323,False,2,7
5718,17,147,159,306,False,2,7
5719,18,103,132,235,False,2,7
5720,19,87,99,186,False,2,7
5721,20,63,94,157,False,2,7
5722,21,43,53,96,False,2,7
5723,22,21,25,46,False,2,7
5724,23,13,17,30,False,2,7
5725,0,12,22,34,False,3,7
5726,1,9,13,22,False,3,7
5727,2,7,12,19,False,3,7
5728,3,14,7,21,False,3,7
5729,4,110,55,165,False,3,7
5730,5,205,134,339,False,3,7
5731,6,323,152,475,False,3,7
5732,7,221,150,371,False,3,7
5733,8,239,183,422,False,3,7
5734,9,237,161,398,False,3,7
5735,10,235,174,409,False,3,7
5736,11,238,213,451,False,3,7
5737,12,227,246,473,False,3,7
5738,13,278,373,651,False,3,7
5739,14,240,271,511,False,3,7
5740,15,198,207,405,False,3,7
5741,16,159,185,344,False,3,7
5742,17,164,143,307,False,3,7
5743,18,141,131,272,False,3,7
5744,19,116,117,233,False,3,7
5745,20,79,93,172,False,3,7
5746,21,55,56,111,False,3,7
5747,22,23,38,61,False,3,7
5748,23,23,21,44,False,3,7
5749,0,19,22,41,False,4,7
5750,1,9,16,25,False,4,7
5751,2,10,16,26,False,4,7
5752,3,15,11,26,False,4,7
5753,4,111,71,182,False,4,7
5754,5,200,122,322,False,4,7
5755,6,305,151,456,False,4,7
5756,7,260,161,421,False,4,7
5757,8,231,177,408,False,4,7
5758,9,241,204,445,False,4,7
5759,10,240,204,444,False,4,7
5760,11,263,253,516,False,4,7
5761,12,286,290,576,False,4,7
5762,13,346,392,738,False,4,7
5763,14,223,325,548,False,4,7
5764,15,193,221,414,False,4,7
5765,16,160,159,319,False,4,7
5766,17,157,157,314,False,4,7
5767,18,130,132,262,False,4,7
5768,19,84,112,196,False,4,7
5769,20,77,80,157,False,4,7
5770,21,49,73,122,False,4,7
5771,22,28,48,76,False,4,7
5772,23,30,54,84,False,4,7
5773,0,23,28,51,False,5,7
5774,1,19,38,57,False,5,7
5775,2,8,12,20,False,5,7
5776,3,14,16,30,False,5,7
5777,4,25,17,42,False,5,7
5778,5,42,27,69,False,5,7
5779,6,45,32,77,False,5,7
5780,7,75,64,139,False,5,7
5781,8,149,85,234,False,5,7
5782,9,180,127,307,False,5,7
5783,10,198,165,363,False,5,7
5784,11,218,178,396,False,5,7
5785,12,213,180,393,False,5,7
5786,13,185,196,381,False,5,7
5787,14,161,196,357,False,5,7
5788,15,154,183,337,False,5,7
5789,16,141,164,305,False,5,7
5790,17,124,136,260,False,5,7
5791,18,116,109,225,False,5,7
5792,19,98,100,198,False,5,7
5793,20,58,91,149,False,5,7
5794,21,54,90,144,False,5,7
5795,22,39,62,101,False,5,7
5796,23,38,54,92,False,5,7
5797,0,29,44,73,True,6,7
5798,1,31,45,76,True,6,7
5799,2,21,35,56,True,6,7
5800,3,10,23,33,True,6,7
5801,4,17,12,29,True,6,7
5802,5,15,18,33,True,6,7
5803,6,39,19,58,True,6,7
5804,7,44,54,98,True,6,7
5805,8,100,73,173,True,6,7
5806,9,116,102,218,True,6,7
5807,10,137,130,267,True,6,7
5808,11,145,130,275,True,6,7
5809,12,204,179,383,True,6,7
5810,13,179,173,352,True,6,7
5811,14,171,205,376,True,6,7
5812,15,161,174,335,True,6,7
5813,16,178,157,335,True,6,7
5814,17,191,203,394,True,6,7
5815,18,171,201,372,True,6,7
5816,19,102,120,222,True,6,7
5817,20,75,94,169,True,6,7
5818,21,40,42,82,True,6,7
5819,22,27,30,57,True,6,7
5820,23,17,27,44,True,6,7
5821,0,5,15,20,False,0,7
5822,1,3,10,13,False,0,7
5823,2,3,10,13,False,0,7
5824,3,17,15,32,False,0,7
5825,4,120,58,178,False,0,7
5826,5,270,176,446,False,0,7
5827,6,390,194,584,False,0,7
5828,7,272,172,444,False,0,7
5829,8,258,161,419,False,0,7
5830,9,249,206,455,False,0,7
5831,10,255,223,478,False,0,7
5832,11,225,206,431,False,0,7
5833,12,227,336,563,False,0,7
5834,13,291,360,651,False,0,7
5835,14,264,325,589,False,0,7
5836,15,209,202,411,False,0,7
5837,16,171,179,350,False,0,7
5838,17,160,157,317,False,0,7
5839,18,158,155,313,False,0,7
5840,19,128,149,277,False,0,7
5841,20,64,93,157,False,0,7
5842,21,47,57,104,False,0,7
5843,22,34,44,78,False,0,7
5844,23,20,38,58,False,0,7
5845,0,16,26,42,False,1,7
5846,1,8,19,27,False,1,7
5847,2,7,7,14,False,1,7
5848,3,18,11,29,False,1,7
5849,4,118,73,191,False,1,7
5850,5,269,160,429,False,1,7
5851,6,372,192,564,False,1,7
5852,7,265,181,446,False,1,7
5853,8,227,200,427,False,1,7
5854,9,240,195,435,False,1,7
5855,10,244,217,461,False,1,7
5856,11,266,215,481,False,1,7
5857,12,238,286,524,False,1,7
5858,13,265,367,632,False,1,7
5859,14,235,288,523,False,1,7
5860,15,201,198,399,False,1,7
5861,16,200,210,410,False,1,7
5862,17,156,184,340,False,1,7
5863,18,133,155,288,False,1,7
5864,19,121,144,265,False,1,7
5865,20,81,94,175,False,1,7
5866,21,59,68,127,False,1,7
5867,22,41,51,92,False,1,7
5868,23,18,53,71,False,1,7
5869,0,14,39,53,False,2,7
5870,1,13,30,43,False,2,7
5871,2,6,12,18,False,2,7
5872,3,15,11,26,False,2,7
5873,4,120,62,182,False,2,7
5874,5,237,149,386,False,2,7
5875,6,355,162,517,False,2,7
5876,7,246,152,398,False,2,7
5877,8,236,159,395,False,2,7
5878,9,239,177,416,False,2,7
5879,10,253,194,447,False,2,7
5880,11,233,215,448,False,2,7
5881,12,220,248,468,False,2,7
5882,13,212,331,543,False,2,7
5883,14,227,295,522,False,2,7
5884,15,184,171,355,False,2,7
5885,16,171,169,340,False,2,7
5886,17,159,151,310,False,2,7
5887,18,135,112,247,False,2,7
5888,19,90,106,196,False,2,7
5889,20,72,82,154,False,2,7
5890,21,29,57,86,False,2,7
5891,22,20,45,65,False,2,7
5892,23,23,43,66,False,2,7
5893,0,19,38,57,False,3,7
5894,1,6,26,32,False,3,7
5895,2,10,17,27,False,3,7
5896,3,23,18,41,False,3,7
5897,4,134,58,192,False,3,7
5898,5,229,147,376,False,3,7
5899,6,343,173,516,False,3,7
5900,7,246,170,416,False,3,7
5901,8,246,174,420,False,3,7
5902,9,225,187,412,False,3,7
5903,10,212,184,396,False,3,7
5904,11,231,187,418,False,3,7
5905,12,241,271,512,False,3,7
5906,13,262,340,602,False,3,7
5907,14,226,282,508,False,3,7
5908,15,178,225,403,False,3,7
5909,16,170,154,324,False,3,7
5910,17,153,166,319,False,3,7
5911,18,137,164,301,False,3,7
5912,19,102,157,259,False,3,7
5913,20,84,221,305,False,3,7
5914,21,43,229,272,False,3,7
5915,22,28,60,88,False,3,7
5916,23,19,47,66,False,3,7
5917,0,13,41,54,False,4,7
5918,1,15,25,40,False,4,7
5919,2,6,22,28,False,4,7
5920,3,20,14,34,False,4,7
5921,4,125,70,195,False,4,7
5922,5,221,143,364,False,4,7
5923,6,363,179,542,False,4,7
5924,7,302,161,463,False,4,7
5925,8,266,175,441,False,4,7
5926,9,237,186,423,False,4,7
5927,10,240,207,447,False,4,7
5928,11,269,225,494,False,4,7
5929,12,244,314,558,False,4,7
5930,13,270,363,633,False,4,7
5931,14,225,283,508,False,4,7
5932,15,184,191,375,False,4,7
5933,16,163,154,317,False,4,7
5934,17,150,142,292,False,4,7
5935,18,139,138,277,False,4,7
5936,19,103,109,212,False,4,7
5937,20,75,91,166,False,4,7
5938,21,63,79,142,False,4,7
5939,22,54,61,115,False,4,7
5940,23,38,68,106,False,4,7
5941,0,27,38,65,False,5,7
5942,1,28,52,80,False,5,7
5943,2,9,21,30,False,5,7
5944,3,12,13,25,False,5,7
5945,4,19,27,46,False,5,7
5946,5,37,31,68,False,5,7
5947,6,40,31,71,False,5,7
5948,7,80,58,138,False,5,7
5949,8,116,92,208,False,5,7
5950,9,143,133,276,False,5,7
5951,10,189,140,329,False,5,7
5952,11,192,142,334,False,5,7
5953,12,187,194,381,False,5,7
5954,13,144,168,312,False,5,7
5955,14,161,170,331,False,5,7
5956,15,157,165,322,False,5,7
5957,16,138,140,278,False,5,7
5958,17,106,123,229,False,5,7
5959,18,95,114,209,False,5,7
5960,19,73,98,171,False,5,7
5961,20,56,68,124,False,5,7
5962,21,52,79,131,False,5,7
5963,22,63,62,125,False,5,7
5964,23,41,63,104,False,5,7
5965,0,33,44,77,True,6,7
5966,1,27,49,76,True,6,7
5967,2,22,36,58,True,6,7
5968,3,16,32,48,True,6,7
5969,4,21,20,41,True,6,7
5970,5,16,12,28,True,6,7
5971,6,37,22,59,True,6,7
5972,7,45,42,87,True,6,7
5973,8,94,58,152,True,6,7
5974,9,110,102,212,True,6,7
5975,10,141,130,271,True,6,7
5976,11,143,185,328,True,6,7
5977,12,181,181,362,True,6,7
5978,13,164,182,346,True,6,7
5979,14,176,201,377,True,6,7
5980,15,187,257,444,True,6,7
5981,16,191,162,353,True,6,7
5982,17,166,156,322,True,6,7
5983,18,234,186,420,True,6,7
5984,19,118,135,253,True,6,7
5985,20,86,93,179,True,6,7
5986,21,46,59,105,True,6,7
5987,22,25,27,52,True,6,7
5988,23,15,15,30,True,6,7
5989,0,5,17,22,False,0,7
5990,1,8,8,16,False,0,7
5991,2,9,6,15,False,0,7
5992,3,18,17,35,False,0,7
5993,4,114,70,184,False,0,7
5994,5,259,153,412,False,0,7
5995,6,377,225,602,False,0,7
5996,7,280,170,450,False,0,7
5997,8,221,201,422,False,0,7
5998,9,240,192,432,False,0,7
5999,10,255,225,480,False,0,7
6000,11,250,234,484,False,0,7
6001,12,232,284,516,False,0,7
6002,13,256,351,607,False,0,7
6003,14,253,284,537,False,0,7
6004,15,191,165,356,False,0,7
6005,16,169,199,368,False,0,7
6006,17,178,138,316,False,0,7
6007,18,131,128,259,False,0,7
6008,19,102,110,212,False,0,7
6009,20,59,84,143,False,0,7
6010,21,34,43,77,False,0,7
6011,22,15,30,45,False,0,7
6012,23,6,17,23,False,0,7
6013,0,7,10,17,False,1,7
6014,1,5,11,16,False,1,7
6015,2,4,9,13,False,1,7
6016,3,21,13,34,False,1,7
6017,4,116,68,184,False,1,7
6018,5,252,173,425,False,1,7
6019,6,369,219,588,False,1,7
6020,7,245,192,437,False,1,7
6021,8,276,197,473,False,1,7
6022,9,234,204,438,False,1,7
6023,10,218,206,424,False,1,7
6024,11,250,217,467,False,1,7
6025,12,231,294,525,False,1,7
6026,13,252,316,568,False,1,7
6027,14,213,265,478,False,1,7
6028,15,193,208,401,False,1,7
6029,16,173,160,333,False,1,7
6030,17,142,145,287,False,1,7
6031,18,135,136,271,False,1,7
6032,19,99,123,222,False,1,7
6033,20,65,82,147,False,1,7
6034,21,27,48,75,False,1,7
6035,22,17,24,41,False,1,7
6036,23,8,20,28,False,1,7
6037,0,7,18,25,False,2,7
6038,1,9,13,22,False,2,7
6039,2,5,10,15,False,2,7
6040,3,20,10,30,False,2,7
6041,4,131,66,197,False,2,7
6042,5,244,169,413,False,2,7
6043,6,377,193,570,False,2,7
6044,7,288,159,447,False,2,7
6045,8,250,191,441,False,2,7
6046,9,243,221,464,False,2,7
6047,10,233,198,431,False,2,7
6048,11,218,227,445,False,2,7
6049,12,256,274,530,False,2,7
6050,13,294,390,684,False,2,7
6051,14,239,291,530,False,2,7
6052,15,201,184,385,False,2,7
6053,16,182,181,363,False,2,7
6054,17,134,151,285,False,2,7
6055,18,132,139,271,False,2,7
6056,19,113,129,242,False,2,7
6057,20,80,88,168,False,2,7
6058,21,32,51,83,False,2,7
6059,22,24,24,48,False,2,7
6060,23,15,25,40,False,2,7
6061,0,7,13,20,False,3,7
6062,1,5,13,18,False,3,7
6063,2,5,11,16,False,3,7
6064,3,11,12,23,False,3,7
6065,4,119,65,184,False,3,7
6066,5,238,164,402,False,3,7
6067,6,373,203,576,False,3,7
6068,7,272,152,424,False,3,7
6069,8,242,194,436,False,3,7
6070,9,247,167,414,False,3,7
6071,10,237,215,452,False,3,7
6072,11,227,238,465,False,3,7
6073,12,236,262,498,False,3,7
6074,13,273,356,629,False,3,7
6075,14,224,343,567,False,3,7
6076,15,200,215,415,False,3,7
6077,16,205,172,377,False,3,7
6078,17,162,168,330,False,3,7
6079,18,141,146,287,False,3,7
6080,19,107,149,256,False,3,7
6081,20,72,99,171,False,3,7
6082,21,32,43,75,False,3,7
6083,22,26,35,61,False,3,7
6084,23,14,53,67,False,3,7
6085,0,10,44,54,False,4,7
6086,1,12,18,30,False,4,7
6087,2,9,16,25,False,4,7
6088,3,17,12,29,False,4,7
6089,4,136,59,195,False,4,7
6090,5,264,162,426,False,4,7
6091,6,413,218,631,False,4,7
6092,7,324,189,513,False,4,7
6093,8,261,192,453,False,4,7
6094,9,273,199,472,False,4,7
6095,10,255,230,485,False,4,7
6096,11,255,279,534,False,4,7
6097,12,281,328,609,False,4,7
6098,13,310,409,719,False,4,7
6099,14,251,273,524,False,4,7
6100,15,187,194,381,False,4,7
6101,16,168,162,330,False,4,7
6102,17,125,137,262,False,4,7
6103,18,133,107,240,False,4,7
6104,19,100,105,205,False,4,7
6105,20,78,70,148,False,4,7
6106,21,55,69,124,False,4,7
6107,22,36,52,88,False,4,7
6108,23,29,44,73,False,4,7
6109,0,18,43,61,False,5,7
6110,1,20,36,56,False,5,7
6111,2,8,23,31,False,5,7
6112,3,10,13,23,False,5,7
6113,4,21,20,41,False,5,7
6114,5,37,30,67,False,5,7
6115,6,29,25,54,False,5,7
6116,7,61,55,116,False,5,7
6117,8,109,91,200,False,5,7
6118,9,163,118,281,False,5,7
6119,10,185,134,319,False,5,7
6120,11,185,170,355,False,5,7
6121,12,161,186,347,False,5,7
6122,13,144,197,341,False,5,7
6123,14,141,138,279,False,5,7
6124,15,129,148,277,False,5,7
6125,16,163,142,305,False,5,7
6126,17,135,134,269,False,5,7
6127,18,102,114,216,False,5,7
6128,19,67,98,165,False,5,7
6129,20,50,68,118,False,5,7
6130,21,51,68,119,False,5,7
6131,22,43,68,111,False,5,7
6132,23,37,58,95,False,5,7
6133,0,35,55,90,True,6,7
6134,1,32,67,99,True,6,7
6135,2,18,49,67,True,6,7
6136,3,12,24,36,True,6,7
6137,4,10,12,22,True,6,7
6138,5,20,15,35,True,6,7
6139,6,26,13,39,True,6,7
6140,7,35,36,71,True,6,7
6141,8,97,73,170,True,6,7
6142,9,142,93,235,True,6,7
6143,10,135,131,266,True,6,7
6144,11,157,160,317,True,6,7
6145,12,176,182,358,True,6,7
6146,13,144,193,337,True,6,7
6147,14,167,215,382,True,6,7
6148,15,168,171,339,True,6,7
6149,16,161,171,332,True,6,7
6150,17,180,144,324,True,6,7
6151,18,152,195,347,True,6,7
6152,19,99,117,216,True,6,7
6153,20,55,88,143,True,6,7
6154,21,44,43,87,True,6,7
6155,22,23,20,43,True,6,7
6156,23,11,17,28,True,6,7
6157,0,6,15,21,False,0,7
6158,1,5,8,13,False,0,7
6159,2,7,10,17,False,0,7
6160,3,19,15,34,False,0,7
6161,4,142,70,212,False,0,7
6162,5,283,173,456,False,0,7
6163,6,373,218,591,False,0,7
6164,7,308,187,495,False,0,7
6165,8,262,203,465,False,0,7
6166,9,244,198,442,False,0,7
6167,10,219,185,404,False,0,7
6168,11,224,236,460,False,0,7
6169,12,218,262,480,False,0,7
6170,13,268,370,638,False,0,7
6171,14,232,312,544,False,0,7
6172,15,180,183,363,False,0,7
6173,16,180,182,362,False,0,7
6174,17,130,157,287,False,0,7
6175,18,139,158,297,False,0,7
6176,19,97,143,240,False,0,7
6177,20,58,77,135,False,0,7
6178,21,23,27,50,False,0,7
6179,22,19,19,38,False,0,7
6180,23,14,15,29,False,0,7
6181,0,11,8,19,False,1,7
6182,1,8,11,19,False,1,7
6183,2,2,10,12,False,1,7
6184,3,19,12,31,False,1,7
6185,4,127,75,202,False,1,7
6186,5,261,194,455,False,1,7
6187,6,372,219,591,False,1,7
6188,7,301,182,483,False,1,7
6189,8,259,197,456,False,1,7
6190,9,233,189,422,False,1,7
6191,10,239,214,453,False,1,7
6192,11,256,248,504,False,1,7
6193,12,207,295,502,False,1,7
6194,13,289,348,637,False,1,7
6195,14,227,302,529,False,1,7
6196,15,189,213,402,False,1,7
6197,16,191,174,365,False,1,7
6198,17,172,182,354,False,1,7
6199,18,124,141,265,False,1,7
6200,19,105,107,212,False,1,7
6201,20,73,93,166,False,1,7
6202,21,27,30,57,False,1,7
6203,22,18,23,41,False,1,7
6204,23,10,12,22,False,1,7
6205,0,8,19,27,False,2,7
6206,1,7,16,23,False,2,7
6207,2,7,10,17,False,2,7
6208,3,15,17,32,False,2,7
6209,4,134,64,198,False,2,7
6210,5,245,159,404,False,2,7
6211,6,402,208,610,False,2,7
6212,7,263,180,443,False,2,7
6213,8,226,179,405,False,2,7
6214,9,246,198,444,False,2,7
6215,10,233,224,457,False,2,7
6216,11,268,226,494,False,2,7
6217,12,249,252,501,False,2,7
6218,13,264,345,609,False,2,7
6219,14,271,285,556,False,2,7
6220,15,212,214,426,False,2,7
6221,16,191,155,346,False,2,7
6222,17,158,159,317,False,2,7
6223,18,113,150,263,False,2,7
6224,19,109,144,253,False,2,7
6225,20,63,131,194,False,2,7
6226,21,36,61,97,False,2,7
6227,22,18,32,50,False,2,7
6228,23,11,14,25,False,2,7
6229,0,5,18,23,False,3,8
6230,1,8,12,20,False,3,8
6231,2,3,10,13,False,3,8
6232,3,19,11,30,False,3,8
6233,4,131,60,191,False,3,8
6234,5,275,170,445,False,3,8
6235,6,438,254,692,False,3,8
6236,7,300,184,484,False,3,8
6237,8,310,238,548,False,3,8
6238,9,239,193,432,False,3,8
6239,10,209,208,417,False,3,8
6240,11,186,205,391,False,3,8
6241,12,224,300,524,False,3,8
6242,13,307,471,778,False,3,8
6243,14,251,317,568,False,3,8
6244,15,208,195,403,False,3,8
6245,16,199,185,384,False,3,8
6246,17,173,162,335,False,3,8
6247,18,136,161,297,False,3,8
6248,19,102,117,219,False,3,8
6249,20,73,92,165,False,3,8
6250,21,50,59,109,False,3,8
6251,22,24,42,66,False,3,8
6252,23,15,29,44,False,3,8
6253,0,10,30,40,False,4,8
6254,1,9,15,24,False,4,8
6255,2,4,11,15,False,4,8
6256,3,11,9,20,False,4,8
6257,4,140,72,212,False,4,8
6258,5,250,150,400,False,4,8
6259,6,411,202,613,False,4,8
6260,7,271,187,458,False,4,8
6261,8,228,178,406,False,4,8
6262,9,233,186,419,False,4,8
6263,10,287,226,513,False,4,8
6264,11,237,243,480,False,4,8
6265,12,277,329,606,False,4,8
6266,13,293,364,657,False,4,8
6267,14,222,298,520,False,4,8
6268,15,199,222,421,False,4,8
6269,16,161,150,311,False,4,8
6270,17,139,132,271,False,4,8
6271,18,119,132,251,False,4,8
6272,19,80,110,190,False,4,8
6273,20,62,88,150,False,4,8
6274,21,43,65,108,False,4,8
6275,22,35,48,83,False,4,8
6276,23,29,37,66,False,4,8
6277,0,20,44,64,False,5,8
6278,1,19,38,57,False,5,8
6279,2,19,30,49,False,5,8
6280,3,10,16,26,False,5,8
6281,4,28,21,49,False,5,8
6282,5,36,31,67,False,5,8
6283,6,38,39,77,False,5,8
6284,7,78,54,132,False,5,8
6285,8,133,78,211,False,5,8
6286,9,129,116,245,False,5,8
6287,10,165,127,292,False,5,8
6288,11,168,146,314,False,5,8
6289,12,169,176,345,False,5,8
6290,13,155,191,346,False,5,8
6291,14,127,166,293,False,5,8
6292,15,151,152,303,False,5,8
6293,16,141,164,305,False,5,8
6294,17,97,122,219,False,5,8
6295,18,92,95,187,False,5,8
6296,19,64,79,143,False,5,8
6297,20,48,75,123,False,5,8
6298,21,57,68,125,False,5,8
6299,22,47,64,111,False,5,8
6300,23,44,55,99,False,5,8
6301,0,28,36,64,True,6,8
6302,1,27,57,84,True,6,8
6303,2,12,36,48,True,6,8
6304,3,11,17,28,True,6,8
6305,4,25,20,45,True,6,8
6306,5,20,22,42,True,6,8
6307,6,39,27,66,True,6,8
6308,7,50,47,97,True,6,8
6309,8,95,58,153,True,6,8
6310,9,111,77,188,True,6,8
6311,10,153,124,277,True,6,8
6312,11,162,184,346,True,6,8
6313,12,173,201,374,True,6,8
6314,13,194,194,388,True,6,8
6315,14,143,222,365,True,6,8
6316,15,157,193,350,True,6,8
6317,16,168,193,361,True,6,8
6318,17,165,169,334,True,6,8
6319,18,123,193,316,True,6,8
6320,19,98,120,218,True,6,8
6321,20,56,78,134,True,6,8
6322,21,44,51,95,True,6,8
6323,22,23,27,50,True,6,8
6324,23,18,18,36,True,6,8
6325,0,5,14,19,False,0,8
6326,1,10,13,23,False,0,8
6327,2,7,12,19,False,0,8
6328,3,23,9,32,False,0,8
6329,4,131,72,203,False,0,8
6330,5,249,150,399,False,0,8
6331,6,381,219,600,False,0,8
6332,7,266,161,427,False,0,8
6333,8,263,178,441,False,0,8
6334,9,210,211,421,False,0,8
6335,10,221,210,431,False,0,8
6336,11,242,234,476,False,0,8
6337,12,231,273,504,False,0,8
6338,13,252,333,585,False,0,8
6339,14,251,319,570,False,0,8
6340,15,213,190,403,False,0,8
6341,16,168,146,314,False,0,8
6342,17,137,161,298,False,0,8
6343,18,129,139,268,False,0,8
6344,19,121,152,273,False,0,8
6345,20,62,95,157,False,0,8
6346,21,38,38,76,False,0,8
6347,22,12,23,35,False,0,8
6348,23,15,7,22,False,0,8
6349,0,5,13,18,False,1,8
6350,1,7,8,15,False,1,8
6351,2,4,8,12,False,1,8
6352,3,18,12,30,False,1,8
6353,4,119,72,191,False,1,8
6354,5,262,159,421,False,1,8
6355,6,411,197,608,False,1,8
6356,7,251,172,423,False,1,8
6357,8,255,184,439,False,1,8
6358,9,230,209,439,False,1,8
6359,10,228,215,443,False,1,8
6360,11,251,219,470,False,1,8
6361,12,219,280,499,False,1,8
6362,13,264,356,620,False,1,8
6363,14,223,307,530,False,1,8
6364,15,188,217,405,False,1,8
6365,16,185,175,360,False,1,8
6366,17,146,158,304,False,1,8
6367,18,129,142,271,False,1,8
6368,19,90,112,202,False,1,8
6369,20,66,81,147,False,1,8
6370,21,45,40,85,False,1,8
6371,22,21,18,39,False,1,8
6372,23,5,18,23,False,1,8
6373,0,13,16,29,False,2,8
6374,1,3,17,20,False,2,8
6375,2,3,11,14,False,2,8
6376,3,18,10,28,False,2,8
6377,4,112,65,177,False,2,8
6378,5,273,170,443,False,2,8
6379,6,398,196,594,False,2,8
6380,7,259,170,429,False,2,8
6381,8,241,168,409,False,2,8
6382,9,229,209,438,False,2,8
6383,10,233,194,427,False,2,8
6384,11,231,207,438,False,2,8
6385,12,236,278,514,False,2,8
6386,13,236,335,571,False,2,8
6387,14,280,318,598,False,2,8
6388,15,203,213,416,False,2,8
6389,16,169,177,346,False,2,8
6390,17,125,154,279,False,2,8
6391,18,140,134,274,False,2,8
6392,19,82,125,207,False,2,8
6393,20,66,84,150,False,2,8
6394,21,29,44,73,False,2,8
6395,22,22,27,49,False,2,8
6396,23,12,23,35,False,2,8
6397,0,11,18,29,False,3,8
6398,1,6,11,17,False,3,8
6399,2,5,12,17,False,3,8
6400,3,20,16,36,False,3,8
6401,4,120,65,185,False,3,8
6402,5,242,172,414,False,3,8
6403,6,396,205,601,False,3,8
6404,7,283,185,468,False,3,8
6405,8,223,189,412,False,3,8
6406,9,229,191,420,False,3,8
6407,10,214,210,424,False,3,8
6408,11,209,229,438,False,3,8
6409,12,203,244,447,False,3,8
6410,13,287,333,620,False,3,8
6411,14,236,264,500,False,3,8
6412,15,207,196,403,False,3,8
6413,16,210,167,377,False,3,8
6414,17,146,165,311,False,3,8
6415,18,131,148,279,False,3,8
6416,19,102,137,239,False,3,8
6417,20,77,259,336,False,3,8
6418,21,38,55,93,False,3,8
6419,22,16,40,56,False,3,8
6420,23,15,23,38,False,3,8
6421,0,13,26,39,False,4,8
6422,1,7,23,30,False,4,8
6423,2,4,9,13,False,4,8
6424,3,15,18,33,False,4,8
6425,4,115,73,188,False,4,8
6426,5,214,169,383,False,4,8
6427,6,355,202,557,False,4,8
6428,7,263,163,426,False,4,8
6429,8,227,192,419,False,4,8
6430,9,246,192,438,False,4,8
6431,10,270,208,478,False,4,8
6432,11,219,231,450,False,4,8
6433,12,253,264,517,False,4,8
6434,13,265,350,615,False,4,8
6435,14,225,298,523,False,4,8
6436,15,161,178,339,False,4,8
6437,16,144,161,305,False,4,8
6438,17,147,147,294,False,4,8
6439,18,115,104,219,False,4,8
6440,19,80,84,164,False,4,8
6441,20,66,74,140,False,4,8
6442,21,55,76,131,False,4,8
6443,22,36,66,102,False,4,8
6444,23,36,55,91,False,4,8
6445,0,29,36,65,False,5,8
6446,1,22,65,87,False,5,8
6447,2,12,24,36,False,5,8
6448,3,15,15,30,False,5,8
6449,4,18,11,29,False,5,8
6450,5,30,24,54,False,5,8
6451,6,34,45,79,False,5,8
6452,7,79,65,144,False,5,8
6453,8,136,93,229,False,5,8
6454,9,140,104,244,False,5,8
6455,10,174,135,309,False,5,8
6456,11,195,225,420,False,5,8
6457,12,170,173,343,False,5,8
6458,13,178,215,393,False,5,8
6459,14,148,208,356,False,5,8
6460,15,145,207,352,False,5,8
6461,16,140,141,281,False,5,8
6462,17,97,104,201,False,5,8
6463,18,126,98,224,False,5,8
6464,19,75,85,160,False,5,8
6465,20,44,62,106,False,5,8
6466,21,47,73,120,False,5,8
6467,22,54,66,120,False,5,8
6468,23,46,54,100,False,5,8
6469,0,24,60,84,True,6,8
6470,1,36,70,106,True,6,8
6471,2,20,41,61,True,6,8
6472,3,13,14,27,True,6,8
6473,4,19,20,39,True,6,8
6474,5,14,16,30,True,6,8
6475,6,25,24,49,True,6,8
6476,7,60,36,96,True,6,8
6477,8,112,61,173,True,6,8
6478,9,118,95,213,True,6,8
6479,10,149,143,292,True,6,8
6480,11,149,165,314,True,6,8
6481,12,207,203,410,True,6,8
6482,13,152,185,337,True,6,8
6483,14,176,247,423,True,6,8
6484,15,165,192,357,True,6,8
6485,16,169,186,355,True,6,8
6486,17,146,175,321,True,6,8
6487,18,131,155,286,True,6,8
6488,19,98,112,210,True,6,8
6489,20,61,77,138,True,6,8
6490,21,37,39,76,True,6,8
6491,22,28,22,50,True,6,8
6492,23,14,7,21,True,6,8
6493,0,4,10,14,False,0,8
6494,1,3,10,13,False,0,8
6495,2,4,6,10,False,0,8
6496,3,20,9,29,False,0,8
6497,4,132,61,193,False,0,8
6498,5,268,147,415,False,0,8
6499,6,368,196,564,False,0,8
6500,7,232,146,378,False,0,8
6501,8,253,172,425,False,0,8
6502,9,263,198,461,False,0,8
6503,10,240,240,480,False,0,8
6504,11,254,230,484,False,0,8
6505,12,219,275,494,False,0,8
6506,13,260,329,589,False,0,8
6507,14,238,314,552,False,0,8
6508,15,215,188,403,False,0,8
6509,16,171,171,342,False,0,8
6510,17,169,203,372,False,0,8
6511,18,119,163,282,False,0,8
6512,19,104,120,224,False,0,8
6513,20,43,93,136,False,0,8
6514,21,14,43,57,False,0,8
6515,22,14,24,38,False,0,8
6516,23,4,14,18,False,0,8
6517,0,1,4,5,False,1,8
6518,1,2,10,12,False,1,8
6519,2,3,10,13,False,1,8
6520,3,24,8,32,False,1,8
6521,4,137,64,201,False,1,8
6522,5,215,155,370,False,1,8
6523,6,340,174,514,False,1,8
6524,7,289,157,446,False,1,8
6525,8,280,178,458,False,1,8
6526,9,229,213,442,False,1,8
6527,10,237,230,467,False,1,8
6528,11,212,242,454,False,1,8
6529,12,227,305,532,False,1,8
6530,13,273,330,603,False,1,8
6531,14,212,313,525,False,1,8
6532,15,229,216,445,False,1,8
6533,16,171,180,351,False,1,8
6534,17,142,144,286,False,1,8
6535,18,143,146,289,False,1,8
6536,19,122,131,253,False,1,8
6537,20,35,99,134,False,1,8
6538,21,21,48,69,False,1,8
6539,22,12,25,37,False,1,8
6540,23,7,22,29,False,1,8
6541,0,4,25,29,False,2,8
6542,1,8,18,26,False,2,8
6543,2,8,10,18,False,2,8
6544,3,19,12,31,False,2,8
6545,4,126,70,196,False,2,8
6546,5,265,162,427,False,2,8
6547,6,386,191,577,False,2,8
6548,7,234,172,406,False,2,8
6549,8,227,172,399,False,2,8
6550,9,213,195,408,False,2,8
6551,10,221,199,420,False,2,8
6552,11,224,216,440,False,2,8
6553,12,226,281,507,False,2,8
6554,13,271,316,587,False,2,8
6555,14,248,315,563,False,2,8
6556,15,213,192,405,False,2,8
6557,16,173,173,346,False,2,8
6558,17,155,160,315,False,2,8
6559,18,152,179,331,False,2,8
6560,19,109,128,237,False,2,8
6561,20,37,86,123,False,2,8
6562,21,13,49,62,False,2,8
6563,22,11,29,40,False,2,8
6564,23,8,23,31,False,2,8
6565,0,3,16,19,False,3,8
6566,1,2,17,19,False,3,8
6567,2,5,17,22,False,3,8
6568,3,19,10,29,False,3,8
6569,4,127,62,189,False,3,8
6570,5,234,157,391,False,3,8
6571,6,408,214,622,False,3,8
6572,7,257,163,420,False,3,8
6573,8,227,171,398,False,3,8
6574,9,220,176,396,False,3,8
6575,10,225,172,397,False,3,8
6576,11,186,242,428,False,3,8
6577,12,236,280,516,False,3,8
6578,13,275,352,627,False,3,8
6579,14,229,292,521,False,3,8
6580,15,177,202,379,False,3,8
6581,16,180,175,355,False,3,8
6582,17,148,170,318,False,3,8
6583,18,132,144,276,False,3,8
6584,19,103,107,210,False,3,8
6585,20,75,165,240,False,3,8
6586,21,44,124,168,False,3,8
6587,22,21,34,55,False,3,8
6588,23,24,40,64,False,3,8
6589,0,15,33,48,False,4,8
6590,1,16,31,47,False,4,8
6591,2,6,20,26,False,4,8
6592,3,15,14,29,False,4,8
6593,4,121,74,195,False,4,8
6594,5,230,158,388,False,4,8
6595,6,335,174,509,False,4,8
6596,7,287,150,437,False,4,8
6597,8,213,158,371,False,4,8
6598,9,240,203,443,False,4,8
6599,10,232,247,479,False,4,8
6600,11,244,235,479,False,4,8
6601,12,244,297,541,False,4,8
6602,13,268,352,620,False,4,8
6603,14,203,247,450,False,4,8
6604,15,167,192,359,False,4,8
6605,16,135,132,267,False,4,8
6606,17,153,130,283,False,4,8
6607,18,96,115,211,False,4,8
6608,19,70,73,143,False,4,8
6609,20,51,61,112,False,4,8
6610,21,46,86,132,False,4,8
6611,22,40,56,96,False,4,8
6612,23,35,51,86,False,4,8
6613,0,15,32,47,False,5,8
6614,1,17,46,63,False,5,8
6615,2,13,26,39,False,5,8
6616,3,6,11,17,False,5,8
6617,4,33,11,44,False,5,8
6618,5,27,27,54,False,5,8
6619,6,42,30,72,False,5,8
6620,7,79,71,150,False,5,8
6621,8,115,80,195,False,5,8
6622,9,149,134,283,False,5,8
6623,10,192,129,321,False,5,8
6624,11,186,155,341,False,5,8
6625,12,142,203,345,False,5,8
6626,13,146,198,344,False,5,8
6627,14,118,167,285,False,5,8
6628,15,132,149,281,False,5,8
6629,16,136,141,277,False,5,8
6630,17,117,109,226,False,5,8
6631,18,85,84,169,False,5,8
6632,19,77,73,150,False,5,8
6633,20,64,55,119,False,5,8
6634,21,40,76,116,False,5,8
6635,22,50,81,131,False,5,8
6636,23,43,59,102,False,5,8
6637,0,30,75,105,True,6,8
6638,1,29,54,83,True,6,8
6639,2,13,48,61,True,6,8
6640,3,14,24,38,True,6,8
6641,4,15,18,33,True,6,8
6642,5,13,18,31,True,6,8
6643,6,26,20,46,True,6,8
6644,7,39,34,73,True,6,8
6645,8,109,72,181,True,6,8
6646,9,114,91,205,True,6,8
6647,10,136,153,289,True,6,8
6648,11,145,163,308,True,6,8
6649,12,189,182,371,True,6,8
6650,13,169,188,357,True,6,8
6651,14,136,195,331,True,6,8
6652,15,157,165,322,True,6,8
6653,16,176,175,351,True,6,8
6654,17,159,183,342,True,6,8
6655,18,157,179,336,True,6,8
6656,19,96,108,204,True,6,8
6657,20,60,78,138,True,6,8
6658,21,39,41,80,True,6,8
6659,22,19,25,44,True,6,8
6660,23,9,15,24,True,6,8
6661,0,3,6,9,False,0,8
6662,1,6,7,13,False,0,8
6663,2,6,8,14,False,0,8
6664,3,22,20,42,False,0,8
6665,4,147,76,223,False,0,8
6666,5,254,161,415,False,0,8
6667,6,385,207,592,False,0,8
6668,7,276,165,441,False,0,8
6669,8,234,214,448,False,0,8
6670,9,188,215,403,False,0,8
6671,10,212,212,424,False,0,8
6672,11,223,231,454,False,0,8
6673,12,213,280,493,False,0,8
6674,13,265,358,623,False,0,8
6675,14,256,294,550,False,0,8
6676,15,201,207,408,False,0,8
6677,16,203,184,387,False,0,8
6678,17,142,167,309,False,0,8
6679,18,122,155,277,False,0,8
6680,19,79,135,214,False,0,8
6681,20,72,103,175,False,0,8
6682,21,25,46,71,False,0,8
6683,22,18,17,35,False,0,8
6684,23,8,15,23,False,0,8
6685,0,6,8,14,False,1,8
6686,1,4,3,7,False,1,8
6687,2,6,10,16,False,1,8
6688,3,26,14,40,False,1,8
6689,4,118,77,195,False,1,8
6690,5,230,167,397,False,1,8
6691,6,395,210,605,False,1,8
6692,7,272,175,447,False,1,8
6693,8,225,176,401,False,1,8
6694,9,212,216,428,False,1,8
6695,10,202,187,389,False,1,8
6696,11,196,209,405,False,1,8
6697,12,207,268,475,False,1,8
6698,13,274,328,602,False,1,8
6699,14,248,304,552,False,1,8
6700,15,228,204,432,False,1,8
6701,16,175,193,368,False,1,8
6702,17,178,175,353,False,1,8
6703,18,135,152,287,False,1,8
6704,19,103,150,253,False,1,8
6705,20,58,98,156,False,1,8
6706,21,24,46,70,False,1,8
6707,22,21,24,45,False,1,8
6708,23,21,21,42,False,1,8
6709,0,13,19,32,False,2,8
6710,1,11,16,27,False,2,8
6711,2,6,13,19,False,2,8
6712,3,22,16,38,False,2,8
6713,4,128,80,208,False,2,8
6714,5,235,155,390,False,2,8
6715,6,386,229,615,False,2,8
6716,7,227,174,401,False,2,8
6717,8,217,180,397,False,2,8
6718,9,249,221,470,False,2,8
6719,10,208,190,398,False,2,8
6720,11,206,226,432,False,2,8
6721,12,217,277,494,False,2,8
6722,13,259,340,599,False,2,8
6723,14,214,305,519,False,2,8
6724,15,189,212,401,False,2,8
6725,16,208,174,382,False,2,8
6726,17,172,153,325,False,2,8
6727,18,117,145,262,False,2,8
6728,19,92,140,232,False,2,8
6729,20,59,129,188,False,2,8
6730,21,35,119,154,False,2,8
6731,22,28,27,55,False,2,8
6732,23,9,21,30,False,2,8
6733,0,8,11,19,False,3,8
6734,1,6,12,18,False,3,8
6735,2,6,12,18,False,3,8
6736,3,19,16,35,False,3,8
6737,4,121,67,188,False,3,8
6738,5,243,188,431,False,3,8
6739,6,411,227,638,False,3,8
6740,7,266,178,444,False,3,8
6741,8,229,174,403,False,3,8
6742,9,206,180,386,False,3,8
6743,10,192,190,382,False,3,8
6744,11,229,227,456,False,3,8
6745,12,219,276,495,False,3,8
6746,13,268,341,609,False,3,8
6747,14,255,325,580,False,3,8
6748,15,216,238,454,False,3,8
6749,16,240,186,426,False,3,8
6750,17,162,192,354,False,3,8
6751,18,127,140,267,False,3,8
6752,19,97,148,245,False,3,8
6753,20,57,81,138,False,3,8
6754,21,37,57,94,False,3,8
6755,22,11,26,37,False,3,8
6756,23,9,29,38,False,3,8
6757,0,15,26,41,False,4,8
6758,1,9,20,29,False,4,8
6759,2,7,16,23,False,4,8
6760,3,20,17,37,False,4,8
6761,4,135,61,196,False,4,8
6762,5,242,161,403,False,4,8
6763,6,363,184,547,False,4,8
6764,7,274,175,449,False,4,8
6765,8,237,188,425,False,4,8
6766,9,264,208,472,False,4,8
6767,10,217,238,455,False,4,8
6768,11,229,270,499,False,4,8
6769,12,276,292,568,False,4,8
6770,13,264,334,598,False,4,8
6771,14,216,380,596,False,4,8
6772,15,203,206,409,False,4,8
6773,16,146,169,315,False,4,8
6774,17,151,156,307,False,4,8
6775,18,114,136,250,False,4,8
6776,19,85,98,183,False,4,8
6777,20,85,90,175,False,4,8
6778,21,42,92,134,False,4,8
6779,22,28,45,73,False,4,8
6780,23,30,52,82,False,4,8
6781,0,22,50,72,False,5,8
6782,1,15,45,60,False,5,8
6783,2,9,29,38,False,5,8
6784,3,8,14,22,False,5,8
6785,4,20,15,35,False,5,8
6786,5,32,33,65,False,5,8
6787,6,28,41,69,False,5,8
6788,7,60,53,113,False,5,8
6789,8,117,91,208,False,5,8
6790,9,157,127,284,False,5,8
6791,10,174,164,338,False,5,8
6792,11,187,170,357,False,5,8
6793,12,159,170,329,False,5,8
6794,13,144,182,326,False,5,8
6795,14,184,191,375,False,5,8
6796,15,149,183,332,False,5,8
6797,16,109,178,287,False,5,8
6798,17,101,148,249,False,5,8
6799,18,99,129,228,False,5,8
6800,19,64,81,145,False,5,8
6801,20,67,78,145,False,5,8
6802,21,53,80,133,False,5,8
6803,22,56,77,133,False,5,8
6804,23,31,79,110,False,5,8
6805,0,36,67,103,True,6,8
6806,1,29,55,84,True,6,8
6807,2,11,51,62,True,6,8
6808,3,8,15,23,True,6,8
6809,4,17,12,29,True,6,8
6810,5,26,19,45,True,6,8
6811,6,25,17,42,True,6,8
6812,7,47,33,80,True,6,8
6813,8,103,62,165,True,6,8
6814,9,131,112,243,True,6,8
6815,10,130,162,292,True,6,8
6816,11,175,165,340,True,6,8
6817,12,218,236,454,True,6,8
6818,13,178,242,420,True,6,8
6819,14,195,243,438,True,6,8
6820,15,163,220,383,True,6,8
6821,16,141,220,361,True,6,8
6822,17,121,238,359,True,6,8
6823,18,116,152,268,True,6,8
6824,19,89,113,202,True,6,8
6825,20,106,85,191,True,6,8
6826,21,33,53,86,True,6,8
6827,22,16,19,35,True,6,8
6828,23,10,12,22,True,6,8
6829,0,7,11,18,False,0,8
6830,1,5,10,15,False,0,8
6831,2,6,11,17,False,0,8
6832,3,16,9,25,False,0,8
6833,4,132,69,201,False,0,8
6834,5,228,152,380,False,0,8
6835,6,371,205,576,False,0,8
6836,7,254,190,444,False,0,8
6837,8,208,209,417,False,0,8
6838,9,221,174,395,False,0,8
6839,10,212,203,415,False,0,8
6840,11,207,214,421,False,0,8
6841,12,211,263,474,False,0,8
6842,13,246,325,571,False,0,8
6843,14,233,320,553,False,0,8
6844,15,200,194,394,False,0,8
6845,16,200,182,382,False,0,8
6846,17,151,169,320,False,0,8
6847,18,129,149,278,False,0,8
6848,19,98,141,239,False,0,8
6849,20,54,80,134,False,0,8
6850,21,44,55,99,False,0,8
6851,22,14,21,35,False,0,8
6852,23,7,17,24,False,0,8
6853,0,8,16,24,False,1,8
6854,1,3,6,9,False,1,8
6855,2,9,5,14,False,1,8
6856,3,23,12,35,False,1,8
6857,4,139,70,209,False,1,8
6858,5,231,185,416,False,1,8
6859,6,427,252,679,False,1,8
6860,7,267,188,455,False,1,8
6861,8,242,179,421,False,1,8
6862,9,242,208,450,False,1,8
6863,10,218,232,450,False,1,8
6864,11,210,220,430,False,1,8
6865,12,226,278,504,False,1,8
6866,13,271,347,618,False,1,8
6867,14,267,341,608,False,1,8
6868,15,230,234,464,False,1,8
6869,16,261,197,458,False,1,8
6870,17,186,146,332,False,1,8
6871,18,124,142,266,False,1,8
6872,19,91,110,201,False,1,8
6873,20,60,94,154,False,1,8
6874,21,26,44,70,False,1,8
6875,22,14,28,42,False,1,8
6876,23,12,20,32,False,1,8
6877,0,11,16,27,False,2,8
6878,1,6,11,17,False,2,8
6879,2,5,4,9,False,2,8
6880,3,21,12,33,False,2,8
6881,4,107,69,176,False,2,8
6882,5,240,149,389,False,2,8
6883,6,388,215,603,False,2,8
6884,7,265,168,433,False,2,8
6885,8,244,167,411,False,2,8
6886,9,237,203,440,False,2,8
6887,10,208,201,409,False,2,8
6888,11,224,215,439,False,2,8
6889,12,215,266,481,False,2,8
6890,13,263,343,606,False,2,8
6891,14,249,329,578,False,2,8
6892,15,237,237,474,False,2,8
6893,16,164,191,355,False,2,8
6894,17,134,168,302,False,2,8
6895,18,116,159,275,False,2,8
6896,19,94,148,242,False,2,8
6897,20,59,97,156,False,2,8
6898,21,37,44,81,False,2,8
6899,22,17,27,44,False,2,8
6900,23,7,12,19,False,2,8
6901,0,8,12,20,False,3,8
6902,1,3,13,16,False,3,8
6903,2,4,10,14,False,3,8
6904,3,26,14,40,False,3,8
6905,4,125,64,189,False,3,8
6906,5,239,174,413,False,3,8
6907,6,412,210,622,False,3,8
6908,7,262,169,431,False,3,8
6909,8,258,197,455,False,3,8
6910,9,220,186,406,False,3,8
6911,10,239,215,454,False,3,8
6912,11,198,265,463,False,3,8
6913,12,228,277,505,False,3,8
6914,13,314,353,667,False,3,8
6915,14,241,315,556,False,3,8
6916,15,215,232,447,False,3,8
6917,16,194,161,355,False,3,8
6918,17,174,190,364,False,3,8
6919,18,107,153,260,False,3,8
6920,19,80,136,216,False,3,8
6921,20,71,87,158,False,3,8
6922,21,35,55,90,False,3,8
6923,22,16,31,47,False,3,8
6924,23,20,34,54,False,3,8
6925,0,18,24,42,False,4,8
6926,1,9,22,31,False,4,8
6927,2,7,16,23,False,4,8
6928,3,21,13,34,False,4,8
6929,4,130,62,192,False,4,8
6930,5,241,171,412,False,4,8
6931,6,396,224,620,False,4,8
6932,7,242,173,415,False,4,8
6933,8,264,196,460,False,4,8
6934,9,233,201,434,False,4,8
6935,10,249,225,474,False,4,8
6936,11,221,253,474,False,4,8
6937,12,256,305,561,False,4,8
6938,13,281,356,637,False,4,8
6939,14,232,283,515,False,4,8
6940,15,236,232,468,False,4,8
6941,16,149,182,331,False,4,8
6942,17,139,167,306,False,4,8
6943,18,87,122,209,False,4,8
6944,19,76,96,172,False,4,8
6945,20,64,88,152,False,4,8
6946,21,51,56,107,False,4,8
6947,22,45,73,118,False,4,8
6948,23,28,40,68,False,4,8
6949,0,28,61,89,False,5,9
6950,1,21,41,62,False,5,9
6951,2,12,33,45,False,5,9
6952,3,13,17,30,False,5,9
6953,4,26,18,44,False,5,9
6954,5,33,29,62,False,5,9
6955,6,46,43,89,False,5,9
6956,7,89,82,171,False,5,9
6957,8,121,96,217,False,5,9
6958,9,152,114,266,False,5,9
6959,10,184,152,336,False,5,9
6960,11,182,173,355,False,5,9
6961,12,170,199,369,False,5,9
6962,13,192,190,382,False,5,9
6963,14,150,204,354,False,5,9
6964,15,133,187,320,False,5,9
6965,16,159,168,327,False,5,9
6966,17,117,133,250,False,5,9
6967,18,79,110,189,False,5,9
6968,19,67,82,149,False,5,9
6969,20,35,57,92,False,5,9
6970,21,50,73,123,False,5,9
6971,22,43,71,114,False,5,9
6972,23,32,58,90,False,5,9
6973,0,27,55,82,True,6,9
6974,1,25,61,86,True,6,9
6975,2,23,49,72,True,6,9
6976,3,11,31,42,True,6,9
6977,4,17,13,30,True,6,9
6978,5,18,15,33,True,6,9
6979,6,54,18,72,True,6,9
6980,7,53,47,100,True,6,9
6981,8,128,72,200,True,6,9
6982,9,138,102,240,True,6,9
6983,10,156,169,325,True,6,9
6984,11,165,200,365,True,6,9
6985,12,155,192,347,True,6,9
6986,13,171,234,405,True,6,9
6987,14,188,235,423,True,6,9
6988,15,166,200,366,True,6,9
6989,16,177,183,360,True,6,9
6990,17,184,227,411,True,6,9
6991,18,136,154,290,True,6,9
6992,19,88,120,208,True,6,9
6993,20,61,83,144,True,6,9
6994,21,29,37,66,True,6,9
6995,22,13,26,39,True,6,9
6996,23,18,13,31,True,6,9
6997,0,10,12,22,False,0,9
6998,1,3,9,12,False,0,9
6999,2,5,9,14,False,0,9
7000,3,19,13,32,False,0,9
7001,4,132,73,205,False,0,9
7002,5,228,167,395,False,0,9
7003,6,383,200,583,False,0,9
7004,7,305,167,472,False,0,9
7005,8,235,184,419,False,0,9
7006,9,208,202,410,False,0,9
7007,10,208,194,402,False,0,9
7008,11,197,230,427,False,0,9
7009,12,218,245,463,False,0,9
7010,13,272,355,627,False,0,9
7011,14,237,296,533,False,0,9
7012,15,184,223,407,False,0,9
7013,16,157,175,332,False,0,9
7014,17,139,161,300,False,0,9
7015,18,136,137,273,False,0,9
7016,19,82,126,208,False,0,9
7017,20,57,82,139,False,0,9
7018,21,37,50,87,False,0,9
7019,22,16,15,31,False,0,9
7020,23,8,5,13,False,0,9
7021,0,4,12,16,False,1,9
7022,1,6,7,13,False,1,9
7023,2,6,12,18,False,1,9
7024,3,27,16,43,False,1,9
7025,4,135,67,202,False,1,9
7026,5,260,190,450,False,1,9
7027,6,389,206,595,False,1,9
7028,7,240,182,422,False,1,9
7029,8,227,169,396,False,1,9
7030,9,232,190,422,False,1,9
7031,10,225,240,465,False,1,9
7032,11,192,225,417,False,1,9
7033,12,235,275,510,False,1,9
7034,13,278,348,626,False,1,9
7035,14,233,274,507,False,1,9
7036,15,210,221,431,False,1,9
7037,16,208,180,388,False,1,9
7038,17,170,169,339,False,1,9
7039,18,119,159,278,False,1,9
7040,19,98,128,226,False,1,9
7041,20,55,102,157,False,1,9
7042,21,41,33,74,False,1,9
7043,22,15,25,40,False,1,9
7044,23,11,17,28,False,1,9
7045,0,6,7,13,False,2,9
7046,1,5,5,10,False,2,9
7047,2,9,6,15,False,2,9
7048,3,21,6,27,False,2,9
7049,4,122,76,198,False,2,9
7050,5,250,183,433,False,2,9
7051,6,395,203,598,False,2,9
7052,7,237,174,411,False,2,9
7053,8,225,171,396,False,2,9
7054,9,196,202,398,False,2,9
7055,10,198,191,389,False,2,9
7056,11,208,201,409,False,2,9
7057,12,212,273,485,False,2,9
7058,13,272,331,603,False,2,9
7059,14,230,286,516,False,2,9
7060,15,229,214,443,False,2,9
7061,16,157,163,320,False,2,9
7062,17,152,178,330,False,2,9
7063,18,112,151,263,False,2,9
7064,19,100,130,230,False,2,9
7065,20,73,91,164,False,2,9
7066,21,36,49,85,False,2,9
7067,22,15,19,34,False,2,9
7068,23,14,13,27,False,2,9
7069,0,10,7,17,False,3,9
7070,1,14,4,18,False,3,9
7071,2,11,7,18,False,3,9
7072,3,16,16,32,False,3,9
7073,4,118,63,181,False,3,9
7074,5,218,166,384,False,3,9
7075,6,401,210,611,False,3,9
7076,7,257,171,428,False,3,9
7077,8,233,178,411,False,3,9
7078,9,201,185,386,False,3,9
7079,10,224,188,412,False,3,9
7080,11,221,240,461,False,3,9
7081,12,216,296,512,False,3,9
7082,13,279,346,625,False,3,9
7083,14,240,266,506,False,3,9
7084,15,192,218,410,False,3,9
7085,16,186,178,364,False,3,9
7086,17,162,163,325,False,3,9
7087,18,111,139,250,False,3,9
7088,19,76,105,181,False,3,9
7089,20,62,277,339,False,3,9
7090,21,38,209,247,False,3,9
7091,22,28,76,104,False,3,9
7092,23,18,49,67,False,3,9
7093,0,12,25,37,False,4,9
7094,1,11,7,18,False,4,9
7095,2,5,3,8,False,4,9
7096,3,19,13,32,False,4,9
7097,4,127,69,196,False,4,9
7098,5,226,162,388,False,4,9
7099,6,346,181,527,False,4,9
7100,7,283,169,452,False,4,9
7101,8,211,154,365,False,4,9
7102,9,230,205,435,False,4,9
7103,10,249,210,459,False,4,9
7104,11,253,270,523,False,4,9
7105,12,266,330,596,False,4,9
7106,13,287,358,645,False,4,9
7107,14,196,301,497,False,4,9
7108,15,176,195,371,False,4,9
7109,16,159,180,339,False,4,9
7110,17,130,134,264,False,4,9
7111,18,110,105,215,False,4,9
7112,19,83,97,180,False,4,9
7113,20,73,87,160,False,4,9
7114,21,51,68,119,False,4,9
7115,22,37,67,104,False,4,9
7116,23,21,43,64,False,4,9
7117,0,30,41,71,False,5,9
7118,1,21,62,83,False,5,9
7119,2,10,27,37,False,5,9
7120,3,11,12,23,False,5,9
7121,4,21,17,38,False,5,9
7122,5,36,26,62,False,5,9
7123,6,39,37,76,False,5,9
7124,7,63,55,118,False,5,9
7125,8,101,86,187,False,5,9
7126,9,159,115,274,False,5,9
7127,10,181,147,328,False,5,9
7128,11,148,154,302,False,5,9
7129,12,151,184,335,False,5,9
7130,13,126,175,301,False,5,9
7131,14,107,163,270,False,5,9
7132,15,125,146,271,False,5,9
7133,16,130,148,278,False,5,9
7134,17,98,108,206,False,5,9
7135,18,87,100,187,False,5,9
7136,19,69,86,155,False,5,9
7137,20,45,73,118,False,5,9
7138,21,61,65,126,False,5,9
7139,22,38,60,98,False,5,9
7140,23,41,63,104,False,5,9
7141,0,30,54,84,True,6,9
7142,1,37,53,90,True,6,9
7143,2,17,48,65,True,6,9
7144,3,8,19,27,True,6,9
7145,4,10,14,24,True,6,9
7146,5,18,16,34,True,6,9
7147,6,24,21,45,True,6,9
7148,7,49,47,96,True,6,9
7149,8,93,66,159,True,6,9
7150,9,103,90,193,True,6,9
7151,10,155,120,275,True,6,9
7152,11,122,144,266,True,6,9
7153,12,150,190,340,True,6,9
7154,13,161,200,361,True,6,9
7155,14,160,205,365,True,6,9
7156,15,145,182,327,True,6,9
7157,16,160,148,308,True,6,9
7158,17,142,135,277,True,6,9
7159,18,113,137,250,True,6,9
7160,19,76,100,176,True,6,9
7161,20,74,63,137,True,6,9
7162,21,31,45,76,True,6,9
7163,22,12,18,30,True,6,9
7164,23,8,14,22,True,6,9
7165,0,6,8,14,True,0,9
7166,1,8,12,20,True,0,9
7167,2,7,13,20,True,0,9
7168,3,19,10,29,True,0,9
7169,4,120,67,187,True,0,9
7170,5,214,145,359,True,0,9
7171,6,316,174,490,True,0,9
7172,7,250,152,402,True,0,9
7173,8,229,173,402,True,0,9
7174,9,218,173,391,True,0,9
7175,10,186,197,383,True,0,9
7176,11,207,215,422,True,0,9
7177,12,228,258,486,True,0,9
7178,13,207,300,507,True,0,9
7179,14,207,268,475,True,0,9
7180,15,192,182,374,True,0,9
7181,16,166,162,328,True,0,9
7182,17,130,147,277,True,0,9
7183,18,130,135,265,True,0,9
7184,19,81,109,190,True,0,9
7185,20,61,97,158,True,0,9
7186,21,40,40,80,True,0,9
7187,22,18,23,41,True,0,9
7188,23,8,15,23,True,0,9
7189,0,5,7,12,True,1,9
7190,1,2,9,11,True,1,9
7191,2,6,13,19,True,1,9
7192,3,16,8,24,True,1,9
7193,4,123,58,181,True,1,9
7194,5,221,147,368,True,1,9
7195,6,296,174,470,True,1,9
7196,7,227,150,377,True,1,9
7197,8,189,197,386,True,1,9
7198,9,211,165,376,True,1,9
7199,10,214,165,379,True,1,9
7200,11,196,219,415,True,1,9
7201,12,217,262,479,True,1,9
7202,13,250,300,550,True,1,9
7203,14,229,278,507,True,1,9
7204,15,192,194,386,True,1,9
7205,16,190,169,359,True,1,9
7206,17,128,149,277,True,1,9
7207,18,98,131,229,True,1,9
7208,19,83,114,197,True,1,9
7209,20,58,68,126,True,1,9
7210,21,29,43,72,True,1,9
7211,22,21,23,44,True,1,9
7212,23,10,25,35,True,1,9
7213,0,10,18,28,True,2,9
7214,1,6,12,18,True,2,9
7215,2,4,10,14,True,2,9
7216,3,14,17,31,True,2,9
7217,4,122,66,188,True,2,9
7218,5,208,142,350,True,2,9
7219,6,285,173,458,True,2,9
7220,7,257,175,432,True,2,9
7221,8,225,172,397,True,2,9
7222,9,223,185,408,True,2,9
7223,10,202,201,403,True,2,9
7224,11,205,221,426,True,2,9
7225,12,194,237,431,True,2,9
7226,13,247,310,557,True,2,9
7227,14,217,281,498,True,2,9
7228,15,197,206,403,True,2,9
7229,16,146,179,325,True,2,9
7230,17,127,131,258,True,2,9
7231,18,114,117,231,True,2,9
7232,19,77,109,186,True,2,9
7233,20,69,77,146,True,2,9
7234,21,43,48,91,True,2,9
7235,22,21,36,57,True,2,9
7236,23,12,16,28,True,2,9
7237,0,8,13,21,True,3,9
7238,1,6,10,16,True,3,9
7239,2,2,9,11,True,3,9
7240,3,15,17,32,True,3,9
7241,4,117,56,173,True,3,9
7242,5,213,133,346,True,3,9
7243,6,255,143,398,True,3,9
7244,7,213,140,353,True,3,9
7245,8,221,147,368,True,3,9
7246,9,195,179,374,True,3,9
7247,10,212,182,394,True,3,9
7248,11,201,214,415,True,3,9
7249,12,214,253,467,True,3,9
7250,13,238,276,514,True,3,9
7251,14,202,263,465,True,3,9
7252,15,181,210,391,True,3,9
7253,16,124,180,304,True,3,9
7254,17,136,121,257,True,3,9
7255,18,104,111,215,True,3,9
7256,19,92,106,198,True,3,9
7257,20,62,75,137,True,3,9
7258,21,36,50,86,True,3,9
7259,22,21,38,59,True,3,9
7260,23,8,22,30,True,3,9
7261,0,16,36,52,True,4,9
7262,1,7,17,24,True,4,9
7263,2,8,16,24,True,4,9
7264,3,18,19,37,True,4,9
7265,4,117,62,179,True,4,9
7266,5,201,124,325,True,4,9
7267,6,233,153,386,True,4,9
7268,7,225,178,403,True,4,9
7269,8,231,160,391,True,4,9
7270,9,192,182,374,True,4,9
7271,10,230,218,448,True,4,9
7272,11,248,226,474,True,4,9
7273,12,219,290,509,True,4,9
7274,13,221,305,526,True,4,9
7275,14,199,257,456,True,4,9
7276,15,163,170,333,True,4,9
7277,16,153,153,306,True,4,9
7278,17,103,122,225,True,4,9
7279,18,91,101,192,True,4,9
7280,19,89,96,185,True,4,9
7281,20,61,77,138,True,4,9
7282,21,48,60,108,True,4,9
7283,22,30,43,73,True,4,9
7284,23,20,44,64,True,4,9
7285,0,17,45,62,True,5,9
7286,1,23,44,67,True,5,9
7287,2,15,22,37,True,5,9
7288,3,11,13,24,True,5,9
7289,4,18,13,31,True,5,9
7290,5,33,15,48,True,5,9
7291,6,40,40,80,True,5,9
7292,7,66,39,105,True,5,9
7293,8,96,76,172,True,5,9
7294,9,148,83,231,True,5,9
7295,10,159,126,285,True,5,9
7296,11,143,127,270,True,5,9
7297,12,139,182,321,True,5,9
7298,13,131,191,322,True,5,9
7299,14,112,144,256,True,5,9
7300,15,136,149,285,True,5,9
7301,16,127,102,229,True,5,9
7302,17,93,107,200,True,5,9
7303,18,71,73,144,True,5,9
7304,19,57,87,144,True,5,9
7305,20,44,64,108,True,5,9
7306,21,39,60,99,True,5,9
7307,22,42,74,116,True,5,9
7308,23,36,50,86,True,5,9
7309,0,45,77,122,True,6,9
7310,1,27,67,94,True,6,9
7311,2,17,46,63,True,6,9
7312,3,12,14,26,True,6,9
7313,4,17,7,24,True,6,9
7314,5,17,16,33,True,6,9
7315,6,29,19,48,True,6,9
7316,7,33,35,68,True,6,9
7317,8,68,52,120,True,6,9
7318,9,100,79,179,True,6,9
7319,10,132,117,249,True,6,9
7320,11,143,157,300,True,6,9
7321,12,161,192,353,True,6,9
7322,13,172,177,349,True,6,9
7323,14,181,232,413,True,6,9
7324,15,148,208,356,True,6,9
7325,16,151,159,310,True,6,9
7326,17,153,156,309,True,6,9
7327,18,152,142,294,True,6,9
7328,19,79,120,199,True,6,9
7329,20,55,65,120,True,6,9
7330,21,30,42,72,True,6,9
7331,22,20,15,35,True,6,9
7332,23,10,15,25,True,6,9
7333,0,7,6,13,False,0,9
7334,1,6,13,19,False,0,9
7335,2,5,10,15,False,0,9
7336,3,16,8,24,False,0,9
7337,4,125,80,205,False,0,9
7338,5,235,148,383,False,0,9
7339,6,375,197,572,False,0,9
7340,7,273,181,454,False,0,9
7341,8,222,188,410,False,0,9
7342,9,202,179,381,False,0,9
7343,10,208,207,415,False,0,9
7344,11,210,189,399,False,0,9
7345,12,218,273,491,False,0,9
7346,13,266,367,633,False,0,9
7347,14,249,315,564,False,0,9
7348,15,210,203,413,False,0,9
7349,16,172,162,334,False,0,9
7350,17,151,170,321,False,0,9
7351,18,133,128,261,False,0,9
7352,19,75,121,196,False,0,9
7353,20,40,75,115,False,0,9
7354,21,42,87,129,False,0,9
7355,22,19,26,45,False,0,9
7356,23,11,19,30,False,0,9
7357,0,6,10,16,False,1,9
7358,1,7,12,19,False,1,9
7359,2,3,5,8,False,1,9
7360,3,19,13,32,False,1,9
7361,4,132,80,212,False,1,9
7362,5,233,181,414,False,1,9
7363,6,393,224,617,False,1,9
7364,7,270,163,433,False,1,9
7365,8,232,215,447,False,1,9
7366,9,193,178,371,False,1,9
7367,10,220,201,421,False,1,9
7368,11,224,211,435,False,1,9
7369,12,215,314,529,False,1,9
7370,13,250,321,571,False,1,9
7371,14,220,297,517,False,1,9
7372,15,226,222,448,False,1,9
7373,16,179,160,339,False,1,9
7374,17,155,181,336,False,1,9
7375,18,100,139,239,False,1,9
7376,19,109,110,219,False,1,9
7377,20,55,82,137,False,1,9
7378,21,27,40,67,False,1,9
7379,22,12,22,34,False,1,9
7380,23,8,18,26,False,1,9
7381,0,12,24,36,False,2,9
7382,1,6,18,24,False,2,9
7383,2,9,4,13,False,2,9
7384,3,25,11,36,False,2,9
7385,4,128,79,207,False,2,9
7386,5,223,160,383,False,2,9
7387,6,386,197,583,False,2,9
7388,7,225,168,393,False,2,9
7389,8,218,201,419,False,2,9
7390,9,222,208,430,False,2,9
7391,10,213,187,400,False,2,9
7392,11,227,182,409,False,2,9
7393,12,211,267,478,False,2,9
7394,13,250,321,571,False,2,9
7395,14,222,287,509,False,2,9
7396,15,200,198,398,False,2,9
7397,16,190,194,384,False,2,9
7398,17,153,159,312,False,2,9
7399,18,105,131,236,False,2,9
7400,19,97,135,232,False,2,9
7401,20,79,96,175,False,2,9
7402,21,34,46,80,False,2,9
7403,22,21,25,46,False,2,9
7404,23,16,21,37,False,2,9
7405,0,9,13,22,False,3,9
7406,1,14,12,26,False,3,9
7407,2,7,16,23,False,3,9
7408,3,20,13,33,False,3,9
7409,4,116,82,198,False,3,9
7410,5,230,146,376,False,3,9
7411,6,351,210,561,False,3,9
7412,7,251,153,404,False,3,9
7413,8,224,153,377,False,3,9
7414,9,221,205,426,False,3,9
7415,10,231,215,446,False,3,9
7416,11,206,261,467,False,3,9
7417,12,226,249,475,False,3,9
7418,13,259,302,561,False,3,9
7419,14,216,284,500,False,3,9
7420,15,202,201,403,False,3,9
7421,16,192,156,348,False,3,9
7422,17,162,211,373,False,3,9
7423,18,114,163,277,False,3,9
7424,19,98,127,225,False,3,9
7425,20,46,84,130,False,3,9
7426,21,38,41,79,False,3,9
7427,22,23,40,63,False,3,9
7428,23,22,34,56,False,3,9
7429,0,13,25,38,False,4,9
7430,1,10,32,42,False,4,9
7431,2,6,14,20,False,4,9
7432,3,23,14,37,False,4,9
7433,4,122,83,205,False,4,9
7434,5,221,151,372,False,4,9
7435,6,385,189,574,False,4,9
7436,7,235,165,400,False,4,9
7437,8,217,218,435,False,4,9
7438,9,225,191,416,False,4,9
7439,10,247,233,480,False,4,9
7440,11,231,220,451,False,4,9
7441,12,264,289,553,False,4,9
7442,13,285,323,608,False,4,9
7443,14,206,294,500,False,4,9
7444,15,147,206,353,False,4,9
7445,16,168,144,312,False,4,9
7446,17,134,158,292,False,4,9
7447,18,95,125,220,False,4,9
7448,19,75,107,182,False,4,9
7449,20,57,71,128,False,4,9
7450,21,47,69,116,False,4,9
7451,22,34,57,91,False,4,9
7452,23,22,48,70,False,4,9
7453,0,25,56,81,False,5,9
7454,1,23,48,71,False,5,9
7455,2,15,23,38,False,5,9
7456,3,15,18,33,False,5,9
7457,4,15,12,27,False,5,9
7458,5,34,26,60,False,5,9
7459,6,45,45,90,False,5,9
7460,7,81,60,141,False,5,9
7461,8,108,99,207,False,5,9
7462,9,131,106,237,False,5,9
7463,10,179,142,321,False,5,9
7464,11,156,184,340,False,5,9
7465,12,152,182,334,False,5,9
7466,13,146,219,365,False,5,9
7467,14,143,189,332,False,5,9
7468,15,138,190,328,False,5,9
7469,16,123,147,270,False,5,9
7470,17,97,114,211,False,5,9
7471,18,122,108,230,False,5,9
7472,19,73,102,175,False,5,9
7473,20,49,68,117,False,5,9
7474,21,49,63,112,False,5,9
7475,22,45,53,98,False,5,9
7476,23,35,51,86,False,5,9
7477,0,30,61,91,True,6,9
7478,1,33,63,96,True,6,9
7479,2,16,57,73,True,6,9
7480,3,10,24,34,True,6,9
7481,4,16,18,34,True,6,9
7482,5,11,14,25,True,6,9
7483,6,29,15,44,True,6,9
7484,7,40,34,74,True,6,9
7485,8,116,72,188,True,6,9
7486,9,120,104,224,True,6,9
7487,10,134,142,276,True,6,9
7488,11,188,207,395,True,6,9
7489,12,242,225,467,True,6,9
7490,13,174,234,408,True,6,9
7491,14,183,219,402,True,6,9
7492,15,178,191,369,True,6,9
7493,16,149,177,326,True,6,9
7494,17,167,168,335,True,6,9
7495,18,104,164,268,True,6,9
7496,19,83,99,182,True,6,9
7497,20,42,58,100,True,6,9
7498,21,33,48,81,True,6,9
7499,22,19,27,46,True,6,9
7500,23,13,13,26,True,6,9
7501,0,11,8,19,False,0,9
7502,1,6,12,18,False,0,9
7503,2,7,9,16,False,0,9
7504,3,17,8,25,False,0,9
7505,4,121,79,200,False,0,9
7506,5,235,166,401,False,0,9
7507,6,360,207,567,False,0,9
7508,7,264,177,441,False,0,9
7509,8,218,166,384,False,0,9
7510,9,202,167,369,False,0,9
7511,10,221,194,415,False,0,9
7512,11,222,201,423,False,0,9
7513,12,237,269,506,False,0,9
7514,13,253,297,550,False,0,9
7515,14,222,289,511,False,0,9
7516,15,200,193,393,False,0,9
7517,16,167,153,320,False,0,9
7518,17,148,145,293,False,0,9
7519,18,123,137,260,False,0,9
7520,19,97,115,212,False,0,9
7521,20,68,85,153,False,0,9
7522,21,35,39,74,False,0,9
7523,22,14,31,45,False,0,9
7524,23,15,11,26,False,0,9
7525,0,8,6,14,False,1,9
7526,1,5,8,13,False,1,9
7527,2,4,5,9,False,1,9
7528,3,14,5,19,False,1,9
7529,4,114,71,185,False,1,9
7530,5,236,174,410,False,1,9
7531,6,393,210,603,False,1,9
7532,7,251,162,413,False,1,9
7533,8,221,207,428,False,1,9
7534,9,221,185,406,False,1,9
7535,10,217,181,398,False,1,9
7536,11,219,213,432,False,1,9
7537,12,213,275,488,False,1,9
7538,13,254,304,558,False,1,9
7539,14,222,306,528,False,1,9
7540,15,239,207,446,False,1,9
7541,16,210,229,439,False,1,9
7542,17,155,195,350,False,1,9
7543,18,116,125,241,False,1,9
7544,19,91,125,216,False,1,9
7545,20,58,90,148,False,1,9
7546,21,35,41,76,False,1,9
7547,22,22,15,37,False,1,9
7548,23,13,17,30,False,1,9
7549,0,5,10,15,False,2,9
7550,1,6,10,16,False,2,9
7551,2,1,7,8,False,2,9
7552,3,21,9,30,False,2,9
7553,4,105,64,169,False,2,9
7554,5,253,158,411,False,2,9
7555,6,395,199,594,False,2,9
7556,7,287,164,451,False,2,9
7557,8,233,187,420,False,2,9
7558,9,231,206,437,False,2,9
7559,10,228,217,445,False,2,9
7560,11,251,327,578,False,2,9
7561,12,227,277,504,False,2,9
7562,13,250,329,579,False,2,9
7563,14,258,326,584,False,2,9
7564,15,223,215,438,False,2,9
7565,16,183,180,363,False,2,9
7566,17,157,169,326,False,2,9
7567,18,120,133,253,False,2,9
7568,19,109,120,229,False,2,9
7569,20,50,85,135,False,2,9
7570,21,33,43,76,False,2,9
7571,22,16,30,46,False,2,9
7572,23,14,21,35,False,2,9
7573,0,10,12,22,False,3,9
7574,1,5,14,19,False,3,9
7575,2,6,7,13,False,3,9
7576,3,15,13,28,False,3,9
7577,4,126,69,195,False,3,9
7578,5,225,176,401,False,3,9
7579,6,399,214,613,False,3,9
7580,7,262,166,428,False,3,9
7581,8,253,210,463,False,3,9
7582,9,226,171,397,False,3,9
7583,10,206,176,382,False,3,9
7584,11,222,232,454,False,3,9
7585,12,231,274,505,False,3,9
7586,13,260,331,591,False,3,9
7587,14,241,300,541,False,3,9
7588,15,217,242,459,False,3,9
7589,16,182,166,348,False,3,9
7590,17,152,206,358,False,3,9
7591,18,125,132,257,False,3,9
7592,19,95,122,217,False,3,9
7593,20,79,85,164,False,3,9
7594,21,49,67,116,False,3,9
7595,22,29,32,61,False,3,9
7596,23,11,29,40,False,3,9
7597,0,10,27,37,False,4,9
7598,1,8,31,39,False,4,9
7599,2,5,7,12,False,4,9
7600,3,18,9,27,False,4,9
7601,4,123,65,188,False,4,9
7602,5,251,161,412,False,4,9
7603,6,369,220,589,False,4,9
7604,7,309,179,488,False,4,9
7605,8,211,201,412,False,4,9
7606,9,244,191,435,False,4,9
7607,10,260,229,489,False,4,9
7608,11,232,252,484,False,4,9
7609,12,237,330,567,False,4,9
7610,13,276,373,649,False,4,9
7611,14,192,278,470,False,4,9
7612,15,184,194,378,False,4,9
7613,16,155,158,313,False,4,9
7614,17,134,145,279,False,4,9
7615,18,108,130,238,False,4,9
7616,19,90,96,186,False,4,9
7617,20,81,89,170,False,4,9
7618,21,61,70,131,False,4,9
7619,22,44,57,101,False,4,9
7620,23,32,35,67,False,4,9
7621,0,21,46,67,False,5,9
7622,1,21,46,67,False,5,9
7623,2,10,27,37,False,5,9
7624,3,11,13,24,False,5,9
7625,4,23,17,40,False,5,9
7626,5,32,21,53,False,5,9
7627,6,40,33,73,False,5,9
7628,7,94,69,163,False,5,9
7629,8,100,77,177,False,5,9
7630,9,168,117,285,False,5,9
7631,10,169,168,337,False,5,9
7632,11,204,173,377,False,5,9
7633,12,185,222,407,False,5,9
7634,13,163,238,401,False,5,9
7635,14,155,206,361,False,5,9
7636,15,136,175,311,False,5,9
7637,16,138,138,276,False,5,9
7638,17,129,128,257,False,5,9
7639,18,90,105,195,False,5,9
7640,19,65,84,149,False,5,9
7641,20,62,77,139,False,5,9
7642,21,55,71,126,False,5,9
7643,22,47,87,134,False,5,9
7644,23,42,76,118,False,5,9
7645,0,46,70,116,True,6,9
7646,1,25,59,84,True,6,9
7647,2,24,54,78,True,6,9
7648,3,15,36,51,True,6,9
7649,4,8,13,21,True,6,9
7650,5,18,14,32,True,6,9
7651,6,15,20,35,True,6,9
7652,7,33,19,52,True,6,9
7653,8,50,39,89,True,6,9
7654,9,127,88,215,True,6,9
7655,10,130,87,217,True,6,9
7656,11,172,161,333,True,6,9
7657,12,183,232,415,True,6,9
7658,13,198,221,419,True,6,9
7659,14,198,208,406,True,6,9
7660,15,184,238,422,True,6,9
7661,16,176,204,380,True,6,9
7662,17,139,159,298,True,6,9
7663,18,135,156,291,True,6,9
7664,19,112,131,243,True,6,9
7665,20,82,106,188,True,6,9
7666,21,58,79,137,True,6,9
7667,22,28,28,56,True,6,9
7668,23,16,28,44,True,6,9
7669,0,11,13,24,False,0,9
7670,1,5,7,12,False,0,9
7671,2,8,15,23,False,0,9
7672,3,3,12,15,False,0,9
7673,4,21,12,33,False,0,9
7674,5,135,78,213,False,0,9
7675,6,244,172,416,False,0,9
7676,7,382,189,571,False,0,9
7677,8,268,183,451,False,0,9
7678,9,210,170,380,False,0,9
7679,10,212,190,402,False,0,9
7680,11,220,186,406,False,0,9
7681,12,221,230,451,False,0,9
7682,13,208,294,502,False,0,9
7683,14,261,292,553,False,0,9
7684,15,239,318,557,False,0,9
7685,16,194,202,396,False,0,9
7686,17,145,156,301,False,0,9
7687,18,133,122,255,False,0,9
7688,19,95,138,233,False,0,9
7689,20,82,129,211,False,0,9
7690,21,63,90,153,False,0,9
7691,22,28,37,65,False,0,9
7692,23,16,21,37,False,0,9
7693,0,4,16,20,False,1,10
7694,1,6,6,12,False,1,10
7695,2,6,5,11,False,1,10
7696,3,6,8,14,False,1,10
7697,4,18,5,23,False,1,10
7698,5,145,98,243,False,1,10
7699,6,252,168,420,False,1,10
7700,7,379,193,572,False,1,10
7701,8,256,167,423,False,1,10
7702,9,217,191,408,False,1,10
7703,10,227,179,406,False,1,10
7704,11,219,203,422,False,1,10
7705,12,194,212,406,False,1,10
7706,13,231,280,511,False,1,10
7707,14,277,313,590,False,1,10
7708,15,260,292,552,False,1,10
7709,16,242,219,461,False,1,10
7710,17,198,164,362,False,1,10
7711,18,135,190,325,False,1,10
7712,19,112,141,253,False,1,10
7713,20,78,103,181,False,1,10
7714,21,68,96,164,False,1,10
7715,22,30,62,92,False,1,10
7716,23,13,26,39,False,1,10
7717,0,7,18,25,False,2,10
7718,1,5,13,18,False,2,10
7719,2,4,17,21,False,2,10
7720,3,7,9,16,False,2,10
7721,4,12,7,19,False,2,10
7722,5,110,67,177,False,2,10
7723,6,225,149,374,False,2,10
7724,7,384,214,598,False,2,10
7725,8,263,161,424,False,2,10
7726,9,198,181,379,False,2,10
7727,10,230,195,425,False,2,10
7728,11,201,197,398,False,2,10
7729,12,207,211,418,False,2,10
7730,13,209,242,451,False,2,10
7731,14,266,317,583,False,2,10
7732,15,232,274,506,False,2,10
7733,16,217,202,419,False,2,10
7734,17,194,183,377,False,2,10
7735,18,130,149,279,False,2,10
7736,19,107,147,254,False,2,10
7737,20,74,113,187,False,2,10
7738,21,49,129,178,False,2,10
7739,22,19,45,64,False,2,10
7740,23,18,35,53,False,2,10
7741,0,6,25,31,False,3,10
7742,1,8,11,19,False,3,10
7743,2,6,17,23,False,3,10
7744,3,7,14,21,False,3,10
7745,4,16,14,30,False,3,10
7746,5,108,70,178,False,3,10
7747,6,224,153,377,False,3,10
7748,7,371,208,579,False,3,10
7749,8,227,151,378,False,3,10
7750,9,243,198,441,False,3,10
7751,10,236,198,434,False,3,10
7752,11,225,220,445,False,3,10
7753,12,202,214,416,False,3,10
7754,13,226,241,467,False,3,10
7755,14,267,322,589,False,3,10
7756,15,246,311,557,False,3,10
7757,16,232,207,439,False,3,10
7758,17,195,187,382,False,3,10
7759,18,131,160,291,False,3,10
7760,19,110,151,261,False,3,10
7761,20,96,119,215,False,3,10
7762,21,55,65,120,False,3,10
7763,22,33,49,82,False,3,10
7764,23,23,27,50,False,3,10
7765,0,8,22,30,False,4,10
7766,1,12,38,50,False,4,10
7767,2,12,35,47,False,4,10
7768,3,5,12,17,False,4,10
7769,4,12,17,29,False,4,10
7770,5,120,76,196,False,4,10
7771,6,219,160,379,False,4,10
7772,7,396,225,621,False,4,10
7773,8,254,186,440,False,4,10
7774,9,244,163,407,False,4,10
7775,10,234,171,405,False,4,10
7776,11,201,239,440,False,4,10
7777,12,212,220,432,False,4,10
7778,13,276,291,567,False,4,10
7779,14,270,323,593,False,4,10
7780,15,228,291,519,False,4,10
7781,16,175,177,352,False,4,10
7782,17,175,162,337,False,4,10
7783,18,123,138,261,False,4,10
7784,19,79,96,175,False,4,10
7785,20,65,82,147,False,4,10
7786,21,79,70,149,False,4,10
7787,22,41,66,107,False,4,10
7788,23,35,53,88,False,4,10
7789,0,23,51,74,False,5,10
7790,1,17,58,75,False,5,10
7791,2,17,53,70,False,5,10
7792,3,15,27,42,False,5,10
7793,4,5,15,20,False,5,10
7794,5,21,15,36,False,5,10
7795,6,52,37,89,False,5,10
7796,7,68,47,115,False,5,10
7797,8,83,69,152,False,5,10
7798,9,169,107,276,False,5,10
7799,10,131,116,247,False,5,10
7800,11,180,142,322,False,5,10
7801,12,147,163,310,False,5,10
7802,13,188,207,395,False,5,10
7803,14,157,276,433,False,5,10
7804,15,144,210,354,False,5,10
7805,16,151,157,308,False,5,10
7806,17,140,134,274,False,5,10
7807,18,112,120,232,False,5,10
7808,19,78,101,179,False,5,10
7809,20,55,82,137,False,5,10
7810,21,63,74,137,False,5,10
7811,22,45,60,105,False,5,10
7812,23,35,75,110,False,5,10
7813,0,32,64,96,True,6,10
7814,1,37,67,104,True,6,10
7815,2,34,66,100,True,6,10
7816,3,20,49,69,True,6,10
7817,4,13,21,34,True,6,10
7818,5,10,16,26,True,6,10
7819,6,12,15,27,True,6,10
7820,7,23,21,44,True,6,10
7821,8,51,54,105,True,6,10
7822,9,105,60,165,True,6,10
7823,10,116,90,206,True,6,10
7824,11,177,167,344,True,6,10
7825,12,180,190,370,True,6,10
7826,13,214,186,400,True,6,10
7827,14,204,247,451,True,6,10
7828,15,189,275,464,True,6,10
7829,16,232,272,504,True,6,10
7830,17,168,164,332,True,6,10
7831,18,121,204,325,True,6,10
7832,19,211,151,362,True,6,10
7833,20,83,95,178,True,6,10
7834,21,54,62,116,True,6,10
7835,22,28,49,77,True,6,10
7836,23,6,31,37,True,6,10
7837,0,7,13,20,False,0,10
7838,1,4,11,15,False,0,10
7839,2,3,11,14,False,0,10
7840,3,4,15,19,False,0,10
7841,4,14,15,29,False,0,10
7842,5,124,76,200,False,0,10
7843,6,216,173,389,False,0,10
7844,7,401,197,598,False,0,10
7845,8,263,170,433,False,0,10
7846,9,229,190,419,False,0,10
7847,10,225,187,412,False,0,10
7848,11,240,215,455,False,0,10
7849,12,211,211,422,False,0,10
7850,13,182,292,474,False,0,10
7851,14,238,318,556,False,0,10
7852,15,242,286,528,False,0,10
7853,16,212,202,414,False,0,10
7854,17,162,165,327,False,0,10
7855,18,121,135,256,False,0,10
7856,19,114,118,232,False,0,10
7857,20,85,116,201,False,0,10
7858,21,26,97,123,False,0,10
7859,22,16,33,49,False,0,10
7860,23,7,20,27,False,0,10
7861,0,5,10,15,False,1,10
7862,1,2,10,12,False,1,10
7863,2,6,9,15,False,1,10
7864,3,4,12,16,False,1,10
7865,4,15,8,23,False,1,10
7866,5,125,72,197,False,1,10
7867,6,245,163,408,False,1,10
7868,7,396,209,605,False,1,10
7869,8,254,170,424,False,1,10
7870,9,220,178,398,False,1,10
7871,10,228,182,410,False,1,10
7872,11,214,202,416,False,1,10
7873,12,192,229,421,False,1,10
7874,13,221,283,504,False,1,10
7875,14,262,318,580,False,1,10
7876,15,223,287,510,False,1,10
7877,16,209,198,407,False,1,10
7878,17,205,177,382,False,1,10
7879,18,159,167,326,False,1,10
7880,19,110,135,245,False,1,10
7881,20,90,129,219,False,1,10
7882,21,44,79,123,False,1,10
7883,22,10,33,43,False,1,10
7884,23,9,22,31,False,1,10
7885,0,5,21,26,False,2,10
7886,1,13,18,31,False,2,10
7887,2,6,14,20,False,2,10
7888,3,4,9,13,False,2,10
7889,4,16,16,32,False,2,10
7890,5,116,73,189,False,2,10
7891,6,251,182,433,False,2,10
7892,7,378,216,594,False,2,10
7893,8,231,164,395,False,2,10
7894,9,237,169,406,False,2,10
7895,10,226,176,402,False,2,10
7896,11,85,70,155,False,2,10
7897,14,161,203,364,False,3,10
7898,15,244,316,560,False,3,10
7899,16,231,183,414,False,3,10
7900,17,189,161,350,False,3,10
7901,18,172,190,362,False,3,10
7902,19,102,144,246,False,3,10
7903,20,76,97,173,False,3,10
7904,21,67,103,170,False,3,10
7905,22,36,57,93,False,3,10
7906,23,26,28,54,False,3,10
7907,0,11,31,42,False,4,10
7908,1,6,20,26,False,4,10
7909,2,13,24,37,False,4,10
7910,3,11,21,32,False,4,10
7911,4,20,20,40,False,4,10
7912,5,95,57,152,False,4,10
7913,6,227,149,376,False,4,10
7914,7,345,201,546,False,4,10
7915,8,242,177,419,False,4,10
7916,9,238,186,424,False,4,10
7917,10,234,186,420,False,4,10
7918,11,233,207,440,False,4,10
7919,12,235,243,478,False,4,10
7920,13,248,263,511,False,4,10
7921,14,258,341,599,False,4,10
7922,15,176,254,430,False,4,10
7923,16,194,176,370,False,4,10
7924,17,165,159,324,False,4,10
7925,18,128,136,264,False,4,10
7926,19,96,91,187,False,4,10
7927,20,75,94,169,False,4,10
7928,21,61,81,142,False,4,10
7929,22,50,55,105,False,4,10
7930,23,49,75,124,False,4,10
7931,0,27,33,60,False,5,10
7932,1,36,57,93,False,5,10
7933,2,20,55,75,False,5,10
7934,3,7,31,38,False,5,10
7935,4,13,14,27,False,5,10
7936,5,31,13,44,False,5,10
7937,6,30,28,58,False,5,10
7938,7,38,42,80,False,5,10
7939,8,86,57,143,False,5,10
7940,9,135,92,227,False,5,10
7941,10,147,108,255,False,5,10
7942,11,157,128,285,False,5,10
7943,12,182,179,361,False,5,10
7944,13,142,242,384,False,5,10
7945,14,154,236,390,False,5,10
7946,15,138,182,320,False,5,10
7947,16,136,169,305,False,5,10
7948,17,146,146,292,False,5,10
7949,18,121,130,251,False,5,10
7950,19,85,97,182,False,5,10
7951,20,76,77,153,False,5,10
7952,21,52,60,112,False,5,10
7953,22,58,72,130,False,5,10
7954,23,48,71,119,False,5,10
7955,0,39,70,109,True,6,10
7956,1,37,73,110,True,6,10
7957,2,30,79,109,True,6,10
7958,3,20,47,67,True,6,10
7959,4,16,26,42,True,6,10
7960,5,11,16,27,True,6,10
7961,6,12,11,23,True,6,10
7962,7,26,19,45,True,6,10
7963,8,46,29,75,True,6,10
7964,9,129,62,191,True,6,10
7965,10,123,102,225,True,6,10
7966,11,142,158,300,True,6,10
7967,12,173,184,357,True,6,10
7968,13,194,213,407,True,6,10
7969,14,177,264,441,True,6,10
7970,15,163,223,386,True,6,10
7971,16,178,160,338,True,6,10
7972,17,163,152,315,True,6,10
7973,18,158,176,334,True,6,10
7974,19,115,150,265,True,6,10
7975,20,84,118,202,True,6,10
7976,21,71,80,151,True,6,10
7977,22,26,47,73,True,6,10
7978,23,21,19,40,True,6,10
7979,0,12,19,31,False,0,10
7980,1,8,10,18,False,0,10
7981,2,3,10,13,False,0,10
7982,3,4,8,12,False,0,10
7983,4,14,19,33,False,0,10
7984,5,130,70,200,False,0,10
7985,6,226,163,389,False,0,10
7986,7,395,210,605,False,0,10
7987,8,270,170,440,False,0,10
7988,9,204,184,388,False,0,10
7989,10,189,170,359,False,0,10
7990,11,218,200,418,False,0,10
7991,12,196,213,409,False,0,10
7992,13,194,239,433,False,0,10
7993,14,252,327,579,False,0,10
7994,15,209,317,526,False,0,10
7995,16,198,191,389,False,0,10
7996,17,157,149,306,False,0,10
7997,18,103,150,253,False,0,10
7998,19,102,110,212,False,0,10
7999,20,89,112,201,False,0,10
8000,21,61,85,146,False,0,10
8001,22,29,30,59,False,0,10
8002,23,17,23,40,False,0,10
8003,0,9,9,18,False,1,10
8004,1,6,8,14,False,1,10
8005,2,10,11,21,False,1,10
8006,3,6,10,16,False,1,10
8007,4,21,6,27,False,1,10
8008,5,113,66,179,False,1,10
8009,6,227,161,388,False,1,10
8010,7,383,207,590,False,1,10
8011,8,274,164,438,False,1,10
8012,9,205,189,394,False,1,10
8013,10,238,195,433,False,1,10
8014,11,233,209,442,False,1,10
8015,12,218,230,448,False,1,10
8016,13,202,290,492,False,1,10
8017,14,265,303,568,False,1,10
8018,15,265,318,583,False,1,10
8019,16,213,211,424,False,1,10
8020,17,183,141,324,False,1,10
8021,18,140,155,295,False,1,10
8022,19,135,163,298,False,1,10
8023,20,80,129,209,False,1,10
8024,21,63,85,148,False,1,10
8025,22,32,89,121,False,1,10
8026,23,11,39,50,False,1,10
8027,0,13,16,29,False,2,10
8028,1,8,19,27,False,2,10
8029,2,5,10,15,False,2,10
8030,3,8,10,18,False,2,10
8031,4,13,9,22,False,2,10
8032,5,107,69,176,False,2,10
8033,6,227,160,387,False,2,10
8034,7,407,202,609,False,2,10
8035,8,242,160,402,False,2,10
8036,9,232,169,401,False,2,10
8037,10,201,174,375,False,2,10
8038,11,231,196,427,False,2,10
8039,12,233,224,457,False,2,10
8040,13,215,281,496,False,2,10
8041,14,275,330,605,False,2,10
8042,15,280,299,579,False,2,10
8043,16,218,230,448,False,2,10
8044,17,167,168,335,False,2,10
8045,18,156,156,312,False,2,10
8046,19,125,139,264,False,2,10
8047,20,86,127,213,False,2,10
8048,21,79,91,170,False,2,10
8049,22,37,43,80,False,2,10
8050,23,24,25,49,False,2,10
8051,0,6,20,26,False,3,10
8052,1,10,7,17,False,3,10
8053,2,5,10,15,False,3,10
8054,3,5,10,15,False,3,10
8055,4,21,9,30,False,3,10
8056,5,112,63,175,False,3,10
8057,6,226,157,383,False,3,10
8058,7,411,204,615,False,3,10
8059,8,239,172,411,False,3,10
8060,9,247,173,420,False,3,10
8061,10,219,166,385,False,3,10
8062,11,209,219,428,False,3,10
8063,12,211,230,441,False,3,10
8064,13,240,276,516,False,3,10
8065,14,257,343,600,False,3,10
8066,15,273,332,605,False,3,10
8067,16,225,209,434,False,3,10
8068,17,186,191,377,False,3,10
8069,18,154,188,342,False,3,10
8070,19,127,138,265,False,3,10
8071,20,81,128,209,False,3,10
8072,21,69,445,514,False,3,10
8073,22,41,337,378,False,3,10
8074,23,20,171,191,False,3,10
8075,0,11,70,81,False,4,10
8076,1,8,59,67,False,4,10
8077,2,17,49,66,False,4,10
8078,3,9,43,52,False,4,10
8079,4,18,50,68,False,4,10
8080,5,122,66,188,False,4,10
8081,6,224,151,375,False,4,10
8082,7,373,209,582,False,4,10
8083,8,259,158,417,False,4,10
8084,9,206,153,359,False,4,10
8085,10,230,207,437,False,4,10
8086,11,220,227,447,False,4,10
8087,12,208,240,448,False,4,10
8088,13,238,242,480,False,4,10
8089,14,274,383,657,False,4,10
8090,15,234,315,549,False,4,10
8091,16,172,186,358,False,4,10
8092,17,148,183,331,False,4,10
8093,18,125,146,271,False,4,10
8094,19,98,95,193,False,4,10
8095,20,85,97,182,False,4,10
8096,21,63,89,152,False,4,10
8097,22,41,69,110,False,4,10
8098,23,47,69,116,False,4,10
8099,0,27,52,79,False,5,10
8100,1,26,48,74,False,5,10
8101,2,20,55,75,False,5,10
8102,3,17,46,63,False,5,10
8103,4,13,18,31,False,5,10
8104,5,32,16,48,False,5,10
8105,6,26,19,45,False,5,10
8106,7,46,50,96,False,5,10
8107,8,98,67,165,False,5,10
8108,9,123,99,222,False,5,10
8109,10,157,116,273,False,5,10
8110,11,190,159,349,False,5,10
8111,12,167,140,307,False,5,10
8112,13,157,220,377,False,5,10
8113,14,160,184,344,False,5,10
8114,15,127,176,303,False,5,10
8115,16,144,172,316,False,5,10
8116,17,146,159,305,False,5,10
8117,18,121,146,267,False,5,10
8118,19,93,84,177,False,5,10
8119,20,60,91,151,False,5,10
8120,21,47,73,120,False,5,10
8121,22,48,72,120,False,5,10
8122,23,39,66,105,False,5,10
8123,0,37,57,94,True,6,10
8124,1,25,63,88,True,6,10
8125,2,35,67,102,True,6,10
8126,3,22,58,80,True,6,10
8127,4,12,27,39,True,6,10
8128,5,22,28,50,True,6,10
8129,6,18,16,34,True,6,10
8130,7,28,26,54,True,6,10
8131,8,45,46,91,True,6,10
8132,9,94,61,155,True,6,10
8133,10,96,102,198,True,6,10
8134,11,139,152,291,True,6,10
8135,12,148,176,324,True,6,10
8136,13,173,166,339,True,6,10
8137,14,192,262,454,True,6,10
8138,15,165,199,364,True,6,10
8139,16,183,188,371,True,6,10
8140,17,161,146,307,True,6,10
8141,18,131,163,294,True,6,10
8142,19,95,148,243,True,6,10
8143,20,73,117,190,True,6,10
8144,21,54,63,117,True,6,10
8145,22,28,55,83,True,6,10
8146,23,17,24,41,True,6,10
8147,0,12,13,25,False,0,10
8148,1,8,17,25,False,0,10
8149,2,7,13,20,False,0,10
8150,3,6,10,16,False,0,10
8151,4,17,9,26,False,0,10
8152,5,125,72,197,False,0,10
8153,6,214,179,393,False,0,10
8154,7,366,209,575,False,0,10
8155,8,287,184,471,False,0,10
8156,9,228,172,400,False,0,10
8157,10,197,165,362,False,0,10
8158,11,212,186,398,False,0,10
8159,12,209,218,427,False,0,10
8160,13,199,273,472,False,0,10
8161,14,244,346,590,False,0,10
8162,15,226,313,539,False,0,10
8163,16,219,199,418,False,0,10
8164,17,157,144,301,False,0,10
8165,18,124,177,301,False,0,10
8166,19,122,132,254,False,0,10
8167,20,89,123,212,False,0,10
8168,21,51,72,123,False,0,10
8169,22,31,29,60,False,0,10
8170,23,15,18,33,False,0,10
8171,0,10,6,16,False,1,10
8172,1,5,10,15,False,1,10
8173,2,5,4,9,False,1,10
8174,3,2,7,9,False,1,10
8175,4,16,8,24,False,1,10
8176,5,107,61,168,False,1,10
8177,6,224,164,388,False,1,10
8178,7,375,235,610,False,1,10
8179,8,253,167,420,False,1,10
8180,9,217,173,390,False,1,10
8181,10,211,200,411,False,1,10
8182,11,232,217,449,False,1,10
8183,12,203,209,412,False,1,10
8184,13,218,244,462,False,1,10
8185,14,274,326,600,False,1,10
8186,15,236,325,561,False,1,10
8187,16,193,220,413,False,1,10
8188,17,204,157,361,False,1,10
8189,18,126,171,297,False,1,10
8190,19,135,120,255,False,1,10
8191,20,97,116,213,False,1,10
8192,21,72,110,182,False,1,10
8193,22,36,43,79,False,1,10
8194,23,17,23,40,False,1,10
8195,0,9,20,29,False,2,10
8196,1,7,20,27,False,2,10
8197,2,7,9,16,False,2,10
8198,3,5,10,15,False,2,10
8199,4,18,19,37,False,2,10
8200,5,107,59,166,False,2,10
8201,6,243,171,414,False,2,10
8202,7,370,230,600,False,2,10
8203,8,286,163,449,False,2,10
8204,9,214,185,399,False,2,10
8205,10,206,193,399,False,2,10
8206,11,225,201,426,False,2,10
8207,12,222,223,445,False,2,10
8208,13,203,259,462,False,2,10
8209,14,237,320,557,False,2,10
8210,15,228,259,487,False,2,10
8211,16,183,204,387,False,2,10
8212,17,172,156,328,False,2,10
8213,18,144,164,308,False,2,10
8214,19,108,145,253,False,2,10
8215,20,96,110,206,False,2,10
8216,21,65,255,320,False,2,10
8217,22,32,168,200,False,2,10
8218,23,17,69,86,False,2,10
8219,0,10,40,50,False,3,10
8220,1,13,15,28,False,3,10
8221,2,12,16,28,False,3,10
8222,3,9,17,26,False,3,10
8223,4,15,13,28,False,3,10
8224,5,105,53,158,False,3,10
8225,6,231,156,387,False,3,10
8226,7,344,220,564,False,3,10
8227,8,271,150,421,False,3,10
8228,9,230,155,385,False,3,10
8229,10,205,180,385,False,3,10
8230,11,209,182,391,False,3,10
8231,12,216,214,430,False,3,10
8232,13,196,263,459,False,3,10
8233,14,271,324,595,False,3,10
8234,15,235,331,566,False,3,10
8235,16,224,214,438,False,3,10
8236,17,165,165,330,False,3,10
8237,18,154,193,347,False,3,10
8238,19,124,112,236,False,3,10
8239,20,88,122,210,False,3,10
8240,21,59,101,160,False,3,10
8241,22,36,65,101,False,3,10
8242,23,20,31,51,False,3,10
8243,0,10,29,39,False,4,10
8244,1,18,27,45,False,4,10
8245,2,22,31,53,False,4,10
8246,3,14,20,34,False,4,10
8247,4,15,7,22,False,4,10
8248,5,105,54,159,False,4,10
8249,6,243,154,397,False,4,10
8250,7,366,229,595,False,4,10
8251,8,248,179,427,False,4,10
8252,9,214,173,387,False,4,10
8253,10,227,188,415,False,4,10
8254,11,194,229,423,False,4,10
8255,12,231,223,454,False,4,10
8256,13,294,289,583,False,4,10
8257,14,299,329,628,False,4,10
8258,15,214,275,489,False,4,10
8259,16,210,206,416,False,4,10
8260,17,184,194,378,False,4,10
8261,18,148,193,341,False,4,10
8262,19,87,117,204,False,4,10
8263,20,85,96,181,False,4,10
8264,21,59,78,137,False,4,10
8265,22,59,68,127,False,4,10
8266,23,54,63,117,False,4,10
8267,0,27,53,80,False,5,10
8268,1,21,47,68,False,5,10
8269,2,23,44,67,False,5,10
8270,3,7,34,41,False,5,10
8271,4,7,15,22,False,5,10
8272,5,23,18,41,False,5,10
8273,6,32,23,55,False,5,10
8274,7,25,28,53,False,5,10
8275,8,73,63,136,False,5,10
8276,9,122,99,221,False,5,10
8277,10,145,117,262,False,5,10
8278,11,179,166,345,False,5,10
8279,12,171,165,336,False,5,10
8280,13,196,172,368,False,5,10
8281,14,264,232,496,False,5,10
8282,15,247,167,414,False,5,10
8283,16,169,432,601,False,5,10
8284,17,126,207,333,False,5,10
8285,18,112,131,243,False,5,10
8286,19,84,120,204,False,5,10
8287,20,56,81,137,False,5,10
8288,21,55,69,124,False,5,10
8289,22,42,64,106,False,5,10
8290,23,53,71,124,False,5,10
8291,0,28,55,83,True,6,10
8292,1,30,75,105,True,6,10
8293,2,30,61,91,True,6,10
8294,3,21,45,66,True,6,10
8295,4,25,23,48,True,6,10
8296,5,10,18,28,True,6,10
8297,6,10,17,27,True,6,10
8298,7,28,20,48,True,6,10
8299,8,41,38,79,True,6,10
8300,9,111,62,173,True,6,10
8301,10,114,101,215,True,6,10
8302,11,149,178,327,True,6,10
8303,12,162,156,318,True,6,10
8304,13,184,195,379,True,6,10
8305,14,178,254,432,True,6,10
8306,15,157,206,363,True,6,10
8307,16,182,195,377,True,6,10
8308,17,146,178,324,True,6,10
8309,18,130,154,284,True,6,10
8310,19,125,174,299,True,6,10
8311,20,55,111,166,True,6,10
8312,21,54,80,134,True,6,10
8313,22,32,41,73,True,6,10
8314,23,13,25,38,True,6,10
8315,0,8,16,24,False,0,10
8316,1,7,12,19,False,0,10
8317,2,11,16,27,False,0,10
8318,3,6,9,15,False,0,10
8319,4,19,15,34,False,0,10
8320,5,105,73,178,False,0,10
8321,6,219,141,360,False,0,10
8322,7,377,193,570,False,0,10
8323,8,261,181,442,False,0,10
8324,9,241,199,440,False,0,10
8325,10,197,159,356,False,0,10
8326,11,202,214,416,False,0,10
8327,12,210,191,401,False,0,10
8328,13,188,265,453,False,0,10
8329,14,255,302,557,False,0,10
8330,15,212,296,508,False,0,10
8331,16,205,214,419,False,0,10
8332,17,177,147,324,False,0,10
8333,18,137,134,271,False,0,10
8334,19,121,133,254,False,0,10
8335,20,95,106,201,False,0,10
8336,21,62,78,140,False,0,10
8337,22,23,35,58,False,0,10
8338,23,18,23,41,False,0,10
8339,0,14,14,28,False,1,10
8340,1,4,9,13,False,1,10
8341,2,7,13,20,False,1,10
8342,3,9,8,17,False,1,10
8343,4,16,16,32,False,1,10
8344,5,112,72,184,False,1,10
8345,6,229,146,375,False,1,10
8346,7,371,207,578,False,1,10
8347,8,275,174,449,False,1,10
8348,9,186,196,382,False,1,10
8349,10,246,193,439,False,1,10
8350,11,214,184,398,False,1,10
8351,12,242,226,468,False,1,10
8352,13,231,256,487,False,1,10
8353,14,261,336,597,False,1,10
8354,15,259,313,572,False,1,10
8355,16,216,228,444,False,1,10
8356,17,171,169,340,False,1,10
8357,18,141,142,283,False,1,10
8358,19,110,143,253,False,1,10
8359,20,70,117,187,False,1,10
8360,21,55,77,132,False,1,10
8361,22,31,47,78,False,1,10
8362,23,17,22,39,False,1,10
8363,0,9,18,27,False,2,10
8364,1,7,20,27,False,2,10
8365,2,2,15,17,False,2,10
8366,3,5,8,13,False,2,10
8367,4,18,14,32,False,2,10
8368,5,116,71,187,False,2,10
8369,6,213,165,378,False,2,10
8370,7,403,223,626,False,2,10
8371,8,254,162,416,False,2,10
8372,9,179,179,358,False,2,10
8373,10,232,178,410,False,2,10
8374,11,193,191,384,False,2,10
8375,12,201,195,396,False,2,10
8376,13,220,275,495,False,2,10
8377,14,279,325,604,False,2,10
8378,15,259,300,559,False,2,10
8379,16,223,224,447,False,2,10
8380,17,160,167,327,False,2,10
8381,18,148,159,307,False,2,10
8382,19,110,162,272,False,2,10
8383,20,100,129,229,False,2,10
8384,21,76,96,172,False,2,10
8385,22,38,62,100,False,2,10
8386,23,23,44,67,False,2,10
8387,0,17,18,35,False,3,11
8388,1,9,17,26,False,3,11
8389,2,6,10,16,False,3,11
8390,3,7,18,25,False,3,11
8391,4,16,13,29,False,3,11
8392,5,107,77,184,False,3,11
8393,6,217,160,377,False,3,11
8394,7,402,208,610,False,3,11
8395,8,260,168,428,False,3,11
8396,9,228,223,451,False,3,11
8397,10,201,158,359,False,3,11
8398,11,196,195,391,False,3,11
8399,12,242,232,474,False,3,11
8400,13,234,261,495,False,3,11
8401,14,287,364,651,False,3,11
8402,15,224,307,531,False,3,11
8403,16,209,238,447,False,3,11
8404,17,208,189,397,False,3,11
8405,18,156,158,314,False,3,11
8406,19,113,151,264,False,3,11
8407,20,101,136,237,False,3,11
8408,21,43,78,121,False,3,11
8409,22,27,61,88,False,3,11
8410,23,18,35,53,False,3,11
8411,0,11,27,38,False,4,11
8412,1,10,20,30,False,4,11
8413,2,5,21,26,False,4,11
8414,3,5,19,24,False,4,11
8415,4,10,12,22,False,4,11
8416,5,88,71,159,False,4,11
8417,6,211,155,366,False,4,11
8418,7,366,183,549,False,4,11
8419,8,238,158,396,False,4,11
8420,9,234,186,420,False,4,11
8421,10,235,198,433,False,4,11
8422,11,244,235,479,False,4,11
8423,12,260,246,506,False,4,11
8424,13,268,263,531,False,4,11
8425,14,261,391,652,False,4,11
8426,15,238,270,508,False,4,11
8427,16,207,207,414,False,4,11
8428,17,185,198,383,False,4,11
8429,18,154,186,340,False,4,11
8430,19,95,138,233,False,4,11
8431,20,68,94,162,False,4,11
8432,21,52,82,134,False,4,11
8433,22,57,77,134,False,4,11
8434,23,36,62,98,False,4,11
8435,0,38,53,91,False,5,11
8436,1,35,39,74,False,5,11
8437,2,23,59,82,False,5,11
8438,3,5,31,36,False,5,11
8439,4,12,16,28,False,5,11
8440,5,28,14,42,False,5,11
8441,6,34,19,53,False,5,11
8442,7,54,31,85,False,5,11
8443,8,75,56,131,False,5,11
8444,9,130,85,215,False,5,11
8445,10,163,122,285,False,5,11
8446,11,171,145,316,False,5,11
8447,12,184,191,375,False,5,11
8448,13,186,203,389,False,5,11
8449,14,161,212,373,False,5,11
8450,15,154,192,346,False,5,11
8451,16,167,222,389,False,5,11
8452,17,135,175,310,False,5,11
8453,18,117,123,240,False,5,11
8454,19,93,95,188,False,5,11
8455,20,61,95,156,False,5,11
8456,21,60,62,122,False,5,11
8457,22,39,69,108,False,5,11
8458,23,33,67,100,False,5,11
8459,0,44,51,95,True,6,11
8460,1,28,57,85,True,6,11
8461,2,39,58,97,True,6,11
8462,3,21,53,74,True,6,11
8463,4,19,32,51,True,6,11
8464,5,18,12,30,True,6,11
8465,6,19,17,36,True,6,11
8466,7,36,20,56,True,6,11
8467,8,33,31,64,True,6,11
8468,9,114,66,180,True,6,11
8469,10,111,97,208,True,6,11
8470,11,156,161,317,True,6,11
8471,12,172,179,351,True,6,11
8472,13,188,153,341,True,6,11
8473,14,167,199,366,True,6,11
8474,15,197,239,436,True,6,11
8475,16,150,192,342,True,6,11
8476,17,148,189,337,True,6,11
8477,18,134,163,297,True,6,11
8478,19,116,179,295,True,6,11
8479,20,73,109,182,True,6,11
8480,21,59,67,126,True,6,11
8481,22,34,60,94,True,6,11
8482,23,10,28,38,True,6,11
8483,0,13,19,32,False,0,11
8484,1,9,12,21,False,0,11
8485,2,5,11,16,False,0,11
8486,3,7,5,12,False,0,11
8487,4,14,17,31,False,0,11
8488,5,116,69,185,False,0,11
8489,6,236,141,377,False,0,11
8490,7,401,195,596,False,0,11
8491,8,259,166,425,False,0,11
8492,9,191,169,360,False,0,11
8493,10,219,174,393,False,0,11
8494,11,202,196,398,False,0,11
8495,12,240,199,439,False,0,11
8496,13,182,248,430,False,0,11
8497,14,246,346,592,False,0,11
8498,15,218,285,503,False,0,11
8499,16,212,200,412,False,0,11
8500,17,162,170,332,False,0,11
8501,18,121,154,275,False,0,11
8502,19,101,125,226,False,0,11
8503,20,77,111,188,False,0,11
8504,21,74,83,157,False,0,11
8505,22,32,38,70,False,0,11
8506,23,17,29,46,False,0,11
8507,0,14,18,32,False,1,11
8508,1,14,13,27,False,1,11
8509,2,8,10,18,False,1,11
8510,3,10,13,23,False,1,11
8511,4,14,10,24,False,1,11
8512,5,103,64,167,False,1,11
8513,6,210,151,361,False,1,11
8514,7,420,200,620,False,1,11
8515,8,266,155,421,False,1,11
8516,9,203,181,384,False,1,11
8517,10,198,190,388,False,1,11
8518,11,220,209,429,False,1,11
8519,12,201,192,393,False,1,11
8520,13,250,262,512,False,1,11
8521,14,257,297,554,False,1,11
8522,15,222,281,503,False,1,11
8523,16,201,211,412,False,1,11
8524,17,218,196,414,False,1,11
8525,18,161,161,322,False,1,11
8526,19,113,151,264,False,1,11
8527,20,73,121,194,False,1,11
8528,21,68,106,174,False,1,11
8529,22,47,91,138,False,1,11
8530,23,16,27,43,False,1,11
8531,0,14,11,25,False,2,11
8532,1,8,11,19,False,2,11
8533,2,8,17,25,False,2,11
8534,3,4,7,11,False,2,11
8535,4,17,13,30,False,2,11
8536,5,108,62,170,False,2,11
8537,6,261,168,429,False,2,11
8538,7,394,237,631,False,2,11
8539,8,244,167,411,False,2,11
8540,9,217,171,388,False,2,11
8541,10,204,222,426,False,2,11
8542,11,215,202,417,False,2,11
8543,12,205,234,439,False,2,11
8544,13,229,284,513,False,2,11
8545,14,279,316,595,False,2,11
8546,15,288,321,609,False,2,11
8547,16,229,214,443,False,2,11
8548,17,178,170,348,False,2,11
8549,18,160,161,321,False,2,11
8550,19,122,151,273,False,2,11
8551,20,95,117,212,False,2,11
8552,21,84,102,186,False,2,11
8553,22,41,59,100,False,2,11
8554,23,22,34,56,False,2,11
8555,0,11,11,22,False,3,11
8556,1,10,16,26,False,3,11
8557,2,8,13,21,False,3,11
8558,3,8,16,24,False,3,11
8559,4,24,9,33,False,3,11
8560,5,108,68,176,False,3,11
8561,6,243,148,391,False,3,11
8562,7,377,215,592,False,3,11
8563,8,284,204,488,False,3,11
8564,9,208,189,397,False,3,11
8565,10,244,200,444,False,3,11
8566,11,220,211,431,False,3,11
8567,12,212,207,419,False,3,11
8568,13,211,232,443,False,3,11
8569,14,262,340,602,False,3,11
8570,15,231,287,518,False,3,11
8571,16,194,215,409,False,3,11
8572,17,170,154,324,False,3,11
8573,18,138,191,329,False,3,11
8574,19,102,131,233,False,3,11
8575,20,87,117,204,False,3,11
8576,21,68,113,181,False,3,11
8577,22,46,64,110,False,3,11
8578,23,29,32,61,False,3,11
8579,0,7,31,38,False,4,11
8580,1,15,35,50,False,4,11
8581,2,14,26,40,False,4,11
8582,3,10,11,21,False,4,11
8583,4,18,12,30,False,4,11
8584,5,113,62,175,False,4,11
8585,6,222,149,371,False,4,11
8586,7,369,202,571,False,4,11
8587,8,233,181,414,False,4,11
8588,9,239,177,416,False,4,11
8589,10,227,178,405,False,4,11
8590,11,272,232,504,False,4,11
8591,12,224,250,474,False,4,11
8592,13,234,311,545,False,4,11
8593,14,313,384,697,False,4,11
8594,15,237,305,542,False,4,11
8595,16,198,203,401,False,4,11
8596,17,154,179,333,False,4,11
8597,18,138,155,293,False,4,11
8598,19,91,124,215,False,4,11
8599,20,59,78,137,False,4,11
8600,21,55,81,136,False,4,11
8601,22,54,69,123,False,4,11
8602,23,50,57,107,False,4,11
8603,0,29,48,77,False,5,11
8604,1,29,52,81,False,5,11
8605,2,24,44,68,False,5,11
8606,3,12,29,41,False,5,11
8607,4,9,21,30,False,5,11
8608,5,20,15,35,False,5,11
8609,6,30,18,48,False,5,11
8610,7,40,34,74,False,5,11
8611,8,74,50,124,False,5,11
8612,9,108,86,194,False,5,11
8613,10,152,126,278,False,5,11
8614,11,187,155,342,False,5,11
8615,12,240,212,452,False,5,11
8616,13,217,231,448,False,5,11
8617,14,174,230,404,False,5,11
8618,15,131,179,310,False,5,11
8619,16,163,205,368,False,5,11
8620,17,158,174,332,False,5,11
8621,18,110,137,247,False,5,11
8622,19,94,96,190,False,5,11
8623,20,52,85,137,False,5,11
8624,21,69,69,138,False,5,11
8625,22,35,80,115,False,5,11
8626,23,46,68,114,False,5,11
8627,0,47,53,100,True,6,11
8628,1,36,63,99,True,6,11
8629,2,27,50,77,True,6,11
8630,3,22,47,69,True,6,11
8631,4,17,32,49,True,6,11
8632,5,21,23,44,True,6,11
8633,6,14,14,28,True,6,11
8634,7,31,16,47,True,6,11
8635,8,49,29,78,True,6,11
8636,9,114,50,164,True,6,11
8637,10,109,88,197,True,6,11
8638,11,149,126,275,True,6,11
8639,12,178,190,368,True,6,11
8640,13,188,209,397,True,6,11
8641,14,163,184,347,True,6,11
8642,15,145,220,365,True,6,11
8643,16,173,180,353,True,6,11
8644,17,138,166,304,True,6,11
8645,18,128,181,309,True,6,11
8646,19,105,146,251,True,6,11
8647,20,83,118,201,True,6,11
8648,21,64,67,131,True,6,11
8649,22,46,44,90,True,6,11
8650,23,21,28,49,True,6,11
8651,0,14,14,28,False,0,11
8652,1,11,15,26,False,0,11
8653,2,7,8,15,False,0,11
8654,3,5,10,15,False,0,11
8655,4,13,19,32,False,0,11
8656,5,114,67,181,False,0,11
8657,6,241,156,397,False,0,11
8658,7,381,181,562,False,0,11
8659,8,287,172,459,False,0,11
8660,9,221,154,375,False,0,11
8661,10,236,183,419,False,0,11
8662,11,204,208,412,False,0,11
8663,12,238,229,467,False,0,11
8664,13,209,283,492,False,0,11
8665,14,293,316,609,False,0,11
8666,15,235,360,595,False,0,11
8667,16,197,205,402,False,0,11
8668,17,165,155,320,False,0,11
8669,18,119,125,244,False,0,11
8670,19,100,122,222,False,0,11
8671,20,72,110,182,False,0,11
8672,21,82,91,173,False,0,11
8673,22,52,67,119,False,0,11
8674,23,14,26,40,False,0,11
8675,0,6,18,24,False,1,11
8676,1,9,9,18,False,1,11
8677,2,8,13,21,False,1,11
8678,3,7,10,17,False,1,11
8679,4,23,15,38,False,1,11
8680,5,117,47,164,False,1,11
8681,6,230,155,385,False,1,11
8682,7,368,177,545,False,1,11
8683,8,296,197,493,False,1,11
8684,9,222,173,395,False,1,11
8685,10,203,181,384,False,1,11
8686,11,206,209,415,False,1,11
8687,12,203,201,404,False,1,11
8688,13,224,278,502,False,1,11
8689,14,267,308,575,False,1,11
8690,15,230,323,553,False,1,11
8691,16,162,202,364,False,1,11
8692,17,149,167,316,False,1,11
8693,18,149,135,284,False,1,11
8694,19,112,148,260,False,1,11
8695,20,103,157,260,False,1,11
8696,21,77,79,156,False,1,11
8697,22,32,50,82,False,1,11
8698,23,21,26,47,False,1,11
8699,0,10,16,26,False,2,11
8700,1,9,17,26,False,2,11
8701,2,8,19,27,False,2,11
8702,3,6,13,19,False,2,11
8703,4,19,16,35,False,2,11
8704,5,107,56,163,False,2,11
8705,6,222,136,358,False,2,11
8706,7,438,199,637,False,2,11
8707,8,540,210,750,False,2,11
8708,9,290,223,513,False,2,11
8709,10,230,170,400,False,2,11
8710,11,249,197,446,False,2,11
8711,12,238,214,452,False,2,11
8712,13,198,279,477,False,2,11
8713,14,238,283,521,False,2,11
8714,15,261,297,558,False,2,11
8715,16,184,236,420,False,2,11
8716,17,151,177,328,False,2,11
8717,18,144,190,334,False,2,11
8718,19,122,146,268,False,2,11
8719,20,83,118,201,False,2,11
8720,21,61,80,141,False,2,11
8721,22,45,53,98,False,2,11
8722,23,28,30,58,False,2,11
8723,0,14,23,37,False,3,11
8724,1,7,22,29,False,3,11
8725,2,11,19,30,False,3,11
8726,3,9,12,21,False,3,11
8727,4,21,20,41,False,3,11
8728,5,104,57,161,False,3,11
8729,6,257,168,425,False,3,11
8730,7,410,198,608,False,3,11
8731,8,254,189,443,False,3,11
8732,9,242,204,446,False,3,11
8733,10,205,190,395,False,3,11
8734,11,248,220,468,False,3,11
8735,12,231,221,452,False,3,11
8736,13,253,314,567,False,3,11
8737,14,290,392,682,False,3,11
8738,15,259,314,573,False,3,11
8739,16,222,217,439,False,3,11
8740,17,153,156,309,False,3,11
8741,18,144,154,298,False,3,11
8742,19,122,147,269,False,3,11
8743,20,97,149,246,False,3,11
8744,21,65,89,154,False,3,11
8745,22,43,64,107,False,3,11
8746,23,34,40,74,False,3,11
8747,0,17,32,49,False,4,11
8748,1,23,37,60,False,4,11
8749,2,14,33,47,False,4,11
8750,3,10,17,27,False,4,11
8751,4,25,21,46,False,4,11
8752,5,106,58,164,False,4,11
8753,6,228,141,369,False,4,11
8754,7,333,206,539,False,4,11
8755,8,270,175,445,False,4,11
8756,9,223,166,389,False,4,11
8757,10,249,204,453,False,4,11
8758,11,235,236,471,False,4,11
8759,12,236,261,497,False,4,11
8760,13,267,312,579,False,4,11
8761,14,306,345,651,False,4,11
8762,15,239,281,520,False,4,11
8763,16,196,223,419,False,4,11
8764,17,188,182,370,False,4,11
8765,18,144,194,338,False,4,11
8766,19,104,129,233,False,4,11
8767,20,76,86,162,False,4,11
8768,21,68,101,169,False,4,11
8769,22,50,87,137,False,4,11
8770,23,45,81,126,False,4,11
8771,0,34,52,86,False,5,11
8772,1,26,51,77,False,5,11
8773,2,28,65,93,False,5,11
8774,3,14,36,50,False,5,11
8775,4,20,16,36,False,5,11
8776,5,18,21,39,False,5,11
8777,6,35,28,63,False,5,11
8778,7,31,31,62,False,5,11
8779,8,65,41,106,False,5,11
8780,9,114,93,207,False,5,11
8781,10,141,112,253,False,5,11
8782,11,195,165,360,False,5,11
8783,12,188,188,376,False,5,11
8784,13,211,228,439,False,5,11
8785,14,201,272,473,False,5,11
8786,15,157,248,405,False,5,11
8787,16,154,188,342,False,5,11
8788,17,160,224,384,False,5,11
8789,18,123,149,272,False,5,11
8790,19,85,110,195,False,5,11
8791,20,64,92,156,False,5,11
8792,21,47,86,133,False,5,11
8793,22,36,72,108,False,5,11
8794,23,41,62,103,False,5,11
8795,0,35,46,81,True,6,11
8796,1,31,56,87,True,6,11
8797,2,23,42,65,True,6,11
8798,3,17,34,51,True,6,11
8799,4,15,24,39,True,6,11
8800,5,10,17,27,True,6,11
8801,6,20,19,39,True,6,11
8802,7,33,15,48,True,6,11
8803,8,38,28,66,True,6,11
8804,9,85,55,140,True,6,11
8805,10,141,119,260,True,6,11
8806,11,164,164,328,True,6,11
8807,12,187,160,347,True,6,11
8808,13,213,162,375,True,6,11
8809,14,180,239,419,True,6,11
8810,15,170,246,416,True,6,11
8811,16,169,151,320,True,6,11
8812,17,132,201,333,True,6,11
8813,18,151,163,314,True,6,11
8814,19,102,182,284,True,6,11
8815,20,89,107,196,True,6,11
8816,21,56,84,140,True,6,11
8817,22,39,53,92,True,6,11
8818,23,18,18,36,True,6,11
8819,0,9,24,33,False,0,11
8820,1,7,13,20,False,0,11
8821,2,12,19,31,False,0,11
8822,3,6,16,22,False,0,11
8823,4,18,14,32,False,0,11
8824,5,129,58,187,False,0,11
8825,6,198,164,362,False,0,11
8826,7,376,194,570,False,0,11
8827,8,257,182,439,False,0,11
8828,9,239,152,391,False,0,11
8829,10,219,195,414,False,0,11
8830,11,253,232,485,False,0,11
8831,12,230,222,452,False,0,11
8832,13,245,287,532,False,0,11
8833,14,273,344,617,False,0,11
8834,15,267,284,551,False,0,11
8835,16,205,187,392,False,0,11
8836,17,145,175,320,False,0,11
8837,18,130,186,316,False,0,11
8838,19,124,151,275,False,0,11
8839,20,84,112,196,False,0,11
8840,21,61,73,134,False,0,11
8841,22,44,60,104,False,0,11
8842,23,15,32,47,False,0,11
8843,0,14,22,36,False,1,11
8844,1,15,18,33,False,1,11
8845,2,16,23,39,False,1,11
8846,3,5,9,14,False,1,11
8847,4,20,10,30,False,1,11
8848,5,106,61,167,False,1,11
8849,6,242,175,417,False,1,11
8850,7,286,168,454,False,1,11
8851,8,270,187,457,False,1,11
8852,9,238,169,407,False,1,11
8853,10,237,224,461,False,1,11
8854,11,252,260,512,False,1,11
8855,12,233,243,476,False,1,11
8856,13,249,275,524,False,1,11
8857,14,289,337,626,False,1,11
8858,15,245,273,518,False,1,11
8859,16,191,210,401,False,1,11
8860,17,150,158,308,False,1,11
8861,18,140,196,336,False,1,11
8862,19,113,160,273,False,1,11
8863,20,98,117,215,False,1,11
8864,21,60,92,152,False,1,11
8865,22,38,49,87,False,1,11
8866,23,26,30,56,False,1,11
8867,0,17,20,37,False,2,11
8868,1,9,20,29,False,2,11
8869,2,6,15,21,False,2,11
8870,3,10,12,22,False,2,11
8871,4,15,14,29,False,2,11
8872,5,92,52,144,False,2,11
8873,6,230,145,375,False,2,11
8874,7,285,165,450,False,2,11
8875,8,240,161,401,False,2,11
8876,9,226,166,392,False,2,11
8877,10,232,192,424,False,2,11
8878,11,249,240,489,False,2,11
8879,12,249,259,508,False,2,11
8880,13,250,300,550,False,2,11
8881,14,267,374,641,False,2,11
8882,15,228,302,530,False,2,11
8883,16,160,194,354,False,2,11
8884,17,148,168,316,False,2,11
8885,18,125,171,296,False,2,11
8886,19,119,123,242,False,2,11
8887,20,85,117,202,False,2,11
8888,21,75,190,265,False,2,11
8889,22,62,97,159,False,2,11
8890,23,38,55,93,False,2,11
8891,0,26,17,43,False,3,11
8892,1,14,21,35,False,3,11
8893,2,13,26,39,False,3,11
8894,3,4,13,17,False,3,11
8895,4,16,8,24,False,3,11
8896,5,99,51,150,False,3,11
8897,6,215,124,339,False,3,11
8898,7,242,145,387,False,3,11
8899,8,260,168,428,False,3,11
8900,9,227,138,365,False,3,11
8901,10,266,234,500,False,3,11
8902,11,248,248,496,False,3,11
8903,12,245,273,518,False,3,11
8904,13,228,314,542,False,3,11
8905,14,376,467,843,False,3,11
8906,15,341,545,886,False,3,11
8907,16,242,323,565,False,3,11
8908,17,148,177,325,False,3,11
8909,18,140,156,296,False,3,11
8910,19,107,137,244,False,3,11
8911,20,83,97,180,False,3,11
8912,21,67,97,164,False,3,11
8913,22,42,60,102,False,3,11
8914,23,27,30,57,False,3,11
8915,0,17,26,43,False,4,11
8916,1,14,25,39,False,4,11
8917,2,10,19,29,False,4,11
8918,3,6,8,14,False,4,11
8919,4,13,12,25,False,4,11
8920,5,74,38,112,False,4,11
8921,6,154,95,249,False,4,11
8922,7,154,102,256,False,4,11
8923,8,138,126,264,False,4,11
8924,9,203,167,370,False,4,11
8925,10,213,191,404,False,4,11
8926,11,232,224,456,False,4,11
8927,12,223,264,487,False,4,11
8928,13,223,273,496,False,4,11
8929,14,193,252,445,False,4,11
8930,15,161,190,351,False,4,11
8931,16,153,145,298,False,4,11
8932,17,115,113,228,False,4,11
8933,18,108,120,228,False,4,11
8934,19,89,78,167,False,4,11
8935,20,86,90,176,False,4,11
8936,21,49,46,95,False,4,11
8937,22,39,46,85,False,4,11
8938,23,24,31,55,False,4,11
8939,0,19,38,57,False,5,11
8940,1,9,17,26,False,5,11
8941,2,4,8,12,False,5,11
8942,3,7,12,19,False,5,11
8943,4,7,6,13,False,5,11
8944,5,15,13,28,False,5,11
8945,6,24,18,42,False,5,11
8946,7,16,31,47,False,5,11
8947,8,25,42,67,False,5,11
8948,9,75,85,160,False,5,11
8949,10,111,131,242,False,5,11
8950,11,172,127,299,False,5,11
8951,12,136,174,310,False,5,11
8952,13,151,140,291,False,5,11
8953,14,157,125,282,False,5,11
8954,15,134,174,308,False,5,11
8955,16,83,107,190,False,5,11
8956,17,53,47,100,False,5,11
8957,18,25,36,61,False,5,11
8958,19,58,38,96,False,5,11
8959,20,40,52,92,False,5,11
8960,21,71,97,168,False,5,11
8961,22,80,59,139,False,5,11
8962,23,56,74,130,False,5,11
8963,0,30,39,69,True,6,11
8964,1,13,14,27,True,6,11
8965,2,7,11,18,True,6,11
8966,3,7,8,15,True,6,11
8967,4,4,3,7,True,6,11
8968,5,11,10,21,True,6,11
8969,6,14,14,28,True,6,11
8970,7,9,8,17,True,6,11
8971,8,16,12,28,True,6,11
8972,9,25,20,45,True,6,11
8973,10,34,38,72,True,6,11
8974,11,69,75,144,True,6,11
8975,12,85,89,174,True,6,11
8976,13,96,113,209,True,6,11
8977,14,96,123,219,True,6,11
8978,15,91,127,218,True,6,11
8979,16,104,81,185,True,6,11
8980,17,86,74,160,True,6,11
8981,18,94,75,169,True,6,11
8982,19,87,81,168,True,6,11
8983,20,74,88,162,True,6,11
8984,21,60,75,135,True,6,11
8985,22,39,45,84,True,6,11
8986,23,24,26,50,True,6,11
8987,0,16,35,51,True,0,11
8988,1,12,21,33,True,0,11
8989,2,9,23,32,True,0,11
8990,3,6,13,19,True,0,11
8991,4,7,12,19,True,0,11
8992,5,14,15,29,True,0,11
8993,6,19,17,36,True,0,11
8994,7,10,12,22,True,0,11
8995,8,20,24,44,True,0,11
8996,9,35,28,63,True,0,11
8997,10,72,70,142,True,0,11
8998,11,92,88,180,True,0,11
8999,12,84,95,179,True,0,11
9000,13,138,144,282,True,0,11
9001,14,104,142,246,True,0,11
9002,15,109,104,213,True,0,11
9003,16,89,93,182,True,0,11
9004,17,88,137,225,True,0,11
9005,18,104,220,324,True,0,11
9006,19,109,209,318,True,0,11
9007,20,71,165,236,True,0,11
9008,21,53,126,179,True,0,11
9009,22,38,50,88,True,0,11
9010,23,20,51,71,True,0,11
9011,0,24,27,51,True,1,11
9012,1,9,43,52,True,1,11
9013,2,22,35,57,True,1,11
9014,3,15,26,41,True,1,11
9015,4,15,25,40,True,1,11
9016,5,47,31,78,True,1,11
9017,6,71,57,128,True,1,11
9018,7,72,67,139,True,1,11
9019,8,107,60,167,True,1,11
9020,9,135,88,223,True,1,11
9021,10,123,131,254,True,1,11
9022,11,154,130,284,True,1,11
9023,12,152,157,309,True,1,11
9024,13,168,167,335,True,1,11
9025,14,130,215,345,True,1,11
9026,15,116,155,271,True,1,11
9027,16,117,119,236,True,1,11
9028,17,119,95,214,True,1,11
9029,18,74,126,200,True,1,11
9030,19,79,80,159,True,1,11
9031,20,62,69,131,True,1,11
9032,21,56,61,117,True,1,11
9033,22,33,53,86,True,1,11
9034,23,25,39,64,True,1,11
9035,0,13,30,43,True,2,11
9036,1,10,18,28,True,2,11
9037,2,10,9,19,True,2,11
9038,3,4,16,20,True,2,11
9039,4,7,14,21,True,2,11
9040,5,43,21,64,True,2,11
9041,6,78,59,137,True,2,11
9042,7,102,63,165,True,2,11
9043,8,100,80,180,True,2,11
9044,9,132,89,221,True,2,11
9045,10,155,121,276,True,2,11
9046,11,180,146,326,True,2,11
9047,12,164,167,331,True,2,11
9048,13,163,183,346,True,2,11
9049,14,159,173,332,True,2,11
9050,15,139,183,322,True,2,11
9051,16,118,141,259,True,2,11
9052,17,121,118,239,True,2,11
9053,18,97,151,248,True,2,11
9054,19,81,87,168,True,2,11
9055,20,74,86,160,True,2,11
9056,21,53,74,127,True,2,11
9057,22,37,65,102,True,2,11
9058,23,21,41,62,True,2,11
9059,0,18,36,54,True,3,11
9060,1,11,22,33,True,3,11
9061,2,10,21,31,True,3,11
9062,3,13,20,33,True,3,11
9063,4,13,6,19,True,3,11
9064,5,46,27,73,True,3,11
9065,6,78,65,143,True,3,11
9066,7,100,73,173,True,3,11
9067,8,109,71,180,True,3,11
9068,9,120,92,212,True,3,11
9069,10,155,114,269,True,3,11
9070,11,160,143,303,True,3,11
9071,12,168,164,332,True,3,11
9072,13,173,198,371,True,3,11
9073,14,173,198,371,True,3,11
9074,15,151,203,354,True,3,11
9075,16,104,148,252,True,3,11
9076,17,121,98,219,True,3,11
9077,18,76,130,206,True,3,11
9078,19,86,94,180,True,3,11
9079,20,67,86,153,True,3,11
9080,21,50,67,117,True,3,11
9081,22,37,44,81,True,3,11
9082,23,22,40,62,True,3,11
9083,0,18,29,47,True,4,11
9084,1,9,20,29,True,4,11
9085,2,8,20,28,True,4,11
9086,3,17,17,34,True,4,11
9087,4,9,11,20,True,4,11
9088,5,49,26,75,True,4,11
9089,6,71,50,121,True,4,11
9090,7,82,76,158,True,4,11
9091,8,114,63,177,True,4,11
9092,9,123,84,207,True,4,11
9093,10,126,97,223,True,4,11
9094,11,174,150,324,True,4,11
9095,12,173,168,341,True,4,11
9096,13,150,147,297,True,4,11
9097,14,155,156,311,True,4,11
9098,15,142,164,306,True,4,11
9099,16,125,140,265,True,4,11
9100,17,107,110,217,True,4,11
9101,18,74,92,166,True,4,11
9102,19,88,91,179,True,4,11
9103,20,58,70,128,True,4,11
9104,21,52,72,124,True,4,11
9105,22,43,62,105,True,4,11
9106,23,22,45,67,True,4,11
9107,0,17,24,41,True,5,11
9108,1,12,34,46,True,5,11
9109,2,14,34,48,True,5,11
9110,3,8,18,26,True,5,11
9111,4,10,9,19,True,5,11
9112,5,19,15,34,True,5,11
9113,6,16,19,35,True,5,11
9114,7,25,17,42,True,5,11
9115,8,26,25,51,True,5,11
9116,9,48,48,96,True,5,11
9117,10,75,60,135,True,5,11
9118,11,100,103,203,True,5,11
9119,12,108,134,242,True,5,11
9120,13,126,134,260,True,5,11
9121,14,119,125,244,True,5,11
9122,15,105,95,200,True,5,11
9123,16,106,121,227,True,5,11
9124,17,104,124,228,True,5,11
9125,18,79,91,170,True,5,11
9126,19,70,77,147,True,5,11
9127,20,65,65,130,True,5,11
9128,21,70,73,143,True,5,11
9129,22,53,49,102,True,5,11
9130,23,47,95,142,True,5,11
9131,0,66,65,131,True,6,0
9132,1,39,62,101,True,6,0
9133,2,54,60,114,True,6,0
9134,3,32,45,77,True,6,0
9135,4,36,40,76,True,6,0
9136,5,23,37,60,True,6,0
9137,6,14,20,34,True,6,0
9138,7,10,13,23,True,6,0
9139,8,13,17,30,True,6,0
9140,9,44,37,81,True,6,0
9141,10,28,39,67,True,6,0
9142,11,57,64,121,True,6,0
9143,12,77,71,148,True,6,0
9144,13,121,131,252,True,6,0
9145,14,123,132,255,True,6,0
9146,15,119,136,255,True,6,0
9147,16,113,136,249,True,6,0
9148,17,119,98,217,True,6,0
9149,18,100,124,224,True,6,0
9150,19,97,106,203,True,6,0
9151,20,62,77,139,True,6,0
9152,21,55,65,120,True,6,0
9153,22,28,30,58,True,6,0
9154,23,18,16,34,True,6,0
9155,0,9,7,16,False,0,0
9156,1,4,9,13,False,0,0
9157,2,9,17,26,False,0,0
9158,3,7,10,17,False,0,0
9159,4,11,16,27,False,0,0
9160,5,90,52,142,False,0,0
9161,6,200,115,315,False,0,0
9162,7,307,160,467,False,0,0
9163,8,204,113,317,False,0,0
9164,9,149,123,272,False,0,0
9165,10,143,117,260,False,0,0
9166,11,139,145,284,False,0,0
9167,12,149,161,310,False,0,0
9168,13,168,208,376,False,0,0
9169,14,209,290,499,False,0,0
9170,15,178,248,426,False,0,0
9171,16,125,138,263,False,0,0
9172,17,118,120,238,False,0,0
9173,18,107,118,225,False,0,0
9174,19,94,96,190,False,0,0
9175,20,73,94,167,False,0,0
9176,21,44,49,93,False,0,0
9177,22,20,32,52,False,0,0
9178,23,15,16,31,False,0,0
9179,0,10,19,29,False,1,0
9180,1,6,10,16,False,1,0
9181,2,8,9,17,False,1,0
9182,3,4,7,11,False,1,0
9183,4,16,11,27,False,1,0
9184,5,79,51,130,False,1,0
9185,6,231,146,377,False,1,0
9186,7,330,166,496,False,1,0
9187,8,227,154,381,False,1,0
9188,9,179,165,344,False,1,0
9189,10,163,161,324,False,1,0
9190,11,192,164,356,False,1,0
9191,12,182,196,378,False,1,0
9192,13,195,232,427,False,1,0
9193,14,244,279,523,False,1,0
9194,15,204,259,463,False,1,0
9195,16,166,166,332,False,1,0
9196,17,142,121,263,False,1,0
9197,18,114,113,227,False,1,0
9198,19,101,129,230,False,1,0
9199,20,84,116,200,False,1,0
9200,21,56,65,121,False,1,0
9201,22,29,36,65,False,1,0
9202,23,18,24,42,False,1,0
9203,0,8,18,26,False,2,0
9204,1,7,12,19,False,2,0
9205,2,5,7,12,False,2,0
9206,3,4,10,14,False,2,0
9207,4,14,7,21,False,2,0
9208,5,83,53,136,False,2,0
9209,6,265,145,410,False,2,0
9210,7,328,178,506,False,2,0
9211,8,208,149,357,False,2,0
9212,9,186,141,327,False,2,0
9213,10,191,177,368,False,2,0
9214,11,190,173,363,False,2,0
9215,12,173,182,355,False,2,0
9216,13,181,222,403,False,2,0
9217,14,239,284,523,False,2,0
9218,15,197,263,460,False,2,0
9219,16,157,176,333,False,2,0
9220,17,137,139,276,False,2,0
9221,18,109,109,218,False,2,0
9222,19,102,96,198,False,2,0
9223,20,75,95,170,False,2,0
9224,21,53,60,113,False,2,0
9225,22,37,87,124,False,2,0
9226,23,21,49,70,False,2,0
9227,0,19,21,40,False,3,0
9228,1,9,12,21,False,3,0
9229,2,5,10,15,False,3,0
9230,3,4,21,25,False,3,0
9231,4,12,5,17,False,3,0
9232,5,92,52,144,False,3,0
9233,6,229,147,376,False,3,0
9234,7,332,161,493,False,3,0
9235,8,215,152,367,False,3,0
9236,9,195,156,351,False,3,0
9237,10,201,145,346,False,3,0
9238,11,172,177,349,False,3,0
9239,12,190,204,394,False,3,0
9240,13,207,226,433,False,3,0
9241,14,243,316,559,False,3,0
9242,15,218,273,491,False,3,0
9243,16,175,196,371,False,3,0
9244,17,147,158,305,False,3,0
9245,18,124,163,287,False,3,0
9246,19,83,118,201,False,3,0
9247,20,68,100,168,False,3,0
9248,21,61,69,130,False,3,0
9249,22,36,34,70,False,3,0
9250,23,20,20,40,False,3,0
9251,0,20,23,43,False,4,0
9252,1,5,22,27,False,4,0
9253,2,9,19,28,False,4,0
9254,3,4,10,14,False,4,0
9255,4,12,13,25,False,4,0
9256,5,98,57,155,False,4,0
9257,6,240,162,402,False,4,0
9258,7,353,166,519,False,4,0
9259,8,226,141,367,False,4,0
9260,9,186,165,351,False,4,0
9261,10,211,174,385,False,4,0
9262,11,217,204,421,False,4,0
9263,12,200,228,428,False,4,0
9264,13,255,273,528,False,4,0
9265,14,274,332,606,False,4,0
9266,15,200,296,496,False,4,0
9267,16,136,159,295,False,4,0
9268,17,124,141,265,False,4,0
9269,18,121,127,248,False,4,0
9270,19,103,105,208,False,4,0
9271,20,61,70,131,False,4,0
9272,21,49,84,133,False,4,0
9273,22,43,52,95,False,4,0
9274,23,30,59,89,False,4,0
9275,0,30,50,80,False,5,0
9276,1,20,33,53,False,5,0
9277,2,12,47,59,False,5,0
9278,3,14,28,42,False,5,0
9279,4,13,14,27,False,5,0
9280,5,17,25,42,False,5,0
9281,6,29,21,50,False,5,0
9282,7,38,26,64,False,5,0
9283,8,77,36,113,False,5,0
9284,9,101,64,165,False,5,0
9285,10,121,94,215,False,5,0
9286,11,116,149,265,False,5,0
9287,12,147,159,306,False,5,0
9288,13,171,184,355,False,5,0
9289,14,154,185,339,False,5,0
9290,15,120,166,286,False,5,0
9291,16,118,144,262,False,5,0
9292,17,119,142,261,False,5,0
9293,18,120,151,271,False,5,0
9294,19,92,101,193,False,5,0
9295,20,62,72,134,False,5,0
9296,21,47,70,117,False,5,0
9297,22,41,61,102,False,5,0
9298,23,38,57,95,False,5,0
9299,0,38,55,93,True,6,0
9300,1,32,36,68,True,6,0
9301,2,25,54,79,True,6,0
9302,3,11,36,47,True,6,0
9303,4,12,25,37,True,6,0
9304,5,17,8,25,True,6,0
9305,6,13,18,31,True,6,0
9306,7,31,14,45,True,6,0
9307,8,58,30,88,True,6,0
9308,9,84,33,117,True,6,0
9309,10,95,75,170,True,6,0
9310,11,122,142,264,True,6,0
9311,12,137,133,270,True,6,0
9312,13,184,178,362,True,6,0
9313,14,155,177,332,True,6,0
9314,15,132,196,328,True,6,0
9315,16,165,141,306,True,6,0
9316,17,159,175,334,True,6,0
9317,18,170,149,319,True,6,0
9318,19,109,153,262,True,6,0
9319,20,78,100,178,True,6,0
9320,21,49,63,112,True,6,0
9321,22,34,40,74,True,6,0
9322,23,24,26,50,True,6,0
9323,0,12,20,32,False,0,0
9324,1,3,10,13,False,0,0
9325,2,7,12,19,False,0,0
9326,3,4,11,15,False,0,0
9327,4,17,9,26,False,0,0
9328,5,110,60,170,False,0,0
9329,6,261,160,421,False,0,0
9330,7,408,209,617,False,0,0
9331,8,254,168,422,False,0,0
9332,9,205,165,370,False,0,0
9333,10,218,184,402,False,0,0
9334,11,194,212,406,False,0,0
9335,12,205,202,407,False,0,0
9336,13,232,261,493,False,0,0
9337,14,240,320,560,False,0,0
9338,15,226,321,547,False,0,0
9339,16,186,194,380,False,0,0
9340,17,171,151,322,False,0,0
9341,18,138,150,288,False,0,0
9342,19,113,119,232,False,0,0
9343,20,78,115,193,False,0,0
9344,21,57,73,130,False,0,0
9345,22,24,35,59,False,0,0
9346,23,27,21,48,False,0,0
9347,0,10,18,28,False,1,0
9348,1,5,13,18,False,1,0
9349,2,9,7,16,False,1,0
9350,3,6,7,13,False,1,0
9351,4,17,12,29,False,1,0
9352,5,119,48,167,False,1,0
9353,6,247,150,397,False,1,0
9354,7,382,204,586,False,1,0
9355,8,227,163,390,False,1,0
9356,9,203,161,364,False,1,0
9357,10,217,176,393,False,1,0
9358,11,198,224,422,False,1,0
9359,12,220,206,426,False,1,0
9360,13,202,252,454,False,1,0
9361,14,243,327,570,False,1,0
9362,15,199,284,483,False,1,0
9363,16,193,183,376,False,1,0
9364,17,154,149,303,False,1,0
9365,18,133,116,249,False,1,0
9366,19,102,127,229,False,1,0
9367,20,84,117,201,False,1,0
9368,21,67,67,134,False,1,0
9369,22,24,51,75,False,1,0
9370,23,15,20,35,False,1,0
9371,0,11,18,29,False,2,0
9372,1,7,17,24,False,2,0
9373,2,5,6,11,False,2,0
9374,3,5,14,19,False,2,0
9375,4,18,14,32,False,2,0
9376,5,104,60,164,False,2,0
9377,6,244,155,399,False,2,0
9378,7,347,195,542,False,2,0
9379,8,243,150,393,False,2,0
9380,9,199,160,359,False,2,0
9381,10,225,188,413,False,2,0
9382,11,196,199,395,False,2,0
9383,12,207,223,430,False,2,0
9384,13,236,251,487,False,2,0
9385,14,240,285,525,False,2,0
9386,15,224,304,528,False,2,0
9387,16,193,186,379,False,2,0
9388,17,152,146,298,False,2,0
9389,18,99,133,232,False,2,0
9390,19,105,131,236,False,2,0
9391,20,92,117,209,False,2,0
9392,21,66,85,151,False,2,0
9393,22,31,135,166,False,2,0
9394,23,17,50,67,False,2,0
9395,0,13,19,32,False,3,0
9396,1,7,14,21,False,3,0
9397,2,6,18,24,False,3,0
9398,3,6,17,23,False,3,0
9399,4,13,10,23,False,3,0
9400,5,114,54,168,False,3,0
9401,6,251,162,413,False,3,0
9402,7,379,177,556,False,3,0
9403,8,244,161,405,False,3,0
9404,9,248,160,408,False,3,0
9405,10,204,234,438,False,3,0
9406,11,205,218,423,False,3,0
9407,12,209,204,413,False,3,0
9408,13,203,257,460,False,3,0
9409,14,248,331,579,False,3,0
9410,15,213,307,520,False,3,0
9411,16,191,216,407,False,3,0
9412,17,165,149,314,False,3,0
9413,18,146,133,279,False,3,0
9414,19,91,128,219,False,3,0
9415,20,96,139,235,False,3,0
9416,21,69,107,176,False,3,0
9417,22,38,55,93,False,3,0
9418,23,24,31,55,False,3,0
9419,0,14,35,49,False,4,0
9420,1,13,26,39,False,4,0
9421,2,6,21,27,False,4,0
9422,3,14,20,34,False,4,0
9423,4,12,14,26,False,4,0
9424,5,93,58,151,False,4,0
9425,6,249,176,425,False,4,0
9426,7,354,166,520,False,4,0
9427,8,226,156,382,False,4,0
9428,9,216,150,366,False,4,0
9429,10,193,180,373,False,4,0
9430,11,197,217,414,False,4,0
9431,12,210,224,434,False,4,0
9432,13,240,278,518,False,4,0
9433,14,263,337,600,False,4,0
9434,15,181,280,461,False,4,0
9435,16,186,188,374,False,4,0
9436,17,136,134,270,False,4,0
9437,18,106,130,236,False,4,0
9438,19,81,108,189,False,4,0
9439,20,65,88,153,False,4,0
9440,21,63,84,147,False,4,0
9441,22,53,64,117,False,4,0
9442,23,48,54,102,False,4,0
9443,0,35,57,92,False,5,0
9444,1,25,49,74,False,5,0
9445,2,23,49,72,False,5,0
9446,3,15,38,53,False,5,0
9447,4,15,20,35,False,5,0
9448,5,27,20,47,False,5,0
9449,6,34,25,59,False,5,0
9450,7,41,39,80,False,5,0
9451,8,51,54,105,False,5,0
9452,9,93,79,172,False,5,0
9453,10,134,79,213,False,5,0
9454,11,132,148,280,False,5,0
9455,12,128,159,287,False,5,0
9456,13,139,160,299,False,5,0
9457,14,155,153,308,False,5,0
9458,15,139,138,277,False,5,0
9459,16,131,144,275,False,5,0
9460,17,121,97,218,False,5,0
9461,18,120,133,253,False,5,0
9462,19,58,85,143,False,5,0
9463,20,46,66,112,False,5,0
9464,21,63,65,128,False,5,0
9465,22,43,64,107,False,5,0
9466,23,50,64,114,False,5,0
9467,0,31,74,105,True,6,0
9468,1,37,59,96,True,6,0
9469,2,26,74,100,True,6,0
9470,3,19,61,80,True,6,0
9471,4,9,27,36,True,6,0
9472,5,20,24,44,True,6,0
9473,6,16,22,38,True,6,0
9474,7,23,18,41,True,6,0
9475,8,37,38,75,True,6,0
9476,9,76,47,123,True,6,0
9477,10,91,79,170,True,6,0
9478,11,120,109,229,True,6,0
9479,12,119,169,288,True,6,0
9480,13,145,153,298,True,6,0
9481,14,152,201,353,True,6,0
9482,15,140,223,363,True,6,0
9483,16,142,159,301,True,6,0
9484,17,146,116,262,True,6,0
9485,18,137,153,290,True,6,0
9486,19,110,135,245,True,6,0
9487,20,85,105,190,True,6,0
9488,21,38,96,134,True,6,0
9489,22,35,45,80,True,6,0
9490,23,13,26,39,True,6,0
9491,0,13,24,37,False,0,0
9492,1,8,18,26,False,0,0
9493,2,11,12,23,False,0,0
9494,3,5,20,25,False,0,0
9495,4,14,9,23,False,0,0
9496,5,94,63,157,False,0,0
9497,6,260,161,421,False,0,0
9498,7,346,191,537,False,0,0
9499,8,260,171,431,False,0,0
9500,9,206,185,391,False,0,0
9501,10,210,167,377,False,0,0
9502,11,195,212,407,False,0,0
9503,12,188,203,391,False,0,0
9504,13,199,250,449,False,0,0
9505,14,233,325,558,False,0,0
9506,15,226,295,521,False,0,0
9507,16,167,190,357,False,0,0
9508,17,152,151,303,False,0,0
9509,18,104,129,233,False,0,0
9510,19,118,107,225,False,0,0
9511,20,79,113,192,False,0,0
9512,21,54,70,124,False,0,0
9513,22,29,38,67,False,0,0
9514,23,11,16,27,False,0,0
9515,0,11,16,27,False,1,0
9516,1,8,12,20,False,1,0
9517,2,13,9,22,False,1,0
9518,3,6,11,17,False,1,0
9519,4,21,10,31,False,1,0
9520,5,110,65,175,False,1,0
9521,6,229,161,390,False,1,0
9522,7,373,190,563,False,1,0
9523,8,270,134,404,False,1,0
9524,9,224,198,422,False,1,0
9525,10,205,190,395,False,1,0
9526,11,191,181,372,False,1,0
9527,12,212,186,398,False,1,0
9528,13,216,252,468,False,1,0
9529,14,251,326,577,False,1,0
9530,15,209,307,516,False,1,0
9531,16,215,219,434,False,1,0
9532,17,197,159,356,False,1,0
9533,18,132,161,293,False,1,0
9534,19,99,131,230,False,1,0
9535,20,68,114,182,False,1,0
9536,21,61,83,144,False,1,0
9537,22,47,37,84,False,1,0
9538,23,14,26,40,False,1,0
9539,0,12,14,26,False,2,0
9540,1,7,13,20,False,2,0
9541,2,7,25,32,False,2,0
9542,3,5,11,16,False,2,0
9543,4,12,10,22,False,2,0
9544,5,108,64,172,False,2,0
9545,6,245,163,408,False,2,0
9546,7,367,215,582,False,2,0
9547,8,243,149,392,False,2,0
9548,9,186,153,339,False,2,0
9549,10,219,181,400,False,2,0
9550,11,193,195,388,False,2,0
9551,12,205,211,416,False,2,0
9552,13,198,251,449,False,2,0
9553,14,282,299,581,False,2,0
9554,15,221,298,519,False,2,0
9555,16,172,198,370,False,2,0
9556,17,194,138,332,False,2,0
9557,18,133,150,283,False,2,0
9558,19,88,114,202,False,2,0
9559,20,92,137,229,False,2,0
9560,21,76,60,136,False,2,0
9561,22,30,42,72,False,2,0
9562,23,20,18,38,False,2,0
9563,0,8,18,26,False,3,0
9564,1,10,14,24,False,3,0
9565,2,8,16,24,False,3,0
9566,3,11,7,18,False,3,0
9567,4,18,5,23,False,3,0
9568,5,113,64,177,False,3,0
9569,6,221,158,379,False,3,0
9570,7,396,199,595,False,3,0
9571,8,235,173,408,False,3,0
9572,9,224,181,405,False,3,0
9573,10,223,206,429,False,3,0
9574,11,174,190,364,False,3,0
9575,12,185,184,369,False,3,0
9576,13,215,262,477,False,3,0
9577,14,290,322,612,False,3,0
9578,15,224,295,519,False,3,0
9579,16,192,223,415,False,3,0
9580,17,182,172,354,False,3,0
9581,18,139,152,291,False,3,0
9582,19,112,109,221,False,3,0
9583,20,76,134,210,False,3,0
9584,21,60,76,136,False,3,0
9585,22,44,50,94,False,3,0
9586,23,16,32,48,False,3,0
9587,0,9,30,39,False,4,0
9588,1,15,30,45,False,4,0
9589,2,16,30,46,False,4,0
9590,3,4,18,22,False,4,0
9591,4,18,11,29,False,4,0
9592,5,103,60,163,False,4,0
9593,6,232,144,376,False,4,0
9594,7,364,191,555,False,4,0
9595,8,242,132,374,False,4,0
9596,9,226,173,399,False,4,0
9597,10,202,198,400,False,4,0
9598,11,194,209,403,False,4,0
9599,12,233,238,471,False,4,0
9600,13,245,298,543,False,4,0
9601,14,310,364,674,False,4,0
9602,15,231,297,528,False,4,0
9603,16,156,188,344,False,4,0
9604,17,141,155,296,False,4,0
9605,18,105,129,234,False,4,0
9606,19,76,100,176,False,4,0
9607,20,91,90,181,False,4,0
9608,21,52,66,118,False,4,0
9609,22,51,55,106,False,4,0
9610,23,31,65,96,False,4,0
9611,0,23,48,71,False,5,0
9612,1,28,53,81,False,5,0
9613,2,21,52,73,False,5,0
9614,3,11,19,30,False,5,0
9615,4,9,12,21,False,5,0
9616,5,25,15,40,False,5,0
9617,6,26,20,46,False,5,0
9618,7,44,33,77,False,5,0
9619,8,51,42,93,False,5,0
9620,9,102,68,170,False,5,0
9621,10,123,105,228,False,5,0
9622,11,151,134,285,False,5,0
9623,12,184,160,344,False,5,0
9624,13,151,202,353,False,5,0
9625,14,159,190,349,False,5,0
9626,15,136,165,301,False,5,0
9627,16,116,149,265,False,5,0
9628,17,143,138,281,False,5,0
9629,18,106,134,240,False,5,0
9630,19,64,102,166,False,5,0
9631,20,61,86,147,False,5,0
9632,21,60,62,122,False,5,0
9633,22,64,60,124,False,5,0
9634,23,45,63,108,False,5,0
9635,0,34,44,78,True,6,0
9636,1,35,78,113,True,6,0
9637,2,36,70,106,True,6,0
9638,3,22,40,62,True,6,0
9639,4,17,24,41,True,6,0
9640,5,14,15,29,True,6,0
9641,6,17,17,34,True,6,0
9642,7,24,15,39,True,6,0
9643,8,40,47,87,True,6,0
9644,9,90,43,133,True,6,0
9645,10,97,73,170,True,6,0
9646,11,134,127,261,True,6,0
9647,12,149,174,323,True,6,0
9648,13,178,205,383,True,6,0
9649,14,162,222,384,True,6,0
9650,15,133,215,348,True,6,0
9651,16,141,154,295,True,6,0
9652,17,139,142,281,True,6,0
9653,18,142,153,295,True,6,0
9654,19,118,164,282,True,6,0
9655,20,72,94,166,True,6,0
9656,21,51,63,114,True,6,0
9657,22,32,42,74,True,6,0
9658,23,20,27,47,True,6,0
9659,0,13,14,27,False,0,0
9660,1,5,16,21,False,0,0
9661,2,7,10,17,False,0,0
9662,3,6,12,18,False,0,0
9663,4,13,15,28,False,0,0
9664,5,120,72,192,False,0,0
9665,6,253,137,390,False,0,0
9666,7,364,189,553,False,0,0
9667,8,278,151,429,False,0,0
9668,9,214,164,378,False,0,0
9669,10,207,175,382,False,0,0
9670,11,220,185,405,False,0,0
9671,12,181,207,388,False,0,0
9672,13,210,228,438,False,0,0
9673,14,243,306,549,False,0,0
9674,15,238,309,547,False,0,0
9675,16,200,180,380,False,0,0
9676,17,175,141,316,False,0,0
9677,18,112,157,269,False,0,0
9678,19,106,140,246,False,0,0
9679,20,72,96,168,False,0,0
9680,21,65,69,134,False,0,0
9681,22,35,48,83,False,0,0
9682,23,12,18,30,False,0,0
9683,0,8,14,22,False,1,0
9684,1,10,10,20,False,1,0
9685,2,7,7,14,False,1,0
9686,3,8,9,17,False,1,0
9687,4,18,13,31,False,1,0
9688,5,122,65,187,False,1,0
9689,6,268,157,425,False,1,0
9690,7,379,185,564,False,1,0
9691,8,251,162,413,False,1,0
9692,9,240,217,457,False,1,0
9693,10,226,194,420,False,1,0
9694,11,185,206,391,False,1,0
9695,12,198,206,404,False,1,0
9696,13,208,261,469,False,1,0
9697,14,255,318,573,False,1,0
9698,15,224,369,593,False,1,0
9699,16,183,183,366,False,1,0
9700,17,193,136,329,False,1,0
9701,18,154,145,299,False,1,0
9702,19,106,156,262,False,1,0
9703,20,79,92,171,False,1,0
9704,21,66,74,140,False,1,0
9705,22,28,37,65,False,1,0
9706,23,17,28,45,False,1,0
9707,0,5,20,25,False,2,0
9708,1,5,17,22,False,2,0
9709,2,9,18,27,False,2,0
9710,3,3,16,19,False,2,0
9711,4,21,12,33,False,2,0
9712,5,120,60,180,False,2,0
9713,6,247,141,388,False,2,0
9714,7,388,203,591,False,2,0
9715,8,251,151,402,False,2,0
9716,9,187,177,364,False,2,0
9717,10,203,189,392,False,2,0
9718,11,197,172,369,False,2,0
9719,12,189,202,391,False,2,0
9720,13,236,263,499,False,2,0
9721,14,248,317,565,False,2,0
9722,15,231,309,540,False,2,0
9723,16,179,199,378,False,2,0
9724,17,176,171,347,False,2,0
9725,18,136,132,268,False,2,0
9726,19,103,124,227,False,2,0
9727,20,103,131,234,False,2,0
9728,21,62,102,164,False,2,0
9729,22,33,128,161,False,2,0
9730,23,24,26,50,False,2,0
9731,0,16,14,30,False,3,0
9732,1,10,23,33,False,3,0
9733,2,9,10,19,False,3,0
9734,3,9,13,22,False,3,0
9735,4,17,15,32,False,3,0
9736,5,108,66,174,False,3,0
9737,6,243,146,389,False,3,0
9738,7,379,207,586,False,3,0
9739,8,261,176,437,False,3,0
9740,9,229,194,423,False,3,0
9741,10,201,180,381,False,3,0
9742,11,232,223,455,False,3,0
9743,12,180,207,387,False,3,0
9744,13,220,287,507,False,3,0
9745,14,277,323,600,False,3,0
9746,15,236,339,575,False,3,0
9747,16,192,218,410,False,3,0
9748,17,194,172,366,False,3,0
9749,18,156,173,329,False,3,0
9750,19,98,169,267,False,3,0
9751,20,72,115,187,False,3,0
9752,21,58,83,141,False,3,0
9753,22,34,43,77,False,3,0
9754,23,20,33,53,False,3,0
9755,0,10,22,32,False,4,0
9756,1,13,31,44,False,4,0
9757,2,7,27,34,False,4,0
9758,3,8,12,20,False,4,0
9759,4,14,17,31,False,4,0
9760,5,108,65,173,False,4,0
9761,6,218,147,365,False,4,0
9762,7,357,193,550,False,4,0
9763,8,259,174,433,False,4,0
9764,9,197,172,369,False,4,0
9765,10,243,179,422,False,4,0
9766,11,214,196,410,False,4,0
9767,12,242,219,461,False,4,0
9768,13,242,327,569,False,4,0
9769,14,280,365,645,False,4,0
9770,15,202,287,489,False,4,0
9771,16,146,191,337,False,4,0
9772,17,151,152,303,False,4,0
9773,18,108,129,237,False,4,0
9774,19,93,109,202,False,4,0
9775,20,63,84,147,False,4,0
9776,21,57,67,124,False,4,0
9777,22,49,80,129,False,4,0
9778,23,40,49,89,False,4,0
9779,0,33,43,76,False,5,0
9780,1,30,51,81,False,5,0
9781,2,19,51,70,False,5,0
9782,3,13,28,41,False,5,0
9783,4,13,19,32,False,5,0
9784,5,21,16,37,False,5,0
9785,6,30,25,55,False,5,0
9786,7,35,29,64,False,5,0
9787,8,63,59,122,False,5,0
9788,9,102,79,181,False,5,0
9789,10,122,111,233,False,5,0
9790,11,167,131,298,False,5,0
9791,12,143,147,290,False,5,0
9792,13,156,198,354,False,5,0
9793,14,150,204,354,False,5,0
9794,15,138,160,298,False,5,0
9795,16,130,153,283,False,5,0
9796,17,158,136,294,False,5,0
9797,18,93,119,212,False,5,0
9798,19,64,88,152,False,5,0
9799,20,49,67,116,False,5,0
9800,21,42,61,103,False,5,0
9801,22,44,76,120,False,5,0
9802,23,53,59,112,False,5,0
9803,0,33,73,106,True,6,0
9804,1,25,65,90,True,6,0
9805,2,33,75,108,True,6,0
9806,3,20,48,68,True,6,0
9807,4,14,27,41,True,6,0
9808,5,15,15,30,True,6,0
9809,6,21,17,38,True,6,0
9810,7,36,18,54,True,6,0
9811,8,47,38,85,True,6,0
9812,9,95,54,149,True,6,0
9813,10,105,71,176,True,6,0
9814,11,143,125,268,True,6,0
9815,12,138,213,351,True,6,0
9816,13,180,184,364,True,6,0
9817,14,146,211,357,True,6,0
9818,15,130,206,336,True,6,0
9819,16,155,163,318,True,6,0
9820,17,109,122,231,True,6,0
9821,18,136,159,295,True,6,0
9822,19,103,140,243,True,6,0
9823,20,82,127,209,True,6,0
9824,21,42,51,93,True,6,0
9825,22,24,42,66,True,6,0
9826,23,17,20,37,True,6,0
9827,0,12,16,28,False,0,0
9828,1,9,6,15,False,0,0
9829,2,5,13,18,False,0,0
9830,3,5,10,15,False,0,0
9831,4,14,15,29,False,0,0
9832,5,108,57,165,False,0,0
9833,6,233,176,409,False,0,0
9834,7,331,203,534,False,0,0
9835,8,236,135,371,False,0,0
9836,9,197,179,376,False,0,0
9837,10,194,152,346,False,0,0
9838,11,183,161,344,False,0,0
9839,12,180,200,380,False,0,0
9840,13,193,239,432,False,0,0
9841,14,242,305,547,False,0,0
9842,15,207,279,486,False,0,0
9843,16,207,223,430,False,0,0
9844,17,165,138,303,False,0,0
9845,18,132,135,267,False,0,0
9846,19,113,149,262,False,0,0
9847,20,92,113,205,False,0,0
9848,21,51,77,128,False,0,0
9849,22,34,47,81,False,0,0
9850,23,17,21,38,False,0,0
9851,0,14,16,30,False,1,0
9852,1,9,13,22,False,1,0
9853,2,6,11,17,False,1,0
9854,3,7,12,19,False,1,0
9855,4,18,10,28,False,1,0
9856,5,102,53,155,False,1,0
9857,6,239,161,400,False,1,0
9858,7,352,179,531,False,1,0
9859,8,239,188,427,False,1,0
9860,9,220,186,406,False,1,0
9861,10,231,208,439,False,1,0
9862,11,187,181,368,False,1,0
9863,12,223,206,429,False,1,0
9864,13,188,222,410,False,1,0
9865,14,249,353,602,False,1,0
9866,15,198,321,519,False,1,0
9867,16,174,207,381,False,1,0
9868,17,194,181,375,False,1,0
9869,18,160,130,290,False,1,0
9870,19,120,137,257,False,1,0
9871,20,84,113,197,False,1,0
9872,21,53,84,137,False,1,0
9873,22,39,44,83,False,1,0
9874,23,10,38,48,False,1,0
9875,0,12,32,44,False,2,1
9876,1,14,28,42,False,2,1
9877,2,9,19,28,False,2,1
9878,3,12,14,26,False,2,1
9879,4,15,11,26,False,2,1
9880,5,105,64,169,False,2,1
9881,6,232,156,388,False,2,1
9882,7,369,199,568,False,2,1
9883,8,261,150,411,False,2,1
9884,9,154,153,307,False,2,1
9885,10,183,165,348,False,2,1
9886,11,192,192,384,False,2,1
9887,12,210,208,418,False,2,1
9888,13,212,257,469,False,2,1
9889,14,232,320,552,False,2,1
9890,15,215,309,524,False,2,1
9891,16,169,191,360,False,2,1
9892,17,173,152,325,False,2,1
9893,18,119,146,265,False,2,1
9894,19,120,115,235,False,2,1
9895,20,91,117,208,False,2,1
9896,21,55,82,137,False,2,1
9897,22,37,48,85,False,2,1
9898,23,19,24,43,False,2,1
9899,0,10,17,27,False,3,1
9900,1,11,15,26,False,3,1
9901,2,8,10,18,False,3,1
9902,3,2,7,9,False,3,1
9903,4,17,7,24,False,3,1
9904,5,103,59,162,False,3,1
9905,6,115,140,255,False,3,1
9906,7,169,213,382,False,3,1
9907,8,65,181,246,False,3,1
9908,9,88,220,308,False,3,1
9909,10,212,187,399,False,3,1
9910,11,222,188,410,False,3,1
9911,12,123,223,346,False,3,1
9912,13,66,260,326,False,3,1
9913,14,204,405,609,False,3,1
9914,15,179,472,651,False,3,1
9915,16,139,234,373,False,3,1
9916,17,168,159,327,False,3,1
9917,18,146,169,315,False,3,1
9918,19,92,137,229,False,3,1
9919,20,67,113,180,False,3,1
9920,21,56,80,136,False,3,1
9921,22,29,58,87,False,3,1
9922,23,21,22,43,False,3,1
9923,0,17,21,38,False,4,1
9924,1,9,22,31,False,4,1
9925,2,9,28,37,False,4,1
9926,3,7,17,24,False,4,1
9927,4,17,12,29,False,4,1
9928,5,107,52,159,False,4,1
9929,6,219,145,364,False,4,1
9930,7,269,162,431,False,4,1
9931,8,241,151,392,False,4,1
9932,9,212,174,386,False,4,1
9933,10,214,194,408,False,4,1
9934,11,211,223,434,False,4,1
9935,12,238,238,476,False,4,1
9936,13,246,312,558,False,4,1
9937,14,288,360,648,False,4,1
9938,15,194,272,466,False,4,1
9939,16,180,190,370,False,4,1
9940,17,138,142,280,False,4,1
9941,18,129,136,265,False,4,1
9942,19,73,98,171,False,4,1
9943,20,76,99,175,False,4,1
9944,21,47,60,107,False,4,1
9945,22,44,66,110,False,4,1
9946,23,32,57,89,False,4,1
9947,0,20,35,55,False,5,1
9948,1,22,46,68,False,5,1
9949,2,17,63,80,False,5,1
9950,3,11,28,39,False,5,1
9951,4,11,17,28,False,5,1
9952,5,20,17,37,False,5,1
9953,6,26,18,44,False,5,1
9954,7,32,28,60,False,5,1
9955,8,63,43,106,False,5,1
9956,9,116,88,204,False,5,1
9957,10,122,120,242,False,5,1
9958,11,140,126,266,False,5,1
9959,12,151,149,300,False,5,1
9960,13,144,147,291,False,5,1
9961,14,119,153,272,False,5,1
9962,15,138,169,307,False,5,1
9963,16,112,132,244,False,5,1
9964,17,130,138,268,False,5,1
9965,18,96,93,189,False,5,1
9966,19,71,81,152,False,5,1
9967,20,46,71,117,False,5,1
9968,21,33,56,89,False,5,1
9969,22,34,72,106,False,5,1
9970,23,32,68,100,False,5,1
9971,0,36,60,96,True,6,1
9972,1,27,65,92,True,6,1
9973,2,28,48,76,True,6,1
9974,3,21,43,64,True,6,1
9975,4,15,33,48,True,6,1
9976,5,16,14,30,True,6,1
9977,6,19,17,36,True,6,1
9978,7,22,12,34,True,6,1
9979,8,47,30,77,True,6,1
9980,9,76,63,139,True,6,1
9981,10,91,67,158,True,6,1
9982,11,126,140,266,True,6,1
9983,12,118,164,282,True,6,1
9984,13,179,189,368,True,6,1
9985,14,154,192,346,True,6,1
9986,15,158,212,370,True,6,1
9987,16,169,173,342,True,6,1
9988,17,151,149,300,True,6,1
9989,18,123,154,277,True,6,1
9990,19,97,174,271,True,6,1
9991,20,76,94,170,True,6,1
9992,21,55,57,112,True,6,1
9993,22,36,35,71,True,6,1
9994,23,20,23,43,True,6,1
9995,0,7,22,29,False,0,1
9996,1,6,15,21,False,0,1
9997,2,5,11,16,False,0,1
9998,3,5,16,21,False,0,1
9999,4,19,8,27,False,0,1
10000,5,108,65,173,False,0,1
10001,6,225,144,369,False,0,1
10002,7,401,203,604,False,0,1
10003,8,249,167,416,False,0,1
10004,9,231,173,404,False,0,1
10005,10,194,188,382,False,0,1
10006,11,184,179,363,False,0,1
10007,12,178,221,399,False,0,1
10008,13,229,268,497,False,0,1
10009,14,260,370,630,False,0,1
10010,15,234,268,502,False,0,1
10011,16,205,171,376,False,0,1
10012,17,167,130,297,False,0,1
10013,18,130,169,299,False,0,1
10014,19,112,99,211,False,0,1
10015,20,69,113,182,False,0,1
10016,21,59,150,209,False,0,1
10017,22,39,157,196,False,0,1
10018,23,14,59,73,False,0,1
10019,0,11,20,31,False,1,1
10020,1,11,26,37,False,1,1
10021,2,6,12,18,False,1,1
10022,3,4,10,14,False,1,1
10023,4,17,8,25,False,1,1
10024,5,108,64,172,False,1,1
10025,6,229,162,391,False,1,1
10026,7,385,175,560,False,1,1
10027,8,272,155,427,False,1,1
10028,9,215,189,404,False,1,1
10029,10,198,175,373,False,1,1
10030,11,197,189,386,False,1,1
10031,12,200,226,426,False,1,1
10032,13,211,250,461,False,1,1
10033,14,256,296,552,False,1,1
10034,15,246,291,537,False,1,1
10035,16,193,216,409,False,1,1
10036,17,171,156,327,False,1,1
10037,18,154,168,322,False,1,1
10038,19,124,183,307,False,1,1
10039,20,82,127,209,False,1,1
10040,21,59,79,138,False,1,1
10041,22,23,41,64,False,1,1
10042,23,14,18,32,False,1,1
10043,0,12,20,32,False,2,1
10044,1,8,13,21,False,2,1
10045,2,7,13,20,False,2,1
10046,3,6,9,15,False,2,1
10047,4,12,14,26,False,2,1
10048,5,118,63,181,False,2,1
10049,6,234,150,384,False,2,1
10050,7,354,190,544,False,2,1
10051,8,281,175,456,False,2,1
10052,9,257,177,434,False,2,1
10053,10,205,177,382,False,2,1
10054,11,198,181,379,False,2,1
10055,12,191,216,407,False,2,1
10056,13,205,263,468,False,2,1
10057,14,282,333,615,False,2,1
10058,15,214,309,523,False,2,1
10059,16,178,184,362,False,2,1
10060,17,182,185,367,False,2,1
10061,18,127,127,254,False,2,1
10062,19,112,119,231,False,2,1
10063,20,90,136,226,False,2,1
10064,21,49,71,120,False,2,1
10065,22,29,35,64,False,2,1
10066,23,20,30,50,False,2,1
10067,0,11,15,26,False,3,1
10068,1,7,17,24,False,3,1
10069,2,6,17,23,False,3,1
10070,3,8,9,17,False,3,1
10071,4,13,15,28,False,3,1
10072,5,99,57,156,False,3,1
10073,6,238,153,391,False,3,1
10074,7,383,228,611,False,3,1
10075,8,258,163,421,False,3,1
10076,9,207,171,378,False,3,1
10077,10,204,164,368,False,3,1
10078,11,197,206,403,False,3,1
10079,12,201,215,416,False,3,1
10080,13,208,247,455,False,3,1
10081,14,265,328,593,False,3,1
10082,15,225,316,541,False,3,1
10083,16,187,210,397,False,3,1
10084,17,195,159,354,False,3,1
10085,18,134,189,323,False,3,1
10086,19,118,114,232,False,3,1
10087,20,97,113,210,False,3,1
10088,21,50,225,275,False,3,1
10089,22,38,154,192,False,3,1
10090,23,24,30,54,False,3,1
10091,0,11,21,32,False,4,1
10092,1,12,29,41,False,4,1
10093,2,8,24,32,False,4,1
10094,3,4,16,20,False,4,1
10095,4,15,16,31,False,4,1
10096,5,97,64,161,False,4,1
10097,6,241,142,383,False,4,1
10098,7,376,174,550,False,4,1
10099,8,240,163,403,False,4,1
10100,9,204,175,379,False,4,1
10101,10,209,184,393,False,4,1
10102,11,198,216,414,False,4,1
10103,12,228,247,475,False,4,1
10104,13,249,313,562,False,4,1
10105,14,288,377,665,False,4,1
10106,15,197,262,459,False,4,1
10107,16,182,201,383,False,4,1
10108,17,134,151,285,False,4,1
10109,18,104,154,258,False,4,1
10110,19,102,95,197,False,4,1
10111,20,75,82,157,False,4,1
10112,21,52,70,122,False,4,1
10113,22,50,68,118,False,4,1
10114,23,38,47,85,False,4,1
10115,0,36,41,77,False,5,1
10116,1,15,53,68,False,5,1
10117,2,20,60,80,False,5,1
10118,3,10,26,36,False,5,1
10119,4,12,12,24,False,5,1
10120,5,22,24,46,False,5,1
10121,6,32,22,54,False,5,1
10122,7,38,37,75,False,5,1
10123,8,67,49,116,False,5,1
10124,9,106,81,187,False,5,1
10125,10,119,104,223,False,5,1
10126,11,133,138,271,False,5,1
10127,12,144,157,301,False,5,1
10128,13,140,158,298,False,5,1
10129,14,149,195,344,False,5,1
10130,15,145,166,311,False,5,1
10131,16,130,174,304,False,5,1
10132,17,136,141,277,False,5,1
10133,18,104,102,206,False,5,1
10134,19,79,91,170,False,5,1
10135,20,60,84,144,False,5,1
10136,21,41,64,105,False,5,1
10137,22,48,63,111,False,5,1
10138,23,37,76,113,False,5,1
10139,0,36,62,98,True,6,1
10140,1,32,60,92,True,6,1
10141,2,30,73,103,True,6,1
10142,3,19,43,62,True,6,1
10143,4,15,18,33,True,6,1
10144,5,12,8,20,True,6,1
10145,6,15,21,36,True,6,1
10146,7,30,20,50,True,6,1
10147,8,48,33,81,True,6,1
10148,9,74,47,121,True,6,1
10149,10,91,78,169,True,6,1
10150,11,141,142,283,True,6,1
10151,12,142,162,304,True,6,1
10152,13,167,198,365,True,6,1
10153,14,175,186,361,True,6,1
10154,15,136,204,340,True,6,1
10155,16,159,187,346,True,6,1
10156,17,164,170,334,True,6,1
10157,18,162,148,310,True,6,1
10158,19,82,110,192,True,6,1
10159,20,74,89,163,True,6,1
10160,21,59,89,148,True,6,1
10161,22,23,48,71,True,6,1
10162,23,26,24,50,True,6,1
10163,0,7,14,21,False,0,1
10164,1,11,13,24,False,0,1
10165,2,4,18,22,False,0,1
10166,3,6,8,14,False,0,1
10167,4,10,10,20,False,0,1
10168,5,106,59,165,False,0,1
10169,6,227,157,384,False,0,1
10170,7,374,179,553,False,0,1
10171,8,247,156,403,False,0,1
10172,9,200,160,360,False,0,1
10173,10,202,167,369,False,0,1
10174,11,184,209,393,False,0,1
10175,12,230,280,510,False,0,1
10176,13,209,262,471,False,0,1
10177,14,241,340,581,False,0,1
10178,15,204,290,494,False,0,1
10179,16,179,194,373,False,0,1
10180,17,172,146,318,False,0,1
10181,18,116,139,255,False,0,1
10182,19,108,122,230,False,0,1
10183,20,77,123,200,False,0,1
10184,21,69,62,131,False,0,1
10185,22,31,38,69,False,0,1
10186,23,15,13,28,False,0,1
10187,0,10,14,24,False,1,1
10188,1,5,6,11,False,1,1
10189,2,5,18,23,False,1,1
10190,3,5,4,9,False,1,1
10191,4,20,3,23,False,1,1
10192,5,99,49,148,False,1,1
10193,6,237,138,375,False,1,1
10194,7,385,190,575,False,1,1
10195,8,226,158,384,False,1,1
10196,9,202,180,382,False,1,1
10197,10,215,176,391,False,1,1
10198,11,184,198,382,False,1,1
10199,12,220,208,428,False,1,1
10200,13,196,249,445,False,1,1
10201,14,254,312,566,False,1,1
10202,15,241,301,542,False,1,1
10203,16,204,205,409,False,1,1
10204,17,221,169,390,False,1,1
10205,18,147,164,311,False,1,1
10206,19,106,136,242,False,1,1
10207,20,81,105,186,False,1,1
10208,21,63,103,166,False,1,1
10209,22,23,54,77,False,1,1
10210,23,19,29,48,False,1,1
10211,0,10,32,42,False,2,1
10212,1,5,14,19,False,2,1
10213,2,7,22,29,False,2,1
10214,3,9,17,26,False,2,1
10215,4,15,16,31,False,2,1
10216,5,94,55,149,False,2,1
10217,6,228,150,378,False,2,1
10218,7,380,180,560,False,2,1
10219,8,241,184,425,False,2,1
10220,9,194,158,352,False,2,1
10221,10,176,180,356,False,2,1
10222,11,206,201,407,False,2,1
10223,12,194,212,406,False,2,1
10224,13,204,231,435,False,2,1
10225,14,266,334,600,False,2,1
10226,15,244,353,597,False,2,1
10227,16,204,213,417,False,2,1
10228,17,157,155,312,False,2,1
10229,18,136,148,284,False,2,1
10230,19,123,99,222,False,2,1
10231,20,82,112,194,False,2,1
10232,21,59,98,157,False,2,1
10233,22,37,62,99,False,2,1
10234,23,12,25,37,False,2,1
10235,0,12,19,31,False,3,1
10236,1,11,15,26,False,3,1
10237,2,9,23,32,False,3,1
10238,3,7,19,26,False,3,1
10239,4,14,15,29,False,3,1
10240,5,91,54,145,False,3,1
10241,6,248,165,413,False,3,1
10242,7,427,192,619,False,3,1
10243,8,263,177,440,False,3,1
10244,9,209,187,396,False,3,1
10245,10,201,183,384,False,3,1
10246,11,235,213,448,False,3,1
10247,12,217,230,447,False,3,1
10248,13,216,255,471,False,3,1
10249,14,261,308,569,False,3,1
10250,15,243,300,543,False,3,1
10251,16,190,234,424,False,3,1
10252,17,204,140,344,False,3,1
10253,18,155,202,357,False,3,1
10254,19,115,152,267,False,3,1
10255,20,73,133,206,False,3,1
10256,21,58,102,160,False,3,1
10257,22,26,51,77,False,3,1
10258,23,19,28,47,False,3,1
10259,0,10,18,28,False,4,1
10260,1,11,14,25,False,4,1
10261,2,9,32,41,False,4,1
10262,3,6,13,19,False,4,1
10263,4,12,20,32,False,4,1
10264,5,99,59,158,False,4,1
10265,6,226,136,362,False,4,1
10266,7,365,182,547,False,4,1
10267,8,236,133,369,False,4,1
10268,9,190,177,367,False,4,1
10269,10,213,170,383,False,4,1
10270,11,220,224,444,False,4,1
10271,12,205,248,453,False,4,1
10272,13,253,293,546,False,4,1
10273,14,232,318,550,False,4,1
10274,15,242,256,498,False,4,1
10275,16,156,192,348,False,4,1
10276,17,189,138,327,False,4,1
10277,18,113,145,258,False,4,1
10278,19,89,103,192,False,4,1
10279,20,79,96,175,False,4,1
10280,21,67,76,143,False,4,1
10281,22,45,73,118,False,4,1
10282,23,47,69,116,False,4,1
10283,0,27,42,69,False,5,1
10284,1,16,41,57,False,5,1
10285,2,14,48,62,False,5,1
10286,3,10,42,52,False,5,1
10287,4,14,9,23,False,5,1
10288,5,17,21,38,False,5,1
10289,6,22,17,39,False,5,1
10290,7,45,35,80,False,5,1
10291,8,86,64,150,False,5,1
10292,9,102,77,179,False,5,1
10293,10,152,111,263,False,5,1
10294,11,169,166,335,False,5,1
10295,12,150,171,321,False,5,1
10296,13,153,170,323,False,5,1
10297,14,146,252,398,False,5,1
10298,15,144,204,348,False,5,1
10299,16,106,160,266,False,5,1
10300,17,135,123,258,False,5,1
10301,18,124,121,245,False,5,1
10302,19,111,124,235,False,5,1
10303,20,66,107,173,False,5,1
10304,21,49,64,113,False,5,1
10305,22,45,65,110,False,5,1
10306,23,48,62,110,False,5,1
10307,0,42,68,110,True,6,1
10308,1,33,50,83,True,6,1
10309,2,24,69,93,True,6,1
10310,3,28,44,72,True,6,1
10311,4,15,24,39,True,6,1
10312,5,17,23,40,True,6,1
10313,6,12,18,30,True,6,1
10314,7,41,16,57,True,6,1
10315,8,41,34,75,True,6,1
10316,9,109,42,151,True,6,1
10317,10,105,61,166,True,6,1
10318,11,153,164,317,True,6,1
10319,12,145,171,316,True,6,1
10320,13,205,198,403,True,6,1
10321,14,163,241,404,True,6,1
10322,15,162,251,413,True,6,1
10323,16,138,207,345,True,6,1
10324,17,163,140,303,True,6,1
10325,18,148,171,319,True,6,1
10326,19,117,179,296,True,6,1
10327,20,78,101,179,True,6,1
10328,21,55,71,126,True,6,1
10329,22,41,61,102,True,6,1
10330,23,17,18,35,True,6,1
10331,0,12,21,33,False,0,1
10332,1,12,15,27,False,0,1
10333,2,6,11,17,False,0,1
10334,3,6,11,17,False,0,1
10335,4,19,20,39,False,0,1
10336,5,113,56,169,False,0,1
10337,6,235,152,387,False,0,1
10338,7,394,193,587,False,0,1
10339,8,240,166,406,False,0,1
10340,9,211,178,389,False,0,1
10341,10,231,167,398,False,0,1
10342,11,211,185,396,False,0,1
10343,12,212,243,455,False,0,1
10344,13,196,254,450,False,0,1
10345,14,245,336,581,False,0,1
10346,15,233,322,555,False,0,1
10347,16,218,194,412,False,0,1
10348,17,188,162,350,False,0,1
10349,18,144,165,309,False,0,1
10350,19,127,143,270,False,0,1
10351,20,90,138,228,False,0,1
10352,21,44,93,137,False,0,1
10353,22,25,57,82,False,0,1
10354,23,23,21,44,False,0,1
10355,0,12,10,22,False,1,1
10356,1,5,14,19,False,1,1
10357,2,5,8,13,False,1,1
10358,3,11,11,22,False,1,1
10359,4,23,14,37,False,1,1
10360,5,101,58,159,False,1,1
10361,6,233,144,377,False,1,1
10362,7,391,205,596,False,1,1
10363,8,241,165,406,False,1,1
10364,9,217,184,401,False,1,1
10365,10,240,194,434,False,1,1
10366,11,210,216,426,False,1,1
10367,12,197,200,397,False,1,1
10368,13,191,255,446,False,1,1
10369,14,247,357,604,False,1,1
10370,15,246,349,595,False,1,1
10371,16,220,218,438,False,1,1
10372,17,169,132,301,False,1,1
10373,18,146,163,309,False,1,1
10374,19,131,133,264,False,1,1
10375,20,81,121,202,False,1,1
10376,21,65,112,177,False,1,1
10377,22,32,53,85,False,1,1
10378,23,14,37,51,False,1,1
10379,0,9,16,25,False,2,1
10380,1,7,20,27,False,2,1
10381,2,12,15,27,False,2,1
10382,3,8,13,21,False,2,1
10383,4,15,20,35,False,2,1
10384,5,100,68,168,False,2,1
10385,6,248,155,403,False,2,1
10386,7,384,206,590,False,2,1
10387,8,275,160,435,False,2,1
10388,9,206,168,374,False,2,1
10389,10,226,201,427,False,2,1
10390,11,215,184,399,False,2,1
10391,12,201,240,441,False,2,1
10392,13,217,242,459,False,2,1
10393,14,233,351,584,False,2,1
10394,15,229,309,538,False,2,1
10395,16,202,201,403,False,2,1
10396,17,176,165,341,False,2,1
10397,18,146,173,319,False,2,1
10398,19,111,135,246,False,2,1
10399,20,88,126,214,False,2,1
10400,21,53,111,164,False,2,1
10401,22,35,61,96,False,2,1
10402,23,19,42,61,False,2,1
10403,0,13,26,39,False,3,1
10404,1,14,31,45,False,3,1
10405,2,9,25,34,False,3,1
10406,3,9,24,33,False,3,1
10407,4,14,19,33,False,3,1
10408,5,112,51,163,False,3,1
10409,6,250,155,405,False,3,1
10410,7,419,214,633,False,3,1
10411,8,273,172,445,False,3,1
10412,9,214,171,385,False,3,1
10413,10,200,199,399,False,3,1
10414,11,204,222,426,False,3,1
10415,12,228,207,435,False,3,1
10416,13,193,247,440,False,3,1
10417,14,247,336,583,False,3,1
10418,15,238,313,551,False,3,1
10419,16,212,233,445,False,3,1
10420,17,228,169,397,False,3,1
10421,18,155,202,357,False,3,1
10422,19,99,138,237,False,3,1
10423,20,98,135,233,False,3,1
10424,21,50,112,162,False,3,1
10425,22,35,275,310,False,3,1
10426,23,14,27,41,False,3,1
10427,0,14,23,37,False,4,1
10428,1,18,27,45,False,4,1
10429,2,13,25,38,False,4,1
10430,3,5,21,26,False,4,1
10431,4,18,15,33,False,4,1
10432,5,108,57,165,False,4,1
10433,6,240,128,368,False,4,1
10434,7,359,186,545,False,4,1
10435,8,254,163,417,False,4,1
10436,9,211,163,374,False,4,1
10437,10,206,182,388,False,4,1
10438,11,211,223,434,False,4,1
10439,12,235,218,453,False,4,1
10440,13,247,314,561,False,4,1
10441,14,278,376,654,False,4,1
10442,15,206,272,478,False,4,1
10443,16,174,191,365,False,4,1
10444,17,123,133,256,False,4,1
10445,18,106,124,230,False,4,1
10446,19,85,87,172,False,4,1
10447,20,67,77,144,False,4,1
10448,21,59,72,131,False,4,1
10449,22,49,69,118,False,4,1
10450,23,35,52,87,False,4,1
10451,0,36,53,89,False,5,1
10452,1,21,35,56,False,5,1
10453,2,21,56,77,False,5,1
10454,3,17,25,42,False,5,1
10455,4,17,16,33,False,5,1
10456,5,23,19,42,False,5,1
10457,6,21,19,40,False,5,1
10458,7,32,32,64,False,5,1
10459,8,48,51,99,False,5,1
10460,9,101,78,179,False,5,1
10461,10,110,87,197,False,5,1
10462,11,162,137,299,False,5,1
10463,12,160,161,321,False,5,1
10464,13,136,180,316,False,5,1
10465,14,127,176,303,False,5,1
10466,15,107,148,255,False,5,1
10467,16,124,150,274,False,5,1
10468,17,110,135,245,False,5,1
10469,18,107,104,211,False,5,1
10470,19,81,102,183,False,5,1
10471,20,56,63,119,False,5,1
10472,21,44,52,96,False,5,1
10473,22,38,55,93,False,5,1
10474,23,37,56,93,False,5,1
10475,0,24,46,70,True,6,1
10476,1,21,64,85,True,6,1
10477,2,24,66,90,True,6,1
10478,3,24,53,77,True,6,1
10479,4,15,18,33,True,6,1
10480,5,20,20,40,True,6,1
10481,6,11,11,22,True,6,1
10482,7,29,14,43,True,6,1
10483,8,42,31,73,True,6,1
10484,9,79,48,127,True,6,1
10485,10,97,72,169,True,6,1
10486,11,130,128,258,True,6,1
10487,12,126,138,264,True,6,1
10488,13,147,170,317,True,6,1
10489,14,120,146,266,True,6,1
10490,15,119,187,306,True,6,1
10491,16,145,177,322,True,6,1
10492,17,127,139,266,True,6,1
10493,18,129,119,248,True,6,1
10494,19,114,144,258,True,6,1
10495,20,85,107,192,True,6,1
10496,21,51,62,113,True,6,1
10497,22,37,50,87,True,6,1
10498,23,20,21,41,True,6,1
10499,0,7,18,25,False,0,1
10500,1,11,15,26,False,0,1
10501,2,8,11,19,False,0,1
10502,3,9,10,19,False,0,1
10503,4,12,12,24,False,0,1
10504,5,108,64,172,False,0,1
10505,6,209,129,338,False,0,1
10506,7,298,157,455,False,0,1
10507,8,240,159,399,False,0,1
10508,9,195,151,346,False,0,1
10509,10,209,177,386,False,0,1
10510,11,219,171,390,False,0,1
10511,12,192,197,389,False,0,1
10512,13,193,247,440,False,0,1
10513,14,208,300,508,False,0,1
10514,15,178,285,463,False,0,1
10515,16,161,166,327,False,0,1
10516,17,164,125,289,False,0,1
10517,18,114,141,255,False,0,1
10518,19,106,104,210,False,0,1
10519,20,82,117,199,False,0,1
10520,21,46,85,131,False,0,1
10521,22,32,54,86,False,0,1
10522,23,22,18,40,False,0,1
10523,0,8,14,22,False,1,1
10524,1,1,15,16,False,1,1
10525,2,6,20,26,False,1,1
10526,3,3,8,11,False,1,1
10527,4,13,16,29,False,1,1
10528,5,98,57,155,False,1,1
10529,6,226,112,338,False,1,1
10530,7,316,148,464,False,1,1
10531,8,217,149,366,False,1,1
10532,9,207,150,357,False,1,1
10533,10,195,202,397,False,1,1
10534,11,228,197,425,False,1,1
10535,12,183,217,400,False,1,1
10536,13,185,247,432,False,1,1
10537,14,214,280,494,False,1,1
10538,15,189,262,451,False,1,1
10539,16,164,174,338,False,1,1
10540,17,158,140,298,False,1,1
10541,18,149,127,276,False,1,1
10542,19,107,123,230,False,1,1
10543,20,85,105,190,False,1,1
10544,21,68,401,469,False,1,1
10545,22,31,265,296,False,1,1
10546,23,19,94,113,False,1,1
10547,0,13,44,57,False,2,2
10548,1,5,31,36,False,2,2
10549,2,5,14,19,False,2,2
10550,3,10,9,19,False,2,2
10551,4,12,9,21,False,2,2
10552,5,96,55,151,False,2,2
10553,6,216,138,354,False,2,2
10554,7,301,147,448,False,2,2
10555,8,254,156,410,False,2,2
10556,9,217,166,383,False,2,2
10557,10,212,186,398,False,2,2
10558,11,174,186,360,False,2,2
10559,12,183,198,381,False,2,2
10560,13,197,246,443,False,2,2
10561,14,229,309,538,False,2,2
10562,15,200,264,464,False,2,2
10563,16,189,177,366,False,2,2
10564,17,152,129,281,False,2,2
10565,18,133,163,296,False,2,2
10566,19,114,141,255,False,2,2
10567,20,73,135,208,False,2,2
10568,21,59,84,143,False,2,2
10569,22,30,48,78,False,2,2
10570,23,17,30,47,False,2,2
10571,0,12,19,31,False,3,2
10572,1,13,34,47,False,3,2
10573,2,7,13,20,False,3,2
10574,3,8,17,25,False,3,2
10575,4,14,13,27,False,3,2
10576,5,78,53,131,False,3,2
10577,6,185,121,306,False,3,2
10578,7,276,157,433,False,3,2
10579,8,188,148,336,False,3,2
10580,9,202,186,388,False,3,2
10581,10,193,152,345,False,3,2
10582,11,193,175,368,False,3,2
10583,12,194,202,396,False,3,2
10584,13,175,218,393,False,3,2
10585,14,219,256,475,False,3,2
10586,15,187,245,432,False,3,2
10587,16,177,189,366,False,3,2
10588,17,138,150,288,False,3,2
10589,18,116,131,247,False,3,2
10590,19,103,112,215,False,3,2
10591,20,69,119,188,False,3,2
10592,21,63,74,137,False,3,2
10593,22,26,49,75,False,3,2
10594,23,22,29,51,False,3,2
10595,0,14,22,36,False,4,2
10596,1,5,20,25,False,4,2
10597,2,8,20,28,False,4,2
10598,3,8,17,25,False,4,2
10599,4,14,22,36,False,4,2
10600,5,85,52,137,False,4,2
10601,6,206,121,327,False,4,2
10602,7,240,131,371,False,4,2
10603,8,233,139,372,False,4,2
10604,9,189,143,332,False,4,2
10605,10,192,178,370,False,4,2
10606,11,192,150,342,False,4,2
10607,12,166,161,327,False,4,2
10608,13,193,267,460,False,4,2
10609,14,212,257,469,False,4,2
10610,15,176,189,365,False,4,2
10611,16,139,198,337,False,4,2
10612,17,119,125,244,False,4,2
10613,18,119,119,238,False,4,2
10614,19,99,96,195,False,4,2
10615,20,74,94,168,False,4,2
10616,21,36,77,113,False,4,2
10617,22,37,58,95,False,4,2
10618,23,29,51,80,False,4,2
10619,0,27,38,65,False,5,2
10620,1,18,39,57,False,5,2
10621,2,12,45,57,False,5,2
10622,3,6,30,36,False,5,2
10623,4,4,11,15,False,5,2
10624,5,19,15,34,False,5,2
10625,6,25,24,49,False,5,2
10626,7,31,38,69,False,5,2
10627,8,51,55,106,False,5,2
10628,9,103,70,173,False,5,2
10629,10,111,84,195,False,5,2
10630,11,139,124,263,False,5,2
10631,12,121,145,266,False,5,2
10632,13,123,133,256,False,5,2
10633,14,118,163,281,False,5,2
10634,15,118,167,285,False,5,2
10635,16,116,132,248,False,5,2
10636,17,118,120,238,False,5,2
10637,18,84,102,186,False,5,2
10638,19,81,90,171,False,5,2
10639,20,56,71,127,False,5,2
10640,21,48,65,113,False,5,2
10641,22,41,61,102,False,5,2
10642,23,46,59,105,False,5,2
10643,0,32,47,79,True,6,2
10644,1,22,53,75,True,6,2
10645,2,20,60,80,True,6,2
10646,3,14,45,59,True,6,2
10647,4,18,26,44,True,6,2
10648,5,11,11,22,True,6,2
10649,6,15,13,28,True,6,2
10650,7,30,20,50,True,6,2
10651,8,28,32,60,True,6,2
10652,9,85,44,129,True,6,2
10653,10,109,69,178,True,6,2
10654,11,101,126,227,True,6,2
10655,12,136,156,292,True,6,2
10656,13,137,159,296,True,6,2
10657,14,135,174,309,True,6,2
10658,15,142,201,343,True,6,2
10659,16,146,150,296,True,6,2
10660,17,154,168,322,True,6,2
10661,18,143,144,287,True,6,2
10662,19,98,157,255,True,6,2
10663,20,71,80,151,True,6,2
10664,21,38,82,120,True,6,2
10665,22,32,116,148,True,6,2
10666,23,21,17,38,True,6,2
10667,0,11,20,31,False,0,2
10668,1,5,10,15,False,0,2
10669,2,8,14,22,False,0,2
10670,3,5,9,14,False,0,2
10671,4,15,12,27,False,0,2
10672,5,113,53,166,False,0,2
10673,6,289,177,466,False,0,2
10674,7,375,242,617,False,0,2
10675,8,271,161,432,False,0,2
10676,9,196,162,358,False,0,2
10677,10,190,207,397,False,0,2
10678,11,182,208,390,False,0,2
10679,12,203,210,413,False,0,2
10680,13,184,244,428,False,0,2
10681,14,234,307,541,False,0,2
10682,15,225,294,519,False,0,2
10683,16,192,198,390,False,0,2
10684,17,151,145,296,False,0,2
10685,18,162,142,304,False,0,2
10686,19,133,134,267,False,0,2
10687,20,93,138,231,False,0,2
10688,21,55,88,143,False,0,2
10689,22,31,45,76,False,0,2
10690,23,15,25,40,False,0,2
10691,0,9,25,34,False,1,2
10692,1,8,8,16,False,1,2
10693,2,8,6,14,False,1,2
10694,3,6,6,12,False,1,2
10695,4,20,14,34,False,1,2
10696,5,102,49,151,False,1,2
10697,6,258,140,398,False,1,2
10698,7,381,235,616,False,1,2
10699,8,249,175,424,False,1,2
10700,9,187,199,386,False,1,2
10701,10,210,168,378,False,1,2
10702,11,203,194,397,False,1,2
10703,12,206,198,404,False,1,2
10704,13,192,247,439,False,1,2
10705,14,253,311,564,False,1,2
10706,15,246,297,543,False,1,2
10707,16,188,208,396,False,1,2
10708,17,188,157,345,False,1,2
10709,18,160,146,306,False,1,2
10710,19,135,147,282,False,1,2
10711,20,75,112,187,False,1,2
10712,21,63,122,185,False,1,2
10713,22,28,53,81,False,1,2
10714,23,14,22,36,False,1,2
10715,0,14,23,37,False,2,2
10716,1,8,20,28,False,2,2
10717,2,7,12,19,False,2,2
10718,3,6,12,18,False,2,2
10719,4,16,18,34,False,2,2
10720,5,114,51,165,False,2,2
10721,6,254,151,405,False,2,2
10722,7,359,228,587,False,2,2
10723,8,253,183,436,False,2,2
10724,9,223,177,400,False,2,2
10725,10,206,194,400,False,2,2
10726,11,200,208,408,False,2,2
10727,12,212,212,424,False,2,2
10728,13,199,282,481,False,2,2
10729,14,236,335,571,False,2,2
10730,15,242,287,529,False,2,2
10731,16,209,189,398,False,2,2
10732,17,172,166,338,False,2,2
10733,18,153,151,304,False,2,2
10734,19,132,130,262,False,2,2
10735,20,77,142,219,False,2,2
10736,21,57,76,133,False,2,2
10737,22,36,59,95,False,2,2
10738,23,19,24,43,False,2,2
10739,0,13,22,35,False,3,2
10740,1,10,23,33,False,3,2
10741,2,11,16,27,False,3,2
10742,3,4,10,14,False,3,2
10743,4,13,22,35,False,3,2
10744,5,96,61,157,False,3,2
10745,6,234,142,376,False,3,2
10746,7,399,203,602,False,3,2
10747,8,258,160,418,False,3,2
10748,9,216,159,375,False,3,2
10749,10,183,177,360,False,3,2
10750,11,231,194,425,False,3,2
10751,12,174,207,381,False,3,2
10752,13,209,255,464,False,3,2
10753,14,245,341,586,False,3,2
10754,15,252,330,582,False,3,2
10755,16,207,239,446,False,3,2
10756,17,175,158,333,False,3,2
10757,18,153,200,353,False,3,2
10758,19,107,160,267,False,3,2
10759,20,93,148,241,False,3,2
10760,21,80,90,170,False,3,2
10761,22,38,70,108,False,3,2
10762,23,18,23,41,False,3,2
10763,0,14,32,46,False,4,2
10764,1,12,24,36,False,4,2
10765,2,6,18,24,False,4,2
10766,3,11,15,26,False,4,2
10767,4,17,13,30,False,4,2
10768,5,107,67,174,False,4,2
10769,6,232,136,368,False,4,2
10770,7,356,231,587,False,4,2
10771,8,234,143,377,False,4,2
10772,9,216,178,394,False,4,2
10773,10,197,169,366,False,4,2
10774,11,226,242,468,False,4,2
10775,12,221,234,455,False,4,2
10776,13,235,316,551,False,4,2
10777,14,283,348,631,False,4,2
10778,15,184,295,479,False,4,2
10779,16,163,170,333,False,4,2
10780,17,143,158,301,False,4,2
10781,18,117,134,251,False,4,2
10782,19,104,119,223,False,4,2
10783,20,63,85,148,False,4,2
10784,21,57,70,127,False,4,2
10785,22,42,62,104,False,4,2
10786,23,37,65,102,False,4,2
10787,0,29,40,69,False,5,2
10788,1,19,41,60,False,5,2
10789,2,19,56,75,False,5,2
10790,3,19,34,53,False,5,2
10791,4,22,20,42,False,5,2
10792,5,21,18,39,False,5,2
10793,6,25,24,49,False,5,2
10794,7,45,43,88,False,5,2
10795,8,84,50,134,False,5,2
10796,9,133,99,232,False,5,2
10797,10,132,108,240,False,5,2
10798,11,157,151,308,False,5,2
10799,12,158,157,315,False,5,2
10800,13,159,188,347,False,5,2
10801,14,173,163,336,False,5,2
10802,15,122,174,296,False,5,2
10803,16,117,147,264,False,5,2
10804,17,107,145,252,False,5,2
10805,18,94,101,195,False,5,2
10806,19,105,100,205,False,5,2
10807,20,52,59,111,False,5,2
10808,21,47,67,114,False,5,2
10809,22,38,77,115,False,5,2
10810,23,50,62,112,False,5,2
10811,0,39,56,95,True,6,2
10812,1,24,53,77,True,6,2
10813,2,27,61,88,True,6,2
10814,3,15,46,61,True,6,2
10815,4,15,24,39,True,6,2
10816,5,17,14,31,True,6,2
10817,6,16,14,30,True,6,2
10818,7,32,23,55,True,6,2
10819,8,52,38,90,True,6,2
10820,9,103,57,160,True,6,2
10821,10,108,71,179,True,6,2
10822,11,144,128,272,True,6,2
10823,12,118,169,287,True,6,2
10824,13,187,202,389,True,6,2
10825,14,153,211,364,True,6,2
10826,15,155,242,397,True,6,2
10827,16,181,179,360,True,6,2
10828,17,160,153,313,True,6,2
10829,18,162,173,335,True,6,2
10830,19,123,165,288,True,6,2
10831,20,72,125,197,True,6,2
10832,21,51,68,119,True,6,2
10833,22,28,33,61,True,6,2
10834,23,16,20,36,True,6,2
10835,0,10,14,24,False,0,2
10836,1,10,16,26,False,0,2
10837,2,6,15,21,False,0,2
10838,3,9,15,24,False,0,2
10839,4,20,13,33,False,0,2
10840,5,109,59,168,False,0,2
10841,6,250,143,393,False,0,2
10842,7,426,211,637,False,0,2
10843,8,248,158,406,False,0,2
10844,9,191,156,347,False,0,2
10845,10,186,165,351,False,0,2
10846,11,205,200,405,False,0,2
10847,12,222,188,410,False,0,2
10848,13,196,281,477,False,0,2
10849,14,218,297,515,False,0,2
10850,15,254,323,577,False,0,2
10851,16,196,178,374,False,0,2
10852,17,170,171,341,False,0,2
10853,18,130,145,275,False,0,2
10854,19,113,121,234,False,0,2
10855,20,73,103,176,False,0,2
10856,21,36,90,126,False,0,2
10857,22,35,55,90,False,0,2
10858,23,14,26,40,False,0,2
10859,0,11,15,26,False,1,2
10860,1,9,14,23,False,1,2
10861,2,1,4,5,False,1,2
10862,3,3,10,13,False,1,2
10863,4,15,7,22,False,1,2
10864,5,115,54,169,False,1,2
10865,6,250,170,420,False,1,2
10866,7,401,216,617,False,1,2
10867,8,259,183,442,False,1,2
10868,9,219,179,398,False,1,2
10869,10,207,191,398,False,1,2
10870,11,242,204,446,False,1,2
10871,12,203,221,424,False,1,2
10872,13,217,268,485,False,1,2
10873,14,247,317,564,False,1,2
10874,15,234,344,578,False,1,2
10875,16,205,205,410,False,1,2
10876,17,216,164,380,False,1,2
10877,18,135,157,292,False,1,2
10878,19,102,133,235,False,1,2
10879,20,81,113,194,False,1,2
10880,21,63,106,169,False,1,2
10881,22,30,55,85,False,1,2
10882,23,13,39,52,False,1,2
10883,0,14,22,36,False,2,2
10884,1,14,16,30,False,2,2
10885,2,9,21,30,False,2,2
10886,3,3,21,24,False,2,2
10887,4,11,16,27,False,2,2
10888,5,101,63,164,False,2,2
10889,6,252,147,399,False,2,2
10890,7,380,199,579,False,2,2
10891,8,279,163,442,False,2,2
10892,9,212,185,397,False,2,2
10893,10,233,183,416,False,2,2
10894,11,212,233,445,False,2,2
10895,12,195,226,421,False,2,2
10896,13,216,282,498,False,2,2
10897,14,259,302,561,False,2,2
10898,15,246,304,550,False,2,2
10899,16,201,214,415,False,2,2
10900,17,173,178,351,False,2,2
10901,18,140,147,287,False,2,2
10902,19,114,136,250,False,2,2
10903,20,86,109,195,False,2,2
10904,21,56,109,165,False,2,2
10905,22,33,49,82,False,2,2
10906,23,15,26,41,False,2,2
10907,0,14,19,33,False,3,2
10908,1,14,12,26,False,3,2
10909,2,6,24,30,False,3,2
10910,3,5,28,33,False,3,2
10911,4,12,10,22,False,3,2
10912,5,115,61,176,False,3,2
10913,6,257,150,407,False,3,2
10914,7,412,215,627,False,3,2
10915,8,249,179,428,False,3,2
10916,9,250,189,439,False,3,2
10917,10,196,181,377,False,3,2
10918,11,175,191,366,False,3,2
10919,12,190,233,423,False,3,2
10920,13,195,240,435,False,3,2
10921,14,303,345,648,False,3,2
10922,15,246,318,564,False,3,2
10923,16,197,231,428,False,3,2
10924,17,182,151,333,False,3,2
10925,18,163,180,343,False,3,2
10926,19,112,131,243,False,3,2
10927,20,75,107,182,False,3,2
10928,21,67,101,168,False,3,2
10929,22,37,192,229,False,3,2
10930,23,26,66,92,False,3,2
10931,0,12,23,35,False,4,2
10932,1,9,20,29,False,4,2
10933,2,6,23,29,False,4,2
10934,3,5,31,36,False,4,2
10935,4,15,21,36,False,4,2
10936,5,112,59,171,False,4,2
10937,6,236,158,394,False,4,2
10938,7,371,177,548,False,4,2
10939,8,236,158,394,False,4,2
10940,9,235,187,422,False,4,2
10941,10,189,185,374,False,4,2
10942,11,205,195,400,False,4,2
10943,12,215,245,460,False,4,2
10944,13,274,314,588,False,4,2
10945,14,298,332,630,False,4,2
10946,15,218,299,517,False,4,2
10947,16,175,185,360,False,4,2
10948,17,132,175,307,False,4,2
10949,18,130,155,285,False,4,2
10950,19,95,97,192,False,4,2
10951,20,56,94,150,False,4,2
10952,21,50,70,120,False,4,2
10953,22,56,74,130,False,4,2
10954,23,33,53,86,False,4,2
10955,0,24,53,77,False,5,2
10956,1,20,39,59,False,5,2
10957,2,26,47,73,False,5,2
10958,3,13,33,46,False,5,2
10959,4,9,17,26,False,5,2
10960,5,22,12,34,False,5,2
10961,6,31,33,64,False,5,2
10962,7,36,29,65,False,5,2
10963,8,65,46,111,False,5,2
10964,9,95,69,164,False,5,2
10965,10,123,88,211,False,5,2
10966,11,138,152,290,False,5,2
10967,12,139,155,294,False,5,2
10968,13,147,168,315,False,5,2
10969,14,125,190,315,False,5,2
10970,15,126,172,298,False,5,2
10971,16,142,165,307,False,5,2
10972,17,133,154,287,False,5,2
10973,18,127,134,261,False,5,2
10974,19,96,89,185,False,5,2
10975,20,65,81,146,False,5,2
10976,21,52,59,111,False,5,2
10977,22,42,63,105,False,5,2
10978,23,40,68,108,False,5,2
10979,0,30,42,72,True,6,2
10980,1,22,51,73,True,6,2
10981,2,29,63,92,True,6,2
10982,3,16,53,69,True,6,2
10983,4,19,33,52,True,6,2
10984,5,14,7,21,True,6,2
10985,6,26,14,40,True,6,2
10986,7,33,19,52,True,6,2
10987,8,60,40,100,True,6,2
10988,9,79,50,129,True,6,2
10989,10,104,76,180,True,6,2
10990,11,153,161,314,True,6,2
10991,12,166,182,348,True,6,2
10992,13,179,190,369,True,6,2
10993,14,154,204,358,True,6,2
10994,15,144,212,356,True,6,2
10995,16,161,183,344,True,6,2
10996,17,141,137,278,True,6,2
10997,18,151,130,281,True,6,2
10998,19,120,177,297,True,6,2
10999,20,79,95,174,True,6,2
11000,21,37,52,89,True,6,2
11001,22,37,40,77,True,6,2
11002,23,23,28,51,True,6,2
11003,0,15,16,31,False,0,2
11004,1,6,14,20,False,0,2
11005,2,5,15,20,False,0,2
11006,3,8,9,17,False,0,2
11007,4,19,13,32,False,0,2
11008,5,115,62,177,False,0,2
11009,6,256,139,395,False,0,2
11010,7,368,200,568,False,0,2
11011,8,263,170,433,False,0,2
11012,9,214,191,405,False,0,2
11013,10,192,180,372,False,0,2
11014,11,194,211,405,False,0,2
11015,12,179,214,393,False,0,2
11016,13,197,278,475,False,0,2
11017,14,244,329,573,False,0,2
11018,15,208,311,519,False,0,2
11019,16,193,189,382,False,0,2
11020,17,161,170,331,False,0,2
11021,18,144,150,294,False,0,2
11022,19,100,121,221,False,0,2
11023,20,78,110,188,False,0,2
11024,21,48,80,128,False,0,2
11025,22,25,39,64,False,0,2
11026,23,13,23,36,False,0,2
11027,0,12,14,26,False,1,2
11028,1,7,11,18,False,1,2
11029,2,8,11,19,False,1,2
11030,3,5,13,18,False,1,2
11031,4,20,12,32,False,1,2
11032,5,108,48,156,False,1,2
11033,6,258,157,415,False,1,2
11034,7,382,190,572,False,1,2
11035,8,287,186,473,False,1,2
11036,9,234,163,397,False,1,2
11037,10,200,197,397,False,1,2
11038,11,200,204,404,False,1,2
11039,12,213,235,448,False,1,2
11040,13,193,266,459,False,1,2
11041,14,243,350,593,False,1,2
11042,15,217,324,541,False,1,2
11043,16,194,221,415,False,1,2
11044,17,179,148,327,False,1,2
11045,18,155,160,315,False,1,2
11046,19,113,155,268,False,1,2
11047,20,88,132,220,False,1,2
11048,21,55,426,481,False,1,2
11049,22,40,221,261,False,1,2
11050,23,20,100,120,False,1,2
11051,0,9,23,32,False,2,2
11052,1,9,22,31,False,2,2
11053,2,9,16,25,False,2,2
11054,3,5,13,18,False,2,2
11055,4,13,15,28,False,2,2
11056,5,108,60,168,False,2,2
11057,6,269,159,428,False,2,2
11058,7,400,200,600,False,2,2
11059,8,262,172,434,False,2,2
11060,9,207,169,376,False,2,2
11061,10,182,212,394,False,2,2
11062,11,188,190,378,False,2,2
11063,12,204,206,410,False,2,2
11064,13,224,234,458,False,2,2
11065,14,224,296,520,False,2,2
11066,15,228,294,522,False,2,2
11067,16,197,220,417,False,2,2
11068,17,165,176,341,False,2,2
11069,18,152,166,318,False,2,2
11070,19,92,154,246,False,2,2
11071,20,77,103,180,False,2,2
11072,21,61,108,169,False,2,2
11073,22,28,48,76,False,2,2
11074,23,18,30,48,False,2,2
11075,0,16,18,34,False,3,2
11076,1,7,14,21,False,3,2
11077,2,10,11,21,False,3,2
11078,3,4,21,25,False,3,2
11079,4,15,13,28,False,3,2
11080,5,120,55,175,False,3,2
11081,6,235,154,389,False,3,2
11082,7,388,201,589,False,3,2
11083,8,274,173,447,False,3,2
11084,9,234,180,414,False,3,2
11085,10,174,167,341,False,3,2
11086,11,201,190,391,False,3,2
11087,12,214,208,422,False,3,2
11088,13,192,258,450,False,3,2
11089,14,281,333,614,False,3,2
11090,15,217,310,527,False,3,2
11091,16,229,213,442,False,3,2
11092,17,183,174,357,False,3,2
11093,18,158,178,336,False,3,2
11094,19,109,125,234,False,3,2
11095,20,82,131,213,False,3,2
11096,21,46,82,128,False,3,2
11097,22,31,61,92,False,3,2
11098,23,20,27,47,False,3,2
11099,0,16,33,49,False,4,2
11100,1,9,30,39,False,4,2
11101,2,6,30,36,False,4,2
11102,3,8,14,22,False,4,2
11103,4,17,12,29,False,4,2
11104,5,114,52,166,False,4,2
11105,6,267,145,412,False,4,2
11106,7,382,190,572,False,4,2
11107,8,261,179,440,False,4,2
11108,9,229,176,405,False,4,2
11109,10,232,226,458,False,4,2
11110,11,221,215,436,False,4,2
11111,12,247,269,516,False,4,2
11112,13,240,308,548,False,4,2
11113,14,296,408,704,False,4,2
11114,15,213,321,534,False,4,2
11115,16,141,190,331,False,4,2
11116,17,145,176,321,False,4,2
11117,18,119,125,244,False,4,2
11118,19,106,96,202,False,4,2
11119,20,75,93,168,False,4,2
11120,21,46,74,120,False,4,2
11121,22,49,62,111,False,4,2
11122,23,32,50,82,False,4,2
11123,0,33,30,63,False,5,2
11124,1,22,33,55,False,5,2
11125,2,15,46,61,False,5,2
11126,3,9,20,29,False,5,2
11127,4,12,17,29,False,5,2
11128,5,25,24,49,False,5,2
11129,6,27,22,49,False,5,2
11130,7,59,43,102,False,5,2
11131,8,83,74,157,False,5,2
11132,9,133,97,230,False,5,2
11133,10,137,117,254,False,5,2
11134,11,150,162,312,False,5,2
11135,12,170,183,353,False,5,2
11136,13,190,212,402,False,5,2
11137,14,155,191,346,False,5,2
11138,15,139,167,306,False,5,2
11139,16,135,183,318,False,5,2
11140,17,143,156,299,False,5,2
11141,18,113,125,238,False,5,2
11142,19,95,77,172,False,5,2
11143,20,54,76,130,False,5,2
11144,21,55,58,113,False,5,2
11145,22,40,73,113,False,5,2
11146,23,30,60,90,False,5,2
11147,0,38,46,84,True,6,2
11148,1,38,66,104,True,6,2
11149,2,31,63,94,True,6,2
11150,3,13,38,51,True,6,2
11151,4,13,20,33,True,6,2
11152,5,10,18,28,True,6,2
11153,6,49,26,75,True,6,2
11154,7,57,48,105,True,6,2
11155,8,87,44,131,True,6,2
11156,9,95,79,174,True,6,2
11157,10,119,127,246,True,6,2
11158,11,145,165,310,True,6,2
11159,12,170,191,361,True,6,2
11160,13,192,230,422,True,6,2
11161,14,174,235,409,True,6,2
11162,15,177,185,362,True,6,2
11163,16,154,181,335,True,6,2
11164,17,144,143,287,True,6,2
11165,18,108,155,263,True,6,2
11166,19,74,123,197,True,6,2
11167,20,60,81,141,True,6,2
11168,21,42,44,86,True,6,2
11169,22,19,25,44,True,6,2
11170,23,10,17,27,True,6,2
11171,0,7,12,19,False,0,2
11172,1,5,17,22,False,0,2
11173,2,5,11,16,False,0,2
11174,3,11,13,24,False,0,2
11175,4,105,59,164,False,0,2
11176,5,243,153,396,False,0,2
11177,6,375,174,549,False,0,2
11178,7,274,154,428,False,0,2
11179,8,213,171,384,False,0,2
11180,9,189,181,370,False,0,2
11181,10,225,202,427,False,0,2
11182,11,207,220,427,False,0,2
11183,12,198,264,462,False,0,2
11184,13,233,335,568,False,0,2
11185,14,221,309,530,False,0,2
11186,15,193,205,398,False,0,2
11187,16,158,170,328,False,0,2
11188,17,107,147,254,False,0,2
11189,18,110,129,239,False,0,2
11190,19,100,96,196,False,0,2
11191,20,58,112,170,False,0,2
11192,21,22,36,58,False,0,2
11193,22,15,30,45,False,0,2
11194,23,9,15,24,False,0,2
11195,0,5,17,22,False,1,2
11196,1,5,15,20,False,1,2
11197,2,7,9,16,False,1,2
11198,3,19,9,28,False,1,2
11199,4,85,52,137,False,1,2
11200,5,223,148,371,False,1,2
11201,6,399,198,597,False,1,2
11202,7,277,179,456,False,1,2
11203,8,207,175,382,False,1,2
11204,9,219,181,400,False,1,2
11205,10,195,204,399,False,1,2
11206,11,227,211,438,False,1,2
11207,12,202,257,459,False,1,2
11208,13,251,309,560,False,1,2
11209,14,232,327,559,False,1,2
11210,15,175,219,394,False,1,2
11211,16,197,194,391,False,1,2
11212,17,159,161,320,False,1,2
11213,18,126,135,261,False,1,2
11214,19,74,132,206,False,1,2
11215,20,78,106,184,False,1,2
11216,21,26,51,77,False,1,2
11217,22,17,23,40,False,1,2
11218,23,14,25,39,False,1,2
11219,0,9,29,38,False,2,2
11220,1,10,40,50,False,2,2
11221,2,5,30,35,False,2,2
11222,3,10,16,26,False,2,2
11223,4,91,54,145,False,2,2
11224,5,242,160,402,False,2,2
11225,6,414,218,632,False,2,2
11226,7,301,175,476,False,2,2
11227,8,216,196,412,False,2,2
11228,9,213,189,402,False,2,2
11229,10,211,213,424,False,2,2
11230,11,200,211,411,False,2,2
11231,12,204,278,482,False,2,2
11232,13,226,325,551,False,2,2
11233,14,240,308,548,False,2,2
11234,15,204,228,432,False,2,2
11235,16,209,192,401,False,2,2
11236,17,142,171,313,False,2,2
11237,18,121,123,244,False,2,2
11238,19,135,131,266,False,2,2
11239,20,60,457,517,False,2,2
11240,21,44,262,306,False,2,2
11241,22,14,96,110,False,2,2
11242,23,13,47,60,False,2,2
11243,0,15,50,65,False,3,2
11244,1,6,45,51,False,3,2
11245,2,6,42,48,False,3,2
11246,3,19,17,36,False,3,2
11247,4,115,61,176,False,3,2
11248,5,218,160,378,False,3,2
11249,6,406,212,618,False,3,2
11250,7,255,160,415,False,3,2
11251,8,227,165,392,False,3,2
11252,9,222,159,381,False,3,2
11253,10,174,236,410,False,3,2
11254,11,191,214,405,False,3,2
11255,12,203,255,458,False,3,2
11256,13,277,312,589,False,3,2
11257,14,246,322,568,False,3,2
11258,15,199,193,392,False,3,2
11259,16,171,198,369,False,3,2
11260,17,159,183,342,False,3,2
11261,18,100,145,245,False,3,2
11262,19,103,135,238,False,3,2
11263,20,65,486,551,False,3,2
11264,21,34,272,306,False,3,2
11265,22,27,114,141,False,3,2
11266,23,21,76,97,False,3,2
11267,0,14,57,71,False,4,2
11268,1,8,49,57,False,4,2
11269,2,11,43,54,False,4,2
11270,3,15,36,51,False,4,2
11271,4,100,60,160,False,4,2
11272,5,227,150,377,False,4,2
11273,6,355,192,547,False,4,2
11274,7,258,166,424,False,4,2
11275,8,223,187,410,False,4,2
11276,9,247,213,460,False,4,2
11277,10,240,249,489,False,4,2
11278,11,269,221,490,False,4,2
11279,12,252,289,541,False,4,2
11280,13,295,355,650,False,4,2
11281,14,219,320,539,False,4,2
11282,15,149,183,332,False,4,2
11283,16,147,158,305,False,4,2
11284,17,125,154,279,False,4,2
11285,18,93,109,202,False,4,2
11286,19,73,106,179,False,4,2
11287,20,63,86,149,False,4,2
11288,21,53,75,128,False,4,2
11289,22,36,53,89,False,4,2
11290,23,27,34,61,False,4,2
11291,0,25,37,62,False,5,3
11292,1,22,48,70,False,5,3
11293,2,15,24,39,False,5,3
11294,3,8,18,26,False,5,3
11295,4,23,24,47,False,5,3
11296,5,40,21,61,False,5,3
11297,6,72,47,119,False,5,3
11298,7,95,59,154,False,5,3
11299,8,141,105,246,False,5,3
11300,9,164,145,309,False,5,3
11301,10,215,161,376,False,5,3
11302,11,198,184,382,False,5,3
11303,12,168,192,360,False,5,3
11304,13,166,235,401,False,5,3
11305,14,176,197,373,False,5,3
11306,15,154,218,372,False,5,3
11307,16,152,171,323,False,5,3
11308,17,125,124,249,False,5,3
11309,18,84,106,190,False,5,3
11310,19,74,76,150,False,5,3
11311,20,59,75,134,False,5,3
11312,21,39,70,109,False,5,3
11313,22,48,93,141,False,5,3
11314,23,43,70,113,False,5,3
11315,0,27,62,89,True,6,3
11316,1,24,63,87,True,6,3
11317,2,15,50,65,True,6,3
11318,3,11,24,35,True,6,3
11319,4,15,14,29,True,6,3
11320,5,16,16,32,True,6,3
11321,6,38,11,49,True,6,3
11322,7,57,48,105,True,6,3
11323,8,92,61,153,True,6,3
11324,9,113,74,187,True,6,3
11325,10,191,175,366,True,6,3
11326,11,155,155,310,True,6,3
11327,12,195,181,376,True,6,3
11328,13,171,236,407,True,6,3
11329,14,161,248,409,True,6,3
11330,15,158,149,307,True,6,3
11331,16,141,158,299,True,6,3
11332,17,136,162,298,True,6,3
11333,18,121,178,299,True,6,3
11334,19,94,108,202,True,6,3
11335,20,53,229,282,True,6,3
11336,21,35,148,183,True,6,3
11337,22,18,58,76,True,6,3
11338,23,11,33,44,True,6,3
11339,0,5,29,34,False,0,3
11340,1,6,22,28,False,0,3
11341,2,3,27,30,False,0,3
11342,3,11,43,54,False,0,3
11343,4,102,68,170,False,0,3
11344,5,244,167,411,False,0,3
11345,6,398,197,595,False,0,3
11346,7,261,164,425,False,0,3
11347,8,196,168,364,False,0,3
11348,9,219,179,398,False,0,3
11349,10,217,207,424,False,0,3
11350,11,200,217,417,False,0,3
11351,12,208,258,466,False,0,3
11352,13,239,310,549,False,0,3
11353,14,218,326,544,False,0,3
11354,15,223,215,438,False,0,3
11355,16,151,151,302,False,0,3
11356,17,156,165,321,False,0,3
11357,18,112,145,257,False,0,3
11358,19,94,113,207,False,0,3
11359,20,64,78,142,False,0,3
11360,21,22,34,56,False,0,3
11361,22,18,32,50,False,0,3
11362,23,10,13,23,False,0,3
11363,0,8,8,16,False,1,3
11364,1,1,6,7,False,1,3
11365,2,2,8,10,False,1,3
11366,3,11,10,21,False,1,3
11367,4,103,55,158,False,1,3
11368,5,245,152,397,False,1,3
11369,6,425,219,644,False,1,3
11370,7,275,170,445,False,1,3
11371,8,190,165,355,False,1,3
11372,9,208,181,389,False,1,3
11373,10,188,189,377,False,1,3
11374,11,199,226,425,False,1,3
11375,12,219,248,467,False,1,3
11376,13,241,325,566,False,1,3
11377,14,239,298,537,False,1,3
11378,15,196,218,414,False,1,3
11379,16,184,198,382,False,1,3
11380,17,126,166,292,False,1,3
11381,18,137,152,289,False,1,3
11382,19,90,120,210,False,1,3
11383,20,49,104,153,False,1,3
11384,21,32,50,82,False,1,3
11385,22,14,28,42,False,1,3
11386,23,17,16,33,False,1,3
11387,0,8,17,25,False,2,3
11388,1,7,19,26,False,2,3
11389,2,6,12,18,False,2,3
11390,3,7,16,23,False,2,3
11391,4,104,48,152,False,2,3
11392,5,246,178,424,False,2,3
11393,6,424,219,643,False,2,3
11394,7,264,163,427,False,2,3
11395,8,253,214,467,False,2,3
11396,9,232,160,392,False,2,3
11397,10,195,192,387,False,2,3
11398,11,206,212,418,False,2,3
11399,12,221,256,477,False,2,3
11400,13,241,307,548,False,2,3
11401,14,225,298,523,False,2,3
11402,15,221,200,421,False,2,3
11403,16,186,180,366,False,2,3
11404,17,123,171,294,False,2,3
11405,18,124,139,263,False,2,3
11406,19,104,111,215,False,2,3
11407,20,63,114,177,False,2,3
11408,21,45,70,115,False,2,3
11409,22,19,32,51,False,2,3
11410,23,15,21,36,False,2,3
11411,0,8,24,32,False,3,3
11412,1,5,17,22,False,3,3
11413,2,7,23,30,False,3,3
11414,3,13,16,29,False,3,3
11415,4,109,48,157,False,3,3
11416,5,247,171,418,False,3,3
11417,6,416,199,615,False,3,3
11418,7,266,185,451,False,3,3
11419,8,223,161,384,False,3,3
11420,9,201,193,394,False,3,3
11421,10,206,191,397,False,3,3
11422,11,233,229,462,False,3,3
11423,12,210,328,538,False,3,3
11424,13,277,342,619,False,3,3
11425,14,261,342,603,False,3,3
11426,15,226,268,494,False,3,3
11427,16,187,202,389,False,3,3
11428,17,161,154,315,False,3,3
11429,18,121,128,249,False,3,3
11430,19,118,142,260,False,3,3
11431,20,68,104,172,False,3,3
11432,21,32,41,73,False,3,3
11433,22,26,33,59,False,3,3
11434,23,21,36,57,False,3,3
11435,0,9,31,40,False,4,3
11436,1,13,32,45,False,4,3
11437,2,8,23,31,False,4,3
11438,3,14,19,33,False,4,3
11439,4,112,55,167,False,4,3
11440,5,242,151,393,False,4,3
11441,6,358,183,541,False,4,3
11442,7,231,167,398,False,4,3
11443,8,213,176,389,False,4,3
11444,9,234,204,438,False,4,3
11445,10,247,235,482,False,4,3
11446,11,254,237,491,False,4,3
11447,12,248,293,541,False,4,3
11448,13,261,343,604,False,4,3
11449,14,202,266,468,False,4,3
11450,15,163,185,348,False,4,3
11451,16,146,156,302,False,4,3
11452,17,119,142,261,False,4,3
11453,18,86,108,194,False,4,3
11454,19,92,92,184,False,4,3
11455,20,62,59,121,False,4,3
11456,21,40,53,93,False,4,3
11457,22,36,44,80,False,4,3
11458,23,23,30,53,False,4,3
11459,0,24,41,65,False,5,3
11460,1,20,45,65,False,5,3
11461,2,10,26,36,False,5,3
11462,3,12,16,28,False,5,3
11463,4,19,10,29,False,5,3
11464,5,28,19,47,False,5,3
11465,6,21,32,53,False,5,3
11466,7,61,63,124,False,5,3
11467,8,97,75,172,False,5,3
11468,9,122,98,220,False,5,3
11469,10,152,139,291,False,5,3
11470,11,132,136,268,False,5,3
11471,12,134,135,269,False,5,3
11472,13,131,169,300,False,5,3
11473,14,110,153,263,False,5,3
11474,15,122,132,254,False,5,3
11475,16,105,143,248,False,5,3
11476,17,85,119,204,False,5,3
11477,18,68,94,162,False,5,3
11478,19,64,81,145,False,5,3
11479,20,44,57,101,False,5,3
11480,21,37,63,100,False,5,3
11481,22,30,62,92,False,5,3
11482,23,18,38,56,False,5,3
11483,0,15,35,50,True,6,3
11484,1,27,43,70,True,6,3
11485,2,11,42,53,True,6,3
11486,3,21,17,38,True,6,3
11487,4,23,19,42,True,6,3
11488,5,16,24,40,True,6,3
11489,6,24,19,43,True,6,3
11490,7,47,26,73,True,6,3
11491,8,77,62,139,True,6,3
11492,9,89,75,164,True,6,3
11493,10,126,115,241,True,6,3
11494,11,123,149,272,True,6,3
11495,12,144,165,309,True,6,3
11496,13,120,165,285,True,6,3
11497,14,101,179,280,True,6,3
11498,15,107,135,242,True,6,3
11499,16,97,124,221,True,6,3
11500,17,118,123,241,True,6,3
11501,18,91,134,225,True,6,3
11502,19,57,83,140,True,6,3
11503,20,38,53,91,True,6,3
11504,21,29,42,71,True,6,3
11505,22,27,25,52,True,6,3
11506,23,8,27,35,True,6,3
11507,0,8,12,20,False,0,3
11508,1,4,8,12,False,0,3
11509,2,9,11,20,False,0,3
11510,3,12,13,25,False,0,3
11511,4,67,38,105,False,0,3
11512,5,137,96,233,False,0,3
11513,6,197,117,314,False,0,3
11514,7,195,118,313,False,0,3
11515,8,169,144,313,False,0,3
11516,9,173,139,312,False,0,3
11517,10,190,170,360,False,0,3
11518,11,162,185,347,False,0,3
11519,12,178,218,396,False,0,3
11520,13,156,230,386,False,0,3
11521,14,167,185,352,False,0,3
11522,15,156,167,323,False,0,3
11523,16,128,140,268,False,0,3
11524,17,86,107,193,False,0,3
11525,18,73,87,160,False,0,3
11526,19,70,83,153,False,0,3
11527,20,55,42,97,False,0,3
11528,21,35,42,77,False,0,3
11529,22,20,24,44,False,0,3
11530,23,10,14,24,False,0,3
11531,0,10,13,23,False,1,3
11532,1,5,13,18,False,1,3
11533,2,5,8,13,False,1,3
11534,3,13,8,21,False,1,3
11535,4,65,37,102,False,1,3
11536,5,136,110,246,False,1,3
11537,6,192,102,294,False,1,3
11538,7,154,110,264,False,1,3
11539,8,143,137,280,False,1,3
11540,9,178,150,328,False,1,3
11541,10,180,182,362,False,1,3
11542,11,165,202,367,False,1,3
11543,12,196,231,427,False,1,3
11544,13,188,206,394,False,1,3
11545,14,166,180,346,False,1,3
11546,15,117,151,268,False,1,3
11547,16,106,118,224,False,1,3
11548,17,103,111,214,False,1,3
11549,18,98,101,199,False,1,3
11550,19,76,94,170,False,1,3
11551,20,58,65,123,False,1,3
11552,21,28,45,73,False,1,3
11553,22,22,28,50,False,1,3
11554,23,11,24,35,False,1,3
11555,0,15,29,44,False,2,3
11556,1,5,22,27,False,2,3
11557,2,6,15,21,False,2,3
11558,3,11,12,23,False,2,3
11559,4,47,24,71,False,2,3
11560,5,117,77,194,False,2,3
11561,6,132,83,215,False,2,3
11562,7,127,91,218,False,2,3
11563,8,129,110,239,False,2,3
11564,9,188,179,367,False,2,3
11565,10,205,198,403,False,2,3
11566,11,145,196,341,False,2,3
11567,12,158,157,315,False,2,3
11568,13,109,147,256,False,2,3
11569,14,132,132,264,False,2,3
11570,15,124,136,260,False,2,3
11571,16,101,99,200,False,2,3
11572,17,69,108,177,False,2,3
11573,18,82,101,183,False,2,3
11574,19,67,59,126,False,2,3
11575,20,38,50,88,False,2,3
11576,21,27,44,71,False,2,3
11577,22,14,34,48,False,2,3
11578,23,15,29,44,False,2,3
11579,0,13,31,44,True,3,3
11580,1,8,25,33,True,3,3
11581,2,9,13,22,True,3,3
11582,3,9,11,20,True,3,3
11583,4,20,11,31,True,3,3
11584,5,17,18,35,True,3,3
11585,6,28,17,45,True,3,3
11586,7,27,20,47,True,3,3
11587,8,54,40,94,True,3,3
11588,9,90,69,159,True,3,3
11589,10,82,96,178,True,3,3
11590,11,99,127,226,True,3,3
11591,12,90,127,217,True,3,3
11592,13,104,129,233,True,3,3
11593,14,81,118,199,True,3,3
11594,15,83,136,219,True,3,3
11595,16,96,96,192,True,3,3
11596,17,66,104,170,True,3,3
11597,18,70,89,159,True,3,3
11598,19,50,73,123,True,3,3
11599,20,31,41,72,True,3,3
11600,21,25,48,73,True,3,3
11601,22,22,37,59,True,3,3
11602,23,14,36,50,True,3,3
11603,0,14,20,34,True,4,3
11604,1,9,37,46,True,4,3
11605,2,5,16,21,True,4,3
11606,3,7,4,11,True,4,3
11607,4,15,11,26,True,4,3
11608,5,23,17,40,True,4,3
11609,6,23,20,43,True,4,3
11610,7,39,29,68,True,4,3
11611,8,61,38,99,True,4,3
11612,9,85,64,149,True,4,3
11613,10,82,74,156,True,4,3
11614,11,95,128,223,True,4,3
11615,12,107,124,231,True,4,3
11616,13,115,143,258,True,4,3
11617,14,89,129,218,True,4,3
11618,15,100,120,220,True,4,3
11619,16,84,114,198,True,4,3
11620,17,64,106,170,True,4,3
11621,18,65,98,163,True,4,3
11622,19,57,87,144,True,4,3
11623,20,43,72,115,True,4,3
11624,21,28,51,79,True,4,3
11625,22,16,36,52,True,4,3
11626,23,12,34,46,True,4,3
11627,0,17,25,42,False,5,3
11628,1,7,24,31,False,5,3
11629,2,5,17,22,False,5,3
11630,3,8,10,18,False,5,3
11631,4,12,9,21,False,5,3
11632,5,23,16,39,False,5,3
11633,6,24,21,45,False,5,3
11634,7,52,32,84,False,5,3
11635,8,96,80,176,False,5,3
11636,9,103,138,241,False,5,3
11637,10,97,157,254,False,5,3
11638,11,80,111,191,False,5,3
11639,12,107,103,210,False,5,3
11640,13,98,137,235,False,5,3
11641,14,93,114,207,False,5,3
11642,15,84,91,175,False,5,3
11643,16,89,92,181,False,5,3
11644,17,63,66,129,False,5,3
11645,18,81,95,176,False,5,3
11646,19,65,68,133,False,5,3
11647,20,34,44,78,False,5,3
11648,21,45,46,91,False,5,3
11649,22,36,62,98,False,5,3
11650,23,14,33,47,False,5,3
11651,0,21,39,60,True,6,3
11652,1,17,40,57,True,6,3
11653,2,22,48,70,True,6,3
11654,3,11,20,31,True,6,3
11655,4,14,10,24,True,6,3
11656,5,12,16,28,True,6,3
11657,6,14,13,27,True,6,3
11658,7,40,17,57,True,6,3
11659,8,61,82,143,True,6,3
11660,9,43,55,98,True,6,3
11661,10,95,89,184,True,6,3
11662,11,86,109,195,True,6,3
11663,12,111,133,244,True,6,3
11664,13,103,154,257,True,6,3
11665,14,105,155,260,True,6,3
11666,15,104,124,228,True,6,3
11667,16,100,117,217,True,6,3
11668,17,122,135,257,True,6,3
11669,18,106,123,229,True,6,3
11670,19,84,97,181,True,6,3
11671,20,53,67,120,True,6,3
11672,21,39,46,85,True,6,3
11673,22,23,25,48,True,6,3
11674,23,11,24,35,True,6,3
11675,0,12,18,30,True,0,3
11676,1,11,21,32,True,0,3
11677,2,6,7,13,True,0,3
11678,3,10,12,22,True,0,3
11679,4,11,9,20,True,0,3
11680,5,15,13,28,True,0,3
11681,6,24,18,42,True,0,3
11682,7,42,39,81,True,0,3
11683,8,64,55,119,True,0,3
11684,9,86,79,165,True,0,3
11685,10,116,130,246,True,0,3
11686,11,130,151,281,True,0,3
11687,12,143,158,301,True,0,3
11688,13,138,171,309,True,0,3
11689,14,137,114,251,True,0,3
11690,15,129,167,296,True,0,3
11691,16,145,132,277,True,0,3
11692,17,121,149,270,True,0,3
11693,18,163,142,305,True,0,3
11694,19,93,124,217,True,0,3
11695,20,44,56,100,True,0,3
11696,21,37,36,73,True,0,3
11697,22,19,33,52,True,0,3
11698,23,10,19,29,True,0,3
11699,0,6,10,16,False,1,3
11700,1,8,9,17,False,1,3
11701,2,2,5,7,False,1,3
11702,3,17,16,33,False,1,3
11703,4,103,59,162,False,1,3
11704,5,253,157,410,False,1,3
11705,6,359,197,556,False,1,3
11706,7,238,174,412,False,1,3
11707,8,209,183,392,False,1,3
11708,9,206,184,390,False,1,3
11709,10,197,233,430,False,1,3
11710,11,220,208,428,False,1,3
11711,12,220,242,462,False,1,3
11712,13,281,333,614,False,1,3
11713,14,268,419,687,False,1,3
11714,15,176,184,360,False,1,3
11715,16,153,150,303,False,1,3
11716,17,152,168,320,False,1,3
11717,18,123,171,294,False,1,3
11718,19,108,148,256,False,1,3
11719,20,62,98,160,False,1,3
11720,21,41,49,90,False,1,3
11721,22,12,29,41,False,1,3
11722,23,10,19,29,False,1,3
11723,0,7,9,16,False,2,3
11724,1,8,14,22,False,2,3
11725,2,3,12,15,False,2,3
11726,3,13,18,31,False,2,3
11727,4,107,50,157,False,2,3
11728,5,241,160,401,False,2,3
11729,6,385,219,604,False,2,3
11730,7,245,170,415,False,2,3
11731,8,209,185,394,False,2,3
11732,9,196,184,380,False,2,3
11733,10,180,216,396,False,2,3
11734,11,224,208,432,False,2,3
11735,12,214,228,442,False,2,3
11736,13,252,321,573,False,2,3
11737,14,254,289,543,False,2,3
11738,15,208,226,434,False,2,3
11739,16,177,158,335,False,2,3
11740,17,144,207,351,False,2,3
11741,18,108,156,264,False,2,3
11742,19,81,115,196,False,2,3
11743,20,42,95,137,False,2,3
11744,21,34,46,80,False,2,3
11745,22,16,31,47,False,2,3
11746,23,11,31,42,False,2,3
11747,0,5,13,18,False,3,3
11748,1,6,22,28,False,3,3
11749,2,5,17,22,False,3,3
11750,3,15,14,29,False,3,3
11751,4,108,58,166,False,3,3
11752,5,241,179,420,False,3,3
11753,6,401,201,602,False,3,3
11754,7,264,155,419,False,3,3
11755,8,232,179,411,False,3,3
11756,9,201,188,389,False,3,3
11757,10,223,183,406,False,3,3
11758,11,221,229,450,False,3,3
11759,12,206,272,478,False,3,3
11760,13,247,347,594,False,3,3
11761,14,260,463,723,False,3,3
11762,15,212,257,469,False,3,3
11763,16,181,182,363,False,3,3
11764,17,160,180,340,False,3,3
11765,18,116,155,271,False,3,3
11766,19,99,133,232,False,3,3
11767,20,62,121,183,False,3,3
11768,21,35,59,94,False,3,3
11769,22,15,31,46,False,3,3
11770,23,10,26,36,False,3,3
11771,0,11,21,32,False,4,3
11772,1,7,25,32,False,4,3
11773,2,3,14,17,False,4,3
11774,3,9,17,26,False,4,3
11775,4,97,51,148,False,4,3
11776,5,241,146,387,False,4,3
11777,6,370,181,551,False,4,3
11778,7,245,172,417,False,4,3
11779,8,200,182,382,False,4,3
11780,9,235,206,441,False,4,3
11781,10,224,219,443,False,4,3
11782,11,200,262,462,False,4,3
11783,12,241,274,515,False,4,3
11784,13,262,329,591,False,4,3
11785,14,228,289,517,False,4,3
11786,15,162,201,363,False,4,3
11787,16,153,148,301,False,4,3
11788,17,133,154,287,False,4,3
11789,18,88,117,205,False,4,3
11790,19,96,95,191,False,4,3
11791,20,47,77,124,False,4,3
11792,21,38,63,101,False,4,3
11793,22,28,54,82,False,4,3
11794,23,17,33,50,False,4,3
11795,0,17,36,53,False,5,3
11796,1,14,32,46,False,5,3
11797,2,8,28,36,False,5,3
11798,3,9,16,25,False,5,3
11799,4,19,14,33,False,5,3
11800,5,51,31,82,False,5,3
11801,6,43,38,81,False,5,3
11802,7,69,59,128,False,5,3
11803,8,140,83,223,False,5,3
11804,9,158,138,296,False,5,3
11805,10,181,128,309,False,5,3
11806,11,152,153,305,False,5,3
11807,12,157,174,331,False,5,3
11808,13,192,221,413,False,5,3
11809,14,176,187,363,False,5,3
11810,15,148,244,392,False,5,3
11811,16,138,167,305,False,5,3
11812,17,113,131,244,False,5,3
11813,18,95,116,211,False,5,3
11814,19,59,88,147,False,5,3
11815,20,62,70,132,False,5,3
11816,21,43,80,123,False,5,3
11817,22,43,71,114,False,5,3
11818,23,43,53,96,False,5,3
11819,0,33,53,86,True,6,3
11820,1,22,55,77,True,6,3
11821,2,16,55,71,True,6,3
11822,3,16,23,39,True,6,3
11823,4,14,15,29,True,6,3
11824,5,16,16,32,True,6,3
11825,6,26,17,43,True,6,3
11826,7,58,41,99,True,6,3
11827,8,121,54,175,True,6,3
11828,9,101,94,195,True,6,3
11829,10,161,126,287,True,6,3
11830,11,126,170,296,True,6,3
11831,12,188,160,348,True,6,3
11832,13,154,219,373,True,6,3
11833,14,174,206,380,True,6,3
11834,15,149,176,325,True,6,3
11835,16,130,172,302,True,6,3
11836,17,145,157,302,True,6,3
11837,18,124,151,275,True,6,3
11838,19,62,85,147,True,6,3
11839,20,66,81,147,True,6,3
11840,21,38,50,88,True,6,3
11841,22,21,28,49,True,6,3
11842,23,12,21,33,True,6,3
11843,0,6,13,19,False,0,3
11844,1,6,10,16,False,0,3
11845,2,6,11,17,False,0,3
11846,3,17,8,25,False,0,3
11847,4,103,56,159,False,0,3
11848,5,230,151,381,False,0,3
11849,6,414,191,605,False,0,3
11850,7,232,164,396,False,0,3
11851,8,207,156,363,False,0,3
11852,9,217,180,397,False,0,3
11853,10,211,211,422,False,0,3
11854,11,181,192,373,False,0,3
11855,12,224,302,526,False,0,3
11856,13,274,330,604,False,0,3
11857,14,240,282,522,False,0,3
11858,15,195,209,404,False,0,3
11859,16,201,169,370,False,0,3
11860,17,131,165,296,False,0,3
11861,18,118,142,260,False,0,3
11862,19,76,133,209,False,0,3
11863,20,58,99,157,False,0,3
11864,21,26,56,82,False,0,3
11865,22,19,26,45,False,0,3
11866,23,15,12,27,False,0,3
11867,0,5,11,16,False,1,3
11868,1,3,10,13,False,1,3
11869,2,1,12,13,False,1,3
11870,3,21,9,30,False,1,3
11871,4,96,50,146,False,1,3
11872,5,248,158,406,False,1,3
11873,6,400,217,617,False,1,3
11874,7,241,166,407,False,1,3
11875,8,202,168,370,False,1,3
11876,9,195,178,373,False,1,3
11877,10,205,181,386,False,1,3
11878,11,192,224,416,False,1,3
11879,12,225,278,503,False,1,3
11880,13,244,312,556,False,1,3
11881,14,243,297,540,False,1,3
11882,15,202,219,421,False,1,3
11883,16,225,194,419,False,1,3
11884,17,156,175,331,False,1,3
11885,18,128,148,276,False,1,3
11886,19,110,164,274,False,1,3
11887,20,76,105,181,False,1,3
11888,21,36,82,118,False,1,3
11889,22,12,34,46,False,1,3
11890,23,15,33,48,False,1,3
11891,0,9,30,39,False,2,3
11892,1,5,16,21,False,2,3
11893,2,4,15,19,False,2,3
11894,3,20,13,33,False,2,3
11895,4,149,78,227,False,2,3
11896,5,230,150,380,False,2,3
11897,6,316,170,486,False,2,3
11898,7,250,145,395,False,2,3
11899,8,187,146,333,False,2,3
11900,9,213,170,383,False,2,3
11901,10,226,204,430,False,2,3
11902,11,229,235,464,False,2,3
11903,12,212,300,512,False,2,3
11904,13,272,287,559,False,2,3
11905,14,239,270,509,False,2,3
11906,15,212,238,450,False,2,3
11907,16,193,186,379,False,2,3
11908,17,148,188,336,False,2,3
11909,18,127,147,274,False,2,3
11910,19,99,128,227,False,2,3
11911,20,70,420,490,False,2,3
11912,21,32,274,306,False,2,3
11913,22,19,93,112,False,2,3
11914,23,15,60,75,False,2,3
11915,0,5,39,44,False,3,3
11916,1,6,14,20,False,3,3
11917,2,7,13,20,False,3,3
11918,3,15,14,29,False,3,3
11919,4,104,67,171,False,3,3
11920,5,257,157,414,False,3,3
11921,6,379,204,583,False,3,3
11922,7,273,188,461,False,3,3
11923,8,240,190,430,False,3,3
11924,9,193,179,372,False,3,3
11925,10,237,198,435,False,3,3
11926,11,235,250,485,False,3,3
11927,12,230,259,489,False,3,3
11928,13,271,339,610,False,3,3
11929,14,241,302,543,False,3,3
11930,15,239,242,481,False,3,3
11931,16,207,214,421,False,3,3
11932,17,170,197,367,False,3,3
11933,18,142,151,293,False,3,3
11934,19,112,139,251,False,3,3
11935,20,59,119,178,False,3,3
11936,21,81,79,160,False,3,3
11937,22,35,40,75,False,3,3
11938,23,9,32,41,False,3,3
11939,0,5,30,35,False,4,3
11940,1,6,27,33,False,4,3
11941,2,9,13,22,False,4,3
11942,3,14,14,28,False,4,3
11943,4,102,57,159,False,4,3
11944,5,253,159,412,False,4,3
11945,6,360,189,549,False,4,3
11946,7,270,191,461,False,4,3
11947,8,258,201,459,False,4,3
11948,9,231,203,434,False,4,3
11949,10,266,249,515,False,4,3
11950,11,267,281,548,False,4,3
11951,12,267,327,594,False,4,3
11952,13,299,358,657,False,4,3
11953,14,229,276,505,False,4,3
11954,15,188,221,409,False,4,3
11955,16,172,216,388,False,4,3
11956,17,140,175,315,False,4,3
11957,18,117,136,253,False,4,3
11958,19,98,116,214,False,4,3
11959,20,77,93,170,False,4,3
11960,21,54,64,118,False,4,3
11961,22,46,56,102,False,4,3
11962,23,21,45,66,False,4,3
11963,0,20,35,55,False,5,3
11964,1,8,38,46,False,5,3
11965,2,17,29,46,False,5,3
11966,3,12,16,28,False,5,3
11967,4,27,20,47,False,5,3
11968,5,30,25,55,False,5,3
11969,6,70,45,115,False,5,3
11970,7,131,44,175,False,5,3
11971,8,172,97,269,False,5,3
11972,9,179,105,284,False,5,3
11973,10,177,136,313,False,5,3
11974,11,147,156,303,False,5,3
11975,12,172,197,369,False,5,3
11976,13,142,178,320,False,5,3
11977,14,133,177,310,False,5,3
11978,15,131,190,321,False,5,3
11979,16,122,129,251,False,5,3
11980,17,110,112,222,False,5,3
11981,18,122,116,238,False,5,3
11982,19,84,110,194,False,5,3
11983,20,55,88,143,False,5,3
11984,21,35,85,120,False,5,3
11985,22,45,74,119,False,5,3
11986,23,27,52,79,False,5,3
11987,0,22,51,73,True,6,3
11988,1,22,64,86,True,6,3
11989,2,24,42,66,True,6,3
11990,3,21,30,51,True,6,3
11991,4,14,19,33,True,6,3
11992,5,20,22,42,True,6,3
11993,6,39,20,59,True,6,3
11994,7,50,42,92,True,6,3
11995,8,99,78,177,True,6,3
11996,9,144,117,261,True,6,3
11997,10,144,154,298,True,6,3
11998,11,200,193,393,True,6,3
11999,12,171,214,385,True,6,3
12000,13,143,209,352,True,6,3
12001,14,137,178,315,True,6,3
12002,15,143,175,318,True,6,3
12003,16,153,165,318,True,6,3
12004,17,164,177,341,True,6,3
12005,18,136,199,335,True,6,3
12006,19,87,149,236,True,6,3
12007,20,60,114,174,True,6,3
12008,21,41,53,94,True,6,3
12009,22,32,50,82,True,6,3
12010,23,23,45,68,True,6,3
12011,0,21,47,68,True,0,4
12012,1,17,48,65,True,0,4
12013,2,6,25,31,True,0,4
12014,3,10,8,18,True,0,4
12015,4,22,15,37,True,0,4
12016,5,21,18,39,True,0,4
12017,6,25,26,51,True,0,4
12018,7,55,49,104,True,0,4
12019,8,93,65,158,True,0,4
12020,9,100,105,205,True,0,4
12021,10,122,146,268,True,0,4
12022,11,148,139,287,True,0,4
12023,12,155,152,307,True,0,4
12024,13,171,217,388,True,0,4
12025,14,156,189,345,True,0,4
12026,15,145,193,338,True,0,4
12027,16,175,194,369,True,0,4
12028,17,168,182,350,True,0,4
12029,18,135,157,292,True,0,4
12030,19,95,125,220,True,0,4
12031,20,57,90,147,True,0,4
12032,21,47,47,94,True,0,4
12033,22,28,28,56,True,0,4
12034,23,8,25,33,True,0,4
12035,0,6,13,19,False,1,4
12036,1,6,16,22,False,1,4
12037,2,4,9,13,False,1,4
12038,3,21,17,38,False,1,4
12039,4,103,55,158,False,1,4
12040,5,250,168,418,False,1,4
12041,6,367,193,560,False,1,4
12042,7,275,168,443,False,1,4
12043,8,226,200,426,False,1,4
12044,9,216,220,436,False,1,4
12045,10,218,228,446,False,1,4
12046,11,249,232,481,False,1,4
12047,12,214,279,493,False,1,4
12048,13,262,342,604,False,1,4
12049,14,250,272,522,False,1,4
12050,15,177,213,390,False,1,4
12051,16,200,166,366,False,1,4
12052,17,126,143,269,False,1,4
12053,18,129,171,300,False,1,4
12054,19,101,124,225,False,1,4
12055,20,77,115,192,False,1,4
12056,21,33,74,107,False,1,4
12057,22,23,25,48,False,1,4
12058,23,14,29,43,False,1,4
12059,0,4,22,26,False,2,4
12060,1,10,21,31,False,2,4
12061,2,3,11,14,False,2,4
12062,3,13,20,33,False,2,4
12063,4,101,64,165,False,2,4
12064,5,230,152,382,False,2,4
12065,6,386,195,581,False,2,4
12066,7,256,178,434,False,2,4
12067,8,214,169,383,False,2,4
12068,9,215,202,417,False,2,4
12069,10,229,213,442,False,2,4
12070,11,238,225,463,False,2,4
12071,12,243,285,528,False,2,4
12072,13,249,349,598,False,2,4
12073,14,243,294,537,False,2,4
12074,15,187,219,406,False,2,4
12075,16,180,180,360,False,2,4
12076,17,145,150,295,False,2,4
12077,18,108,156,264,False,2,4
12078,19,106,133,239,False,2,4
12079,20,53,392,445,False,2,4
12080,21,39,327,366,False,2,4
12081,22,15,105,120,False,2,4
12082,23,11,52,63,False,2,4
12083,0,7,45,52,False,3,4
12084,1,9,23,32,False,3,4
12085,2,10,12,22,False,3,4
12086,3,6,13,19,False,3,4
12087,4,93,51,144,False,3,4
12088,5,244,177,421,False,3,4
12089,6,374,199,573,False,3,4
12090,7,229,180,409,False,3,4
12091,8,223,199,422,False,3,4
12092,9,216,193,409,False,3,4
12093,10,211,249,460,False,3,4
12094,11,214,253,467,False,3,4
12095,12,220,277,497,False,3,4
12096,13,288,380,668,False,3,4
12097,14,254,328,582,False,3,4
12098,15,186,241,427,False,3,4
12099,16,208,170,378,False,3,4
12100,17,148,167,315,False,3,4
12101,18,129,164,293,False,3,4
12102,19,94,158,252,False,3,4
12103,20,67,109,176,False,3,4
12104,21,38,72,110,False,3,4
12105,22,20,31,51,False,3,4
12106,23,11,31,42,False,3,4
12107,0,15,22,37,False,4,4
12108,1,8,22,30,False,4,4
12109,2,3,16,19,False,4,4
12110,3,21,15,36,False,4,4
12111,4,110,63,173,False,4,4
12112,5,236,156,392,False,4,4
12113,6,347,192,539,False,4,4
12114,7,255,196,451,False,4,4
12115,8,234,195,429,False,4,4
12116,9,205,208,413,False,4,4
12117,10,208,241,449,False,4,4
12118,11,233,256,489,False,4,4
12119,12,251,318,569,False,4,4
12120,13,255,365,620,False,4,4
12121,14,203,302,505,False,4,4
12122,15,184,204,388,False,4,4
12123,16,176,153,329,False,4,4
12124,17,125,142,267,False,4,4
12125,18,104,131,235,False,4,4
12126,19,80,128,208,False,4,4
12127,20,79,89,168,False,4,4
12128,21,43,74,117,False,4,4
12129,22,22,50,72,False,4,4
12130,23,22,37,59,False,4,4
12131,0,15,36,51,False,5,4
12132,1,15,30,45,False,5,4
12133,2,7,13,20,False,5,4
12134,3,14,17,31,False,5,4
12135,4,24,14,38,False,5,4
12136,5,36,34,70,False,5,4
12137,6,65,36,101,False,5,4
12138,7,86,65,151,False,5,4
12139,8,138,112,250,False,5,4
12140,9,131,121,252,False,5,4
12141,10,144,161,305,False,5,4
12142,11,165,147,312,False,5,4
12143,12,141,153,294,False,5,4
12144,13,113,178,291,False,5,4
12145,14,138,147,285,False,5,4
12146,15,138,180,318,False,5,4
12147,16,137,144,281,False,5,4
12148,17,117,136,253,False,5,4
12149,18,90,116,206,False,5,4
12150,19,76,95,171,False,5,4
12151,20,49,93,142,False,5,4
12152,21,55,68,123,False,5,4
12153,22,38,53,91,False,5,4
12154,23,39,45,84,False,5,4
12155,0,29,46,75,True,6,4
12156,1,16,44,60,True,6,4
12157,2,13,42,55,True,6,4
12158,3,6,13,19,True,6,4
12159,4,12,12,24,True,6,4
12160,5,15,12,27,True,6,4
12161,6,44,33,77,True,6,4
12162,7,52,41,93,True,6,4
12163,8,111,83,194,True,6,4
12164,9,131,107,238,True,6,4
12165,10,131,156,287,True,6,4
12166,11,143,166,309,True,6,4
12167,12,183,186,369,True,6,4
12168,13,137,173,310,True,6,4
12169,14,170,234,404,True,6,4
12170,15,145,171,316,True,6,4
12171,16,152,179,331,True,6,4
12172,17,190,214,404,True,6,4
12173,18,126,185,311,True,6,4
12174,19,94,140,234,True,6,4
12175,20,79,96,175,True,6,4
12176,21,52,62,114,True,6,4
12177,22,22,25,47,True,6,4
12178,23,13,10,23,True,6,4
12179,0,11,15,26,False,0,4
12180,1,4,13,17,False,0,4
12181,2,5,14,19,False,0,4
12182,3,15,10,25,False,0,4
12183,4,109,53,162,False,0,4
12184,5,274,154,428,False,0,4
12185,6,398,201,599,False,0,4
12186,7,251,171,422,False,0,4
12187,8,199,191,390,False,0,4
12188,9,206,191,397,False,0,4
12189,10,210,189,399,False,0,4
12190,11,191,211,402,False,0,4
12191,12,225,286,511,False,0,4
12192,13,234,346,580,False,0,4
12193,14,230,304,534,False,0,4
12194,15,206,198,404,False,0,4
12195,16,171,177,348,False,0,4
12196,17,157,158,315,False,0,4
12197,18,117,140,257,False,0,4
12198,19,94,140,234,False,0,4
12199,20,51,109,160,False,0,4
12200,21,31,66,97,False,0,4
12201,22,24,32,56,False,0,4
12202,23,8,21,29,False,0,4
12203,0,4,20,24,False,1,4
12204,1,9,12,21,False,1,4
12205,2,7,20,27,False,1,4
12206,3,16,6,22,False,1,4
12207,4,102,54,156,False,1,4
12208,5,246,166,412,False,1,4
12209,6,350,196,546,False,1,4
12210,7,233,175,408,False,1,4
12211,8,215,190,405,False,1,4
12212,9,203,185,388,False,1,4
12213,10,224,190,414,False,1,4
12214,11,208,256,464,False,1,4
12215,12,215,288,503,False,1,4
12216,13,258,307,565,False,1,4
12217,14,222,302,524,False,1,4
12218,15,227,186,413,False,1,4
12219,16,176,167,343,False,1,4
12220,17,167,163,330,False,1,4
12221,18,118,152,270,False,1,4
12222,19,100,135,235,False,1,4
12223,20,55,87,142,False,1,4
12224,21,31,106,137,False,1,4
12225,22,14,47,61,False,1,4
12226,23,9,20,29,False,1,4
12227,0,7,24,31,False,2,4
12228,1,4,15,19,False,2,4
12229,2,7,15,22,False,2,4
12230,3,15,15,30,False,2,4
12231,4,103,47,150,False,2,4
12232,5,259,179,438,False,2,4
12233,6,366,208,574,False,2,4
12234,7,263,151,414,False,2,4
12235,8,210,185,395,False,2,4
12236,9,228,196,424,False,2,4
12237,10,187,215,402,False,2,4
12238,11,201,224,425,False,2,4
12239,12,207,275,482,False,2,4
12240,13,260,320,580,False,2,4
12241,14,233,273,506,False,2,4
12242,15,173,216,389,False,2,4
12243,16,138,181,319,False,2,4
12244,17,157,168,325,False,2,4
12245,18,104,111,215,False,2,4
12246,19,90,117,207,False,2,4
12247,20,71,112,183,False,2,4
12248,21,22,71,93,False,2,4
12249,22,19,35,54,False,2,4
12250,23,10,18,28,False,2,4
12251,0,5,16,21,False,3,4
12252,1,4,15,19,False,3,4
12253,2,2,12,14,False,3,4
12254,3,14,10,24,False,3,4
12255,4,98,52,150,False,3,4
12256,5,243,165,408,False,3,4
12257,6,373,220,593,False,3,4
12258,7,275,173,448,False,3,4
12259,8,205,167,372,False,3,4
12260,9,192,187,379,False,3,4
12261,10,216,211,427,False,3,4
12262,11,209,213,422,False,3,4
12263,12,226,308,534,False,3,4
12264,13,269,331,600,False,3,4
12265,14,212,284,496,False,3,4
12266,15,196,200,396,False,3,4
12267,16,164,165,329,False,3,4
12268,17,145,174,319,False,3,4
12269,18,116,149,265,False,3,4
12270,19,93,136,229,False,3,4
12271,20,60,118,178,False,3,4
12272,21,41,67,108,False,3,4
12273,22,32,36,68,False,3,4
12274,23,13,22,35,False,3,4
12275,0,8,20,28,False,4,4
12276,1,8,22,30,False,4,4
12277,2,10,24,34,False,4,4
12278,3,16,13,29,False,4,4
12279,4,105,56,161,False,4,4
12280,5,255,164,419,False,4,4
12281,6,368,196,564,False,4,4
12282,7,262,199,461,False,4,4
12283,8,198,187,385,False,4,4
12284,9,202,193,395,False,4,4
12285,10,233,214,447,False,4,4
12286,11,213,230,443,False,4,4
12287,12,233,306,539,False,4,4
12288,13,265,325,590,False,4,4
12289,14,246,434,680,False,4,4
12290,15,171,230,401,False,4,4
12291,16,160,162,322,False,4,4
12292,17,140,151,291,False,4,4
12293,18,106,130,236,False,4,4
12294,19,91,120,211,False,4,4
12295,20,65,83,148,False,4,4
12296,21,46,65,111,False,4,4
12297,22,49,64,113,False,4,4
12298,23,26,41,67,False,4,4
12299,0,32,42,74,False,5,4
12300,1,21,47,68,False,5,4
12301,2,4,30,34,False,5,4
12302,3,17,21,38,False,5,4
12303,4,19,18,37,False,5,4
12304,5,25,27,52,False,5,4
12305,6,42,37,79,False,5,4
12306,7,61,71,132,False,5,4
12307,8,119,86,205,False,5,4
12308,9,139,114,253,False,5,4
12309,10,152,161,313,False,5,4
12310,11,143,167,310,False,5,4
12311,12,142,162,304,False,5,4
12312,13,122,173,295,False,5,4
12313,14,142,175,317,False,5,4
12314,15,112,169,281,False,5,4
12315,16,139,163,302,False,5,4
12316,17,106,166,272,False,5,4
12317,18,85,94,179,False,5,4
12318,19,67,79,146,False,5,4
12319,20,93,70,163,False,5,4
12320,21,55,65,120,False,5,4
12321,22,40,68,108,False,5,4
12322,23,30,66,96,False,5,4
12323,0,24,59,83,True,6,4
12324,1,22,92,114,True,6,4
12325,2,26,54,80,True,6,4
12326,3,13,33,46,True,6,4
12327,4,17,20,37,True,6,4
12328,5,20,19,39,True,6,4
12329,6,34,26,60,True,6,4
12330,7,49,62,111,True,6,4
12331,8,98,70,168,True,6,4
12332,9,136,80,216,True,6,4
12333,10,163,143,306,True,6,4
12334,11,150,224,374,True,6,4
12335,12,163,223,386,True,6,4
12336,13,162,223,385,True,6,4
12337,14,158,223,381,True,6,4
12338,15,179,189,368,True,6,4
12339,16,171,197,368,True,6,4
12340,17,156,184,340,True,6,4
12341,18,138,189,327,True,6,4
12342,19,99,136,235,True,6,4
12343,20,70,167,237,True,6,4
12344,21,48,74,122,True,6,4
12345,22,24,43,67,True,6,4
12346,23,10,26,36,True,6,4
12347,0,5,11,16,False,0,4
12348,1,8,23,31,False,0,4
12349,2,5,8,13,False,0,4
12350,3,20,19,39,False,0,4
12351,4,112,62,174,False,0,4
12352,5,238,150,388,False,0,4
12353,6,388,213,601,False,0,4
12354,7,286,176,462,False,0,4
12355,8,197,192,389,False,0,4
12356,9,217,195,412,False,0,4
12357,10,227,222,449,False,0,4
12358,11,216,248,464,False,0,4
12359,12,236,286,522,False,0,4
12360,13,283,341,624,False,0,4
12361,14,268,309,577,False,0,4
12362,15,181,224,405,False,0,4
12363,16,199,181,380,False,0,4
12364,17,155,166,321,False,0,4
12365,18,151,162,313,False,0,4
12366,19,112,157,269,False,0,4
12367,20,85,104,189,False,0,4
12368,21,37,56,93,False,0,4
12369,22,20,41,61,False,0,4
12370,23,9,19,28,False,0,4
12371,0,9,20,29,False,1,4
12372,1,8,16,24,False,1,4
12373,2,6,2,8,False,1,4
12374,3,24,22,46,False,1,4
12375,4,121,52,173,False,1,4
12376,5,271,155,426,False,1,4
12377,6,381,212,593,False,1,4
12378,7,279,188,467,False,1,4
12379,8,218,195,413,False,1,4
12380,9,215,219,434,False,1,4
12381,10,244,223,467,False,1,4
12382,11,221,269,490,False,1,4
12383,12,243,310,553,False,1,4
12384,13,287,371,658,False,1,4
12385,14,242,455,697,False,1,4
12386,15,204,422,626,False,1,4
12387,16,163,149,312,False,1,4
12388,17,150,142,292,False,1,4
12389,18,223,172,395,False,1,4
12390,19,124,123,247,False,1,4
12391,20,71,116,187,False,1,4
12392,21,47,74,121,False,1,4
12393,22,31,61,92,False,1,4
12394,23,29,34,63,False,1,4
12395,0,20,32,52,True,2,4
12396,1,20,51,71,True,2,4
12397,2,19,27,46,True,2,4
12398,3,13,19,32,True,2,4
12399,4,49,23,72,True,2,4
12400,5,91,59,150,True,2,4
12401,6,149,111,260,True,2,4
12402,7,350,164,514,True,2,4
12403,8,392,219,611,True,2,4
12404,9,241,255,496,True,2,4
12405,10,153,245,398,True,2,4
12406,11,128,383,511,True,2,4
12407,12,139,264,403,True,2,4
12408,13,116,240,356,True,2,4
12409,14,115,198,313,True,2,4
12410,15,116,182,298,True,2,4
12411,16,143,205,348,True,2,4
12412,17,130,197,327,True,2,4
12413,18,99,183,282,True,2,4
12414,19,89,173,262,True,2,4
12415,20,75,138,213,True,2,4
12416,21,51,139,190,True,2,4
12417,22,39,74,113,True,2,4
12418,23,33,78,111,True,2,4
12419,0,16,50,66,False,3,4
12420,1,24,45,69,False,3,4
12421,2,9,38,47,False,3,4
12422,3,16,24,40,False,3,4
12423,4,117,52,169,False,3,4
12424,5,242,154,396,False,3,4
12425,6,338,196,534,False,3,4
12426,7,254,151,405,False,3,4
12427,8,237,174,411,False,3,4
12428,9,208,187,395,False,3,4
12429,10,216,218,434,False,3,4
12430,11,214,220,434,False,3,4
12431,12,242,281,523,False,3,4
12432,13,269,321,590,False,3,4
12433,14,232,297,529,False,3,4
12434,15,175,202,377,False,3,4
12435,16,141,173,314,False,3,4
12436,17,161,161,322,False,3,4
12437,18,115,155,270,False,3,4
12438,19,102,132,234,False,3,4
12439,20,51,86,137,False,3,4
12440,21,30,39,69,False,3,4
12441,22,14,24,38,False,3,4
12442,23,8,18,26,False,3,4
12443,0,13,23,36,False,4,4
12444,1,11,19,30,False,4,4
12445,2,9,9,18,False,4,4
12446,3,12,16,28,False,4,4
12447,4,107,59,166,False,4,4
12448,5,258,139,397,False,4,4
12449,6,379,218,597,False,4,4
12450,7,238,179,417,False,4,4
12451,8,225,182,407,False,4,4
12452,9,212,188,400,False,4,4
12453,10,220,227,447,False,4,4
12454,11,252,251,503,False,4,4
12455,12,237,295,532,False,4,4
12456,13,291,329,620,False,4,4
12457,14,214,287,501,False,4,4
12458,15,145,219,364,False,4,4
12459,16,125,159,284,False,4,4
12460,17,112,146,258,False,4,4
12461,18,99,115,214,False,4,4
12462,19,97,114,211,False,4,4
12463,20,64,110,174,False,4,4
12464,21,54,83,137,False,4,4
12465,22,39,46,85,False,4,4
12466,23,18,31,49,False,4,4
12467,0,18,33,51,False,5,4
12468,1,13,39,52,False,5,4
12469,2,8,23,31,False,5,4
12470,3,11,11,22,False,5,4
12471,4,26,8,34,False,5,4
12472,5,27,27,54,False,5,4
12473,6,53,39,92,False,5,4
12474,7,81,65,146,False,5,4
12475,8,131,108,239,False,5,4
12476,9,122,95,217,False,5,4
12477,10,137,128,265,False,5,4
12478,11,168,215,383,False,5,4
12479,12,158,178,336,False,5,4
12480,13,144,185,329,False,5,4
12481,14,119,166,285,False,5,4
12482,15,126,164,290,False,5,4
12483,16,134,163,297,False,5,4
12484,17,107,129,236,False,5,4
12485,18,70,77,147,False,5,4
12486,19,57,92,149,False,5,4
12487,20,71,77,148,False,5,4
12488,21,46,68,114,False,5,4
12489,22,33,58,91,False,5,4
12490,23,28,44,72,False,5,4
12491,0,22,37,59,True,6,4
12492,1,21,56,77,True,6,4
12493,2,9,33,42,True,6,4
12494,3,14,15,29,True,6,4
12495,4,21,11,32,True,6,4
12496,5,18,13,31,True,6,4
12497,6,38,25,63,True,6,4
12498,7,64,47,111,True,6,4
12499,8,131,72,203,True,6,4
12500,9,121,96,217,True,6,4
12501,10,138,156,294,True,6,4
12502,11,166,187,353,True,6,4
12503,12,185,179,364,True,6,4
12504,13,158,185,343,True,6,4
12505,14,117,235,352,True,6,4
12506,15,138,175,313,True,6,4
12507,16,148,181,329,True,6,4
12508,17,143,171,314,True,6,4
12509,18,109,161,270,True,6,4
12510,19,83,101,184,True,6,4
12511,20,65,100,165,True,6,4
12512,21,31,58,89,True,6,4
12513,22,18,32,50,True,6,4
12514,23,6,23,29,True,6,4
12515,0,7,15,22,False,0,4
12516,1,5,23,28,False,0,4
12517,2,6,14,20,False,0,4
12518,3,8,12,20,False,0,4
12519,4,122,66,188,False,0,4
12520,5,266,163,429,False,0,4
12521,6,385,231,616,False,0,4
12522,7,265,190,455,False,0,4
12523,8,208,180,388,False,0,4
12524,9,231,207,438,False,0,4
12525,10,229,223,452,False,0,4
12526,11,207,240,447,False,0,4
12527,12,213,273,486,False,0,4
12528,13,269,340,609,False,0,4
12529,14,224,279,503,False,0,4
12530,15,180,215,395,False,0,4
12531,16,183,171,354,False,0,4
12532,17,143,175,318,False,0,4
12533,18,122,154,276,False,0,4
12534,19,112,142,254,False,0,4
12535,20,63,86,149,False,0,4
12536,21,34,58,92,False,0,4
12537,22,13,31,44,False,0,4
12538,23,7,15,22,False,0,4
12539,0,2,10,12,False,1,4
12540,1,7,15,22,False,1,4
12541,2,6,15,21,False,1,4
12542,3,17,18,35,False,1,4
12543,4,123,51,174,False,1,4
12544,5,227,183,410,False,1,4
12545,6,396,192,588,False,1,4
12546,7,279,195,474,False,1,4
12547,8,225,170,395,False,1,4
12548,9,233,213,446,False,1,4
12549,10,214,211,425,False,1,4
12550,11,224,220,444,False,1,4
12551,12,252,288,540,False,1,4
12552,13,268,323,591,False,1,4
12553,14,198,312,510,False,1,4
12554,15,178,196,374,False,1,4
12555,16,144,167,311,False,1,4
12556,17,141,174,315,False,1,4
12557,18,120,142,262,False,1,4
12558,19,85,122,207,False,1,4
12559,20,68,115,183,False,1,4
12560,21,33,66,99,False,1,4
12561,22,20,22,42,False,1,4
12562,23,9,25,34,False,1,4
12563,0,7,19,26,False,2,4
12564,1,5,25,30,False,2,4
12565,2,8,12,20,False,2,4
12566,3,8,14,22,False,2,4
12567,4,111,67,178,False,2,4
12568,5,268,157,425,False,2,4
12569,6,382,195,577,False,2,4
12570,7,309,186,495,False,2,4
12571,8,229,171,400,False,2,4
12572,9,224,201,425,False,2,4
12573,10,245,224,469,False,2,4
12574,11,238,235,473,False,2,4
12575,12,243,319,562,False,2,4
12576,13,293,347,640,False,2,4
12577,14,215,306,521,False,2,4
12578,15,146,194,340,False,2,4
12579,16,154,181,335,False,2,4
12580,17,139,146,285,False,2,4
12581,18,136,138,274,False,2,4
12582,19,86,144,230,False,2,4
12583,20,62,90,152,False,2,4
12584,21,43,64,107,False,2,4
12585,22,25,43,68,False,2,4
12586,23,21,39,60,False,2,4
12587,0,13,32,45,True,3,4
12588,1,14,41,55,True,3,4
12589,2,8,29,37,True,3,4
12590,3,7,9,16,True,3,4
12591,4,17,7,24,True,3,4
12592,5,31,14,45,True,3,4
12593,6,54,35,89,True,3,4
12594,7,74,56,130,True,3,4
12595,8,99,66,165,True,3,4
12596,9,131,98,229,True,3,4
12597,10,163,155,318,True,3,4
12598,11,149,185,334,True,3,4
12599,12,165,203,368,True,3,4
12600,13,139,194,333,True,3,4
12601,14,134,194,328,True,3,4
12602,15,145,189,334,True,3,4
12603,16,148,174,322,True,3,4
12604,17,145,127,272,True,3,4
12605,18,103,130,233,True,3,4
12606,19,68,132,200,True,3,4
12607,20,62,120,182,True,3,4
12608,21,47,74,121,True,3,4
12609,22,23,29,52,True,3,4
12610,23,11,24,35,True,3,4
12611,0,3,18,21,False,4,4
12612,1,8,21,29,False,4,4
12613,2,9,14,23,False,4,4
12614,3,8,17,25,False,4,4
12615,4,83,39,122,False,4,4
12616,5,154,98,252,False,4,4
12617,6,230,146,376,False,4,4
12618,7,236,162,398,False,4,4
12619,8,225,171,396,False,4,4
12620,9,228,193,421,False,4,4
12621,10,226,211,437,False,4,4
12622,11,224,220,444,False,4,4
12623,12,195,247,442,False,4,4
12624,13,232,270,502,False,4,4
12625,14,184,249,433,False,4,4
12626,15,150,187,337,False,4,4
12627,16,143,149,292,False,4,4
12628,17,108,139,247,False,4,4
12629,18,104,108,212,False,4,4
12630,19,65,115,180,False,4,4
12631,20,69,98,167,False,4,4
12632,21,48,65,113,False,4,4
12633,22,38,46,84,False,4,4
12634,23,29,36,65,False,4,4
12635,0,21,38,59,False,5,4
12636,1,16,42,58,False,5,4
12637,2,9,24,33,False,5,4
12638,3,7,18,25,False,5,4
12639,4,22,18,40,False,5,4
12640,5,32,24,56,False,5,4
12641,6,46,36,82,False,5,4
12642,7,68,68,136,False,5,4
12643,8,103,101,204,False,5,4
12644,9,130,104,234,False,5,4
12645,10,136,144,280,False,5,4
12646,11,124,144,268,False,5,4
12647,12,129,135,264,False,5,4
12648,13,149,177,326,False,5,4
12649,14,117,139,256,False,5,4
12650,15,136,169,305,False,5,4
12651,16,122,158,280,False,5,4
12652,17,104,120,224,False,5,4
12653,18,97,119,216,False,5,4
12654,19,79,100,179,False,5,4
12655,20,58,84,142,False,5,4
12656,21,44,69,113,False,5,4
12657,22,40,73,113,False,5,4
12658,23,31,46,77,False,5,4
12659,0,19,53,72,True,6,4
12660,1,25,35,60,True,6,4
12661,2,19,46,65,True,6,4
12662,3,12,20,32,True,6,4
12663,4,25,13,38,True,6,4
12664,5,27,23,50,True,6,4
12665,6,51,24,75,True,6,4
12666,7,66,34,100,True,6,4
12667,8,88,88,176,True,6,4
12668,9,108,98,206,True,6,4
12669,10,124,117,241,True,6,4
12670,11,122,153,275,True,6,4
12671,12,153,165,318,True,6,4
12672,13,134,166,300,True,6,4
12673,14,158,214,372,True,6,4
12674,15,154,216,370,True,6,4
12675,16,133,159,292,True,6,4
12676,17,154,176,330,True,6,4
12677,18,199,167,366,True,6,4
12678,19,104,154,258,True,6,4
12679,20,58,113,171,True,6,4
12680,21,40,69,109,True,6,4
12681,22,16,33,49,True,6,4
12682,23,11,29,40,True,6,4
12683,0,8,15,23,False,0,4
12684,1,6,10,16,False,0,4
12685,2,3,8,11,False,0,4
12686,3,16,18,34,False,0,4
12687,4,130,59,189,False,0,4
12688,5,251,150,401,False,0,4
12689,6,376,213,589,False,0,4
12690,7,305,183,488,False,0,4
12691,8,228,195,423,False,0,4
12692,9,234,227,461,False,0,4
12693,10,226,214,440,False,0,4
12694,11,188,222,410,False,0,4
12695,12,213,256,469,False,0,4
12696,13,261,294,555,False,0,4
12697,14,251,312,563,False,0,4
12698,15,179,210,389,False,0,4
12699,16,178,179,357,False,0,4
12700,17,164,173,337,False,0,4
12701,18,122,128,250,False,0,4
12702,19,98,178,276,False,0,4
12703,20,65,104,169,False,0,4
12704,21,27,58,85,False,0,4
12705,22,22,32,54,False,0,4
12706,23,12,19,31,False,0,4
12707,0,8,18,26,False,1,4
12708,1,4,8,12,False,1,4
12709,2,8,14,22,False,1,4
12710,3,16,19,35,False,1,4
12711,4,131,57,188,False,1,4
12712,5,232,159,391,False,1,4
12713,6,414,193,607,False,1,4
12714,7,252,181,433,False,1,4
12715,8,222,203,425,False,1,4
12716,9,209,203,412,False,1,4
12717,10,229,217,446,False,1,4
12718,11,242,245,487,False,1,4
12719,12,220,276,496,False,1,4
12720,13,273,363,636,False,1,4
12721,14,212,292,504,False,1,4
12722,15,175,198,373,False,1,4
12723,16,195,180,375,False,1,4
12724,17,151,159,310,False,1,4
12725,18,129,161,290,False,1,4
12726,19,99,145,244,False,1,4
12727,20,65,122,187,False,1,4
12728,21,42,74,116,False,1,4
12729,22,26,44,70,False,1,4
12730,23,10,33,43,False,1,4
12731,0,12,20,32,False,2,4
12732,1,14,26,40,False,2,4
12733,2,16,16,32,False,2,4
12734,3,7,20,27,False,2,4
12735,4,113,51,164,False,2,4
12736,5,278,165,443,False,2,4
12737,6,383,205,588,False,2,4
12738,7,282,191,473,False,2,4
12739,8,259,205,464,False,2,4
12740,9,252,203,455,False,2,4
12741,10,239,253,492,False,2,4
12742,11,224,217,441,False,2,4
12743,12,250,254,504,False,2,4
12744,13,234,335,569,False,2,4
12745,14,218,269,487,False,2,4
12746,15,177,176,353,False,2,4
12747,16,160,188,348,False,2,4
12748,17,154,173,327,False,2,4
12749,18,111,135,246,False,2,4
12750,19,109,153,262,False,2,4
12751,20,70,430,500,False,2,4
12752,21,45,69,114,False,2,4
12753,22,28,50,78,False,2,4
12754,23,9,31,40,False,2,4
12755,0,6,16,22,False,3,5
12756,1,10,20,30,False,3,5
12757,2,6,24,30,False,3,5
12758,3,10,14,24,False,3,5
12759,4,119,59,178,False,3,5
12760,5,245,172,417,False,3,5
12761,6,360,192,552,False,3,5
12762,7,267,189,456,False,3,5
12763,8,229,207,436,False,3,5
12764,9,236,207,443,False,3,5
12765,10,256,227,483,False,3,5
12766,11,229,253,482,False,3,5
12767,12,230,319,549,False,3,5
12768,13,289,331,620,False,3,5
12769,14,230,293,523,False,3,5
12770,15,197,203,400,False,3,5
12771,16,185,169,354,False,3,5
12772,17,158,187,345,False,3,5
12773,18,122,169,291,False,3,5
12774,19,97,140,237,False,3,5
12775,20,71,128,199,False,3,5
12776,21,47,70,117,False,3,5
12777,22,29,45,74,False,3,5
12778,23,17,36,53,False,3,5
12779,0,15,31,46,False,4,5
12780,1,10,29,39,False,4,5
12781,2,10,24,34,False,4,5
12782,3,15,17,32,False,4,5
12783,4,125,55,180,False,4,5
12784,5,228,142,370,False,4,5
12785,6,365,211,576,False,4,5
12786,7,216,173,389,False,4,5
12787,8,222,188,410,False,4,5
12788,9,235,217,452,False,4,5
12789,10,225,261,486,False,4,5
12790,11,225,266,491,False,4,5
12791,12,253,325,578,False,4,5
12792,13,277,371,648,False,4,5
12793,14,210,296,506,False,4,5
12794,15,163,191,354,False,4,5
12795,16,157,161,318,False,4,5
12796,17,128,132,260,False,4,5
12797,18,113,124,237,False,4,5
12798,19,91,95,186,False,4,5
12799,20,60,87,147,False,4,5
12800,21,36,60,96,False,4,5
12801,22,31,48,79,False,4,5
12802,23,26,31,57,False,4,5
12803,0,17,34,51,False,5,5
12804,1,17,30,47,False,5,5
12805,2,17,33,50,False,5,5
12806,3,7,9,16,False,5,5
12807,4,23,14,37,False,5,5
12808,5,33,27,60,False,5,5
12809,6,52,41,93,False,5,5
12810,7,66,65,131,False,5,5
12811,8,121,96,217,False,5,5
12812,9,153,118,271,False,5,5
12813,10,170,163,333,False,5,5
12814,11,139,144,283,False,5,5
12815,12,131,167,298,False,5,5
12816,13,150,177,327,False,5,5
12817,14,139,191,330,False,5,5
12818,15,144,187,331,False,5,5
12819,16,166,167,333,False,5,5
12820,17,146,129,275,False,5,5
12821,18,95,112,207,False,5,5
12822,19,69,84,153,False,5,5
12823,20,61,87,148,False,5,5
12824,21,49,58,107,False,5,5
12825,22,53,72,125,False,5,5
12826,23,32,61,93,False,5,5
12827,0,25,53,78,True,6,5
12828,1,33,71,104,True,6,5
12829,2,13,43,56,True,6,5
12830,3,6,20,26,True,6,5
12831,4,16,15,31,True,6,5
12832,5,17,15,32,True,6,5
12833,6,33,15,48,True,6,5
12834,7,32,39,71,True,6,5
12835,8,87,60,147,True,6,5
12836,9,105,82,187,True,6,5
12837,10,145,129,274,True,6,5
12838,11,128,151,279,True,6,5
12839,12,171,151,322,True,6,5
12840,13,137,193,330,True,6,5
12841,14,117,255,372,True,6,5
12842,15,135,149,284,True,6,5
12843,16,130,139,269,True,6,5
12844,17,95,128,223,True,6,5
12845,18,104,142,246,True,6,5
12846,19,80,93,173,True,6,5
12847,20,64,85,149,True,6,5
12848,21,40,58,98,True,6,5
12849,22,27,40,67,True,6,5
12850,23,17,28,45,True,6,5
12851,0,17,32,49,True,0,5
12852,1,7,14,21,True,0,5
12853,2,5,10,15,True,0,5
12854,3,8,9,17,True,0,5
12855,4,11,8,19,True,0,5
12856,5,29,27,56,True,0,5
12857,6,39,26,65,True,0,5
12858,7,62,52,114,True,0,5
12859,8,86,73,159,True,0,5
12860,9,100,101,201,True,0,5
12861,10,143,118,261,True,0,5
12862,11,140,167,307,True,0,5
12863,12,140,176,316,True,0,5
12864,13,135,181,316,True,0,5
12865,14,163,209,372,True,0,5
12866,15,194,192,386,True,0,5
12867,16,155,192,347,True,0,5
12868,17,165,174,339,True,0,5
12869,18,134,148,282,True,0,5
12870,19,106,127,233,True,0,5
12871,20,57,115,172,True,0,5
12872,21,34,69,103,True,0,5
12873,22,21,35,56,True,0,5
12874,23,14,21,35,True,0,5
12875,0,9,11,20,False,1,5
12876,1,6,8,14,False,1,5
12877,2,2,12,14,False,1,5
12878,3,13,12,25,False,1,5
12879,4,124,70,194,False,1,5
12880,5,271,166,437,False,1,5
12881,6,414,243,657,False,1,5
12882,7,288,200,488,False,1,5
12883,8,226,213,439,False,1,5
12884,9,220,184,404,False,1,5
12885,10,227,259,486,False,1,5
12886,11,237,216,453,False,1,5
12887,12,231,246,477,False,1,5
12888,13,276,388,664,False,1,5
12889,14,224,330,554,False,1,5
12890,15,205,200,405,False,1,5
12891,16,193,182,375,False,1,5
12892,17,146,152,298,False,1,5
12893,18,102,148,250,False,1,5
12894,19,96,142,238,False,1,5
12895,20,64,95,159,False,1,5
12896,21,33,73,106,False,1,5
12897,22,20,31,51,False,1,5
12898,23,19,29,48,False,1,5
12899,0,12,17,29,False,2,5
12900,1,10,18,28,False,2,5
12901,2,7,15,22,False,2,5
12902,3,17,10,27,False,2,5
12903,4,112,58,170,False,2,5
12904,5,245,150,395,False,2,5
12905,6,383,223,606,False,2,5
12906,7,283,159,442,False,2,5
12907,8,211,205,416,False,2,5
12908,9,221,182,403,False,2,5
12909,10,214,193,407,False,2,5
12910,11,201,222,423,False,2,5
12911,12,231,304,535,False,2,5
12912,13,252,300,552,False,2,5
12913,14,193,297,490,False,2,5
12914,15,158,198,356,False,2,5
12915,16,172,155,327,False,2,5
12916,17,136,149,285,False,2,5
12917,18,121,150,271,False,2,5
12918,19,100,135,235,False,2,5
12919,20,67,427,494,False,2,5
12920,21,44,332,376,False,2,5
12921,22,19,140,159,False,2,5
12922,23,13,91,104,False,2,5
12923,0,7,56,63,False,3,5
12924,1,6,55,61,False,3,5
12925,2,10,12,22,False,3,5
12926,3,13,11,24,False,3,5
12927,4,96,54,150,False,3,5
12928,5,234,148,382,False,3,5
12929,6,388,193,581,False,3,5
12930,7,264,190,454,False,3,5
12931,8,218,203,421,False,3,5
12932,9,226,190,416,False,3,5
12933,10,254,230,484,False,3,5
12934,11,230,241,471,False,3,5
12935,12,257,319,576,False,3,5
12936,13,262,341,603,False,3,5
12937,14,201,302,503,False,3,5
12938,15,186,214,400,False,3,5
12939,16,174,149,323,False,3,5
12940,17,144,172,316,False,3,5
12941,18,117,136,253,False,3,5
12942,19,93,136,229,False,3,5
12943,20,74,116,190,False,3,5
12944,21,50,82,132,False,3,5
12945,22,30,48,78,False,3,5
12946,23,18,47,65,False,3,5
12947,0,12,27,39,False,4,5
12948,1,6,31,37,False,4,5
12949,2,8,24,32,False,4,5
12950,3,14,11,25,False,4,5
12951,4,105,58,163,False,4,5
12952,5,266,176,442,False,4,5
12953,6,350,198,548,False,4,5
12954,7,257,182,439,False,4,5
12955,8,233,200,433,False,4,5
12956,9,246,212,458,False,4,5
12957,10,255,239,494,False,4,5
12958,11,236,258,494,False,4,5
12959,12,260,332,592,False,4,5
12960,13,262,355,617,False,4,5
12961,14,210,260,470,False,4,5
12962,15,166,187,353,False,4,5
12963,16,197,152,349,False,4,5
12964,17,114,166,280,False,4,5
12965,18,101,115,216,False,4,5
12966,19,68,111,179,False,4,5
12967,20,52,86,138,False,4,5
12968,21,48,64,112,False,4,5
12969,22,57,59,116,False,4,5
12970,23,31,53,84,False,4,5
12971,0,17,30,47,False,5,5
12972,1,17,26,43,False,5,5
12973,2,11,28,39,False,5,5
12974,3,24,14,38,False,5,5
12975,4,30,58,88,False,5,5
12976,5,37,24,61,False,5,5
12977,6,39,41,80,False,5,5
12978,7,90,78,168,False,5,5
12979,8,122,92,214,False,5,5
12980,9,145,107,252,False,5,5
12981,10,156,155,311,False,5,5
12982,11,180,186,366,False,5,5
12983,12,158,170,328,False,5,5
12984,13,177,257,434,False,5,5
12985,14,137,221,358,False,5,5
12986,15,133,211,344,False,5,5
12987,16,127,174,301,False,5,5
12988,17,117,129,246,False,5,5
12989,18,109,105,214,False,5,5
12990,19,74,99,173,False,5,5
12991,20,48,81,129,False,5,5
12992,21,53,68,121,False,5,5
12993,22,50,85,135,False,5,5
12994,23,35,52,87,False,5,5
12995,0,26,47,73,True,6,5
12996,1,27,62,89,True,6,5
12997,2,21,45,66,True,6,5
12998,3,9,22,31,True,6,5
12999,4,19,11,30,True,6,5
13000,5,21,16,37,True,6,5
13001,6,45,25,70,True,6,5
13002,7,70,52,122,True,6,5
13003,8,103,63,166,True,6,5
13004,9,160,90,250,True,6,5
13005,10,208,169,377,True,6,5
13006,11,226,233,459,True,6,5
13007,12,194,259,453,True,6,5
13008,13,168,265,433,True,6,5
13009,14,178,305,483,True,6,5
13010,15,164,215,379,True,6,5
13011,16,199,175,374,True,6,5
13012,17,138,188,326,True,6,5
13013,18,137,206,343,True,6,5
13014,19,98,115,213,True,6,5
13015,20,68,90,158,True,6,5
13016,21,50,74,124,True,6,5
13017,22,21,30,51,True,6,5
13018,23,10,15,25,True,6,5
13019,0,16,22,38,False,0,5
13020,1,8,12,20,False,0,5
13021,2,6,18,24,False,0,5
13022,3,15,16,31,False,0,5
13023,4,122,64,186,False,0,5
13024,5,244,156,400,False,0,5
13025,6,337,206,543,False,0,5
13026,7,273,189,462,False,0,5
13027,8,212,187,399,False,0,5
13028,9,215,199,414,False,0,5
13029,10,211,204,415,False,0,5
13030,11,232,242,474,False,0,5
13031,12,240,281,521,False,0,5
13032,13,285,342,627,False,0,5
13033,14,232,293,525,False,0,5
13034,15,171,188,359,False,0,5
13035,16,189,204,393,False,0,5
13036,17,143,128,271,False,0,5
13037,18,126,140,266,False,0,5
13038,19,86,116,202,False,0,5
13039,20,81,310,391,False,0,5
13040,21,37,223,260,False,0,5
13041,22,20,108,128,False,0,5
13042,23,15,76,91,False,0,5
13043,0,15,44,59,False,1,5
13044,1,12,36,48,False,1,5
13045,2,10,32,42,False,1,5
13046,3,20,29,49,False,1,5
13047,4,117,59,176,False,1,5
13048,5,248,150,398,False,1,5
13049,6,374,209,583,False,1,5
13050,7,275,174,449,False,1,5
13051,8,209,219,428,False,1,5
13052,9,214,208,422,False,1,5
13053,10,228,242,470,False,1,5
13054,11,269,234,503,False,1,5
13055,12,219,284,503,False,1,5
13056,13,261,360,621,False,1,5
13057,14,236,302,538,False,1,5
13058,15,175,186,361,False,1,5
13059,16,152,185,337,False,1,5
13060,17,130,165,295,False,1,5
13061,18,127,133,260,False,1,5
13062,19,93,115,208,False,1,5
13063,20,57,471,528,False,1,5
13064,21,43,310,353,False,1,5
13065,22,26,130,156,False,1,5
13066,23,21,81,102,False,1,5
13067,0,13,42,55,False,2,5
13068,1,9,45,54,False,2,5
13069,2,15,43,58,False,2,5
13070,3,16,67,83,False,2,5
13071,4,103,55,158,False,2,5
13072,5,199,159,358,False,2,5
13073,6,349,190,539,False,2,5
13074,7,288,166,454,False,2,5
13075,8,248,167,415,False,2,5
13076,9,203,217,420,False,2,5
13077,10,242,233,475,False,2,5
13078,11,229,235,464,False,2,5
13079,12,225,270,495,False,2,5
13080,13,299,353,652,False,2,5
13081,14,231,275,506,False,2,5
13082,15,210,232,442,False,2,5
13083,16,147,192,339,False,2,5
13084,17,152,155,307,False,2,5
13085,18,101,139,240,False,2,5
13086,19,88,129,217,False,2,5
13087,20,69,116,185,False,2,5
13088,21,38,80,118,False,2,5
13089,22,29,44,73,False,2,5
13090,23,19,47,66,False,2,5
13091,0,10,30,40,False,3,5
13092,1,10,33,43,False,3,5
13093,2,8,19,27,False,3,5
13094,3,14,21,35,False,3,5
13095,4,95,61,156,False,3,5
13096,5,214,155,369,False,3,5
13097,6,332,188,520,False,3,5
13098,7,247,162,409,False,3,5
13099,8,227,195,422,False,3,5
13100,9,212,185,397,False,3,5
13101,10,212,209,421,False,3,5
13102,11,241,233,474,False,3,5
13103,12,230,284,514,False,3,5
13104,13,258,324,582,False,3,5
13105,14,214,284,498,False,3,5
13106,15,188,191,379,False,3,5
13107,16,166,160,326,False,3,5
13108,17,133,175,308,False,3,5
13109,18,133,135,268,False,3,5
13110,19,86,112,198,False,3,5
13111,20,70,100,170,False,3,5
13112,21,57,65,122,False,3,5
13113,22,36,38,74,False,3,5
13114,23,24,36,60,False,3,5
13115,0,19,26,45,False,4,5
13116,1,8,26,34,False,4,5
13117,2,8,23,31,False,4,5
13118,3,14,16,30,False,4,5
13119,4,110,46,156,False,4,5
13120,5,225,157,382,False,4,5
13121,6,359,211,570,False,4,5
13122,7,258,173,431,False,4,5
13123,8,218,190,408,False,4,5
13124,9,227,215,442,False,4,5
13125,10,254,235,489,False,4,5
13126,11,238,243,481,False,4,5
13127,12,265,312,577,False,4,5
13128,13,259,299,558,False,4,5
13129,14,208,254,462,False,4,5
13130,15,158,174,332,False,4,5
13131,16,138,156,294,False,4,5
13132,17,118,152,270,False,4,5
13133,18,96,124,220,False,4,5
13134,19,67,110,177,False,4,5
13135,20,73,101,174,False,4,5
13136,21,47,69,116,False,4,5
13137,22,47,73,120,False,4,5
13138,23,36,50,86,False,4,5
13139,0,20,44,64,False,5,5
13140,1,25,51,76,False,5,5
13141,2,18,29,47,False,5,5
13142,3,14,14,28,False,5,5
13143,4,22,17,39,False,5,5
13144,5,32,31,63,False,5,5
13145,6,39,40,79,False,5,5
13146,7,59,58,117,False,5,5
13147,8,97,79,176,False,5,5
13148,9,158,129,287,False,5,5
13149,10,169,165,334,False,5,5
13150,11,153,178,331,False,5,5
13151,12,153,170,323,False,5,5
13152,13,146,200,346,False,5,5
13153,14,134,176,310,False,5,5
13154,15,130,159,289,False,5,5
13155,16,125,154,279,False,5,5
13156,17,98,111,209,False,5,5
13157,18,95,109,204,False,5,5
13158,19,64,89,153,False,5,5
13159,20,58,91,149,False,5,5
13160,21,46,65,111,False,5,5
13161,22,38,47,85,False,5,5
13162,23,37,55,92,False,5,5
13163,0,27,42,69,True,6,5
13164,1,27,51,78,True,6,5
13165,2,27,42,69,True,6,5
13166,3,13,31,44,True,6,5
13167,4,18,21,39,True,6,5
13168,5,20,17,37,True,6,5
13169,6,31,26,57,True,6,5
13170,7,50,41,91,True,6,5
13171,8,73,71,144,True,6,5
13172,9,94,69,163,True,6,5
13173,10,131,105,236,True,6,5
13174,11,203,176,379,True,6,5
13175,12,177,210,387,True,6,5
13176,13,175,235,410,True,6,5
13177,14,160,233,393,True,6,5
13178,15,172,253,425,True,6,5
13179,16,149,192,341,True,6,5
13180,17,166,157,323,True,6,5
13181,18,137,177,314,True,6,5
13182,19,92,134,226,True,6,5
13183,20,75,89,164,True,6,5
13184,21,47,63,110,True,6,5
13185,22,29,37,66,True,6,5
13186,23,21,21,42,True,6,5
13187,0,13,8,21,False,0,5
13188,1,7,18,25,False,0,5
13189,2,7,10,17,False,0,5
13190,3,13,12,25,False,0,5
13191,4,115,58,173,False,0,5
13192,5,234,144,378,False,0,5
13193,6,377,198,575,False,0,5
13194,7,248,173,421,False,0,5
13195,8,223,176,399,False,0,5
13196,9,214,203,417,False,0,5
13197,10,194,192,386,False,0,5
13198,11,199,197,396,False,0,5
13199,12,224,284,508,False,0,5
13200,13,265,433,698,False,0,5
13201,14,253,578,831,False,0,5
13202,15,172,231,403,False,0,5
13203,16,199,184,383,False,0,5
13204,17,130,106,236,False,0,5
13205,18,112,127,239,False,0,5
13206,19,127,155,282,False,0,5
13207,20,68,68,136,False,0,5
13208,21,45,57,102,False,0,5
13209,22,23,26,49,False,0,5
13210,23,12,8,20,False,0,5
13211,0,6,13,19,False,1,5
13212,1,8,16,24,False,1,5
13213,2,8,14,22,False,1,5
13214,3,22,15,37,False,1,5
13215,4,111,58,169,False,1,5
13216,5,237,149,386,False,1,5
13217,6,377,185,562,False,1,5
13218,7,290,180,470,False,1,5
13219,8,214,188,402,False,1,5
13220,9,214,231,445,False,1,5
13221,10,223,198,421,False,1,5
13222,11,176,210,386,False,1,5
13223,12,200,290,490,False,1,5
13224,13,268,362,630,False,1,5
13225,14,196,273,469,False,1,5
13226,15,174,182,356,False,1,5
13227,16,159,167,326,False,1,5
13228,17,126,163,289,False,1,5
13229,18,146,130,276,False,1,5
13230,19,85,107,192,False,1,5
13231,20,93,77,170,False,1,5
13232,21,87,61,148,False,1,5
13233,22,60,28,88,False,1,5
13234,23,46,18,64,False,1,5
13235,0,33,10,43,False,2,5
13236,1,12,25,37,False,2,5
13237,2,11,19,30,False,2,5
13238,3,22,7,29,False,2,5
13239,4,116,54,170,False,2,5
13240,5,228,146,374,False,2,5
13241,6,340,225,565,False,2,5
13242,7,262,174,436,False,2,5
13243,8,201,189,390,False,2,5
13244,9,186,192,378,False,2,5
13245,10,238,221,459,False,2,5
13246,11,206,218,424,False,2,5
13247,12,230,289,519,False,2,5
13248,13,284,339,623,False,2,5
13249,14,224,304,528,False,2,5
13250,15,163,190,353,False,2,5
13251,16,144,165,309,False,2,5
13252,17,139,157,296,False,2,5
13253,18,115,141,256,False,2,5
13254,19,102,123,225,False,2,5
13255,20,70,90,160,False,2,5
13256,21,53,56,109,False,2,5
13257,22,41,37,78,False,2,5
13258,23,26,26,52,False,2,5
13259,0,20,19,39,False,3,5
13260,1,5,21,26,False,3,5
13261,2,4,22,26,False,3,5
13262,3,12,13,25,False,3,5
13263,4,120,56,176,False,3,5
13264,5,208,155,363,False,3,5
13265,6,366,182,548,False,3,5
13266,7,253,151,404,False,3,5
13267,8,204,182,386,False,3,5
13268,9,218,190,408,False,3,5
13269,10,226,218,444,False,3,5
13270,11,193,230,423,False,3,5
13271,12,219,287,506,False,3,5
13272,13,265,353,618,False,3,5
13273,14,230,298,528,False,3,5
13274,15,221,206,427,False,3,5
13275,16,158,174,332,False,3,5
13276,17,140,162,302,False,3,5
13277,18,122,138,260,False,3,5
13278,19,90,112,202,False,3,5
13279,20,67,118,185,False,3,5
13280,21,54,63,117,False,3,5
13281,22,40,47,87,False,3,5
13282,23,20,25,45,False,3,5
13283,0,13,16,29,False,4,5
13284,1,8,19,27,False,4,5
13285,2,5,15,20,False,4,5
13286,3,15,10,25,False,4,5
13287,4,122,57,179,False,4,5
13288,5,241,145,386,False,4,5
13289,6,359,183,542,False,4,5
13290,7,277,163,440,False,4,5
13291,8,249,194,443,False,4,5
13292,9,225,226,451,False,4,5
13293,10,246,205,451,False,4,5
13294,11,245,260,505,False,4,5
13295,12,258,322,580,False,4,5
13296,13,257,335,592,False,4,5
13297,14,188,297,485,False,4,5
13298,15,150,175,325,False,4,5
13299,16,123,125,248,False,4,5
13300,17,108,109,217,False,4,5
13301,18,85,99,184,False,4,5
13302,19,64,90,154,False,4,5
13303,20,66,71,137,False,4,5
13304,21,50,65,115,False,4,5
13305,22,37,64,101,False,4,5
13306,23,33,44,77,False,4,5
13307,0,23,41,64,False,5,5
13308,1,18,33,51,False,5,5
13309,2,7,22,29,False,5,5
13310,3,13,15,28,False,5,5
13311,4,24,14,38,False,5,5
13312,5,28,26,54,False,5,5
13313,6,28,43,71,False,5,5
13314,7,56,73,129,False,5,5
13315,8,97,72,169,False,5,5
13316,9,118,105,223,False,5,5
13317,10,159,133,292,False,5,5
13318,11,164,152,316,False,5,5
13319,12,139,184,323,False,5,5
13320,13,127,168,295,False,5,5
13321,14,120,176,296,False,5,5
13322,15,131,160,291,False,5,5
13323,16,127,126,253,False,5,5
13324,17,84,109,193,False,5,5
13325,18,87,105,192,False,5,5
13326,19,78,72,150,False,5,5
13327,20,53,68,121,False,5,5
13328,21,44,66,110,False,5,5
13329,22,37,54,91,False,5,5
13330,23,36,56,92,False,5,5
13331,0,28,50,78,True,6,5
13332,1,27,44,71,True,6,5
13333,2,19,25,44,True,6,5
13334,3,18,21,39,True,6,5
13335,4,19,19,38,True,6,5
13336,5,19,23,42,True,6,5
13337,6,30,23,53,True,6,5
13338,7,42,57,99,True,6,5
13339,8,80,62,142,True,6,5
13340,9,155,69,224,True,6,5
13341,10,153,144,297,True,6,5
13342,11,176,178,354,True,6,5
13343,12,177,195,372,True,6,5
13344,13,163,198,361,True,6,5
13345,14,146,209,355,True,6,5
13346,15,148,178,326,True,6,5
13347,16,130,167,297,True,6,5
13348,17,130,132,262,True,6,5
13349,18,122,148,270,True,6,5
13350,19,94,129,223,True,6,5
13351,20,73,288,361,True,6,5
13352,21,51,181,232,True,6,5
13353,22,37,85,122,True,6,5
13354,23,12,46,58,True,6,5
13355,0,16,41,57,False,0,5
13356,1,7,8,15,False,0,5
13357,2,8,6,14,False,0,5
13358,3,15,18,33,False,0,5
13359,4,112,58,170,False,0,5
13360,5,216,141,357,False,0,5
13361,6,312,174,486,False,0,5
13362,7,262,183,445,False,0,5
13363,8,250,191,441,False,0,5
13364,9,216,189,405,False,0,5
13365,10,212,185,397,False,0,5
13366,11,199,224,423,False,0,5
13367,12,219,277,496,False,0,5
13368,13,240,338,578,False,0,5
13369,14,196,282,478,False,0,5
13370,15,159,181,340,False,0,5
13371,16,129,156,285,False,0,5
13372,17,131,131,262,False,0,5
13373,18,140,121,261,False,0,5
13374,19,78,135,213,False,0,5
13375,20,53,84,137,False,0,5
13376,21,39,51,90,False,0,5
13377,22,23,35,58,False,0,5
13378,23,15,20,35,False,0,5
13379,0,8,12,20,False,1,5
13380,1,3,5,8,False,1,5
13381,2,6,12,18,False,1,5
13382,3,13,17,30,False,1,5
13383,4,99,63,162,False,1,5
13384,5,216,123,339,False,1,5
13385,6,303,167,470,False,1,5
13386,7,238,172,410,False,1,5
13387,8,192,157,349,False,1,5
13388,9,214,183,397,False,1,5
13389,10,208,212,420,False,1,5
13390,11,184,197,381,False,1,5
13391,12,211,269,480,False,1,5
13392,13,222,322,544,False,1,5
13393,14,180,261,441,False,1,5
13394,15,157,188,345,False,1,5
13395,16,134,131,265,False,1,5
13396,17,107,143,250,False,1,5
13397,18,104,138,242,False,1,5
13398,19,92,115,207,False,1,5
13399,20,59,81,140,False,1,5
13400,21,54,47,101,False,1,5
13401,22,21,36,57,False,1,5
13402,23,17,33,50,False,1,5
13403,0,12,19,31,False,2,5
13404,1,6,12,18,False,2,5
13405,2,10,9,19,False,2,5
13406,3,9,21,30,False,2,5
13407,4,124,58,182,False,2,5
13408,5,197,118,315,False,2,5
13409,6,306,158,464,False,2,5
13410,7,238,181,419,False,2,5
13411,8,192,149,341,False,2,5
13412,9,201,180,381,False,2,5
13413,10,216,202,418,False,2,5
13414,11,187,202,389,False,2,5
13415,12,205,243,448,False,2,5
13416,13,258,320,578,False,2,5
13417,14,186,232,418,False,2,5
13418,15,154,170,324,False,2,5
13419,16,108,160,268,False,2,5
13420,17,137,135,272,False,2,5
13421,18,98,113,211,False,2,5
13422,19,90,98,188,False,2,5
13423,20,50,96,146,False,2,5
13424,21,48,47,95,False,2,5
13425,22,25,43,68,False,2,5
13426,23,14,43,57,False,2,5
13427,0,4,20,24,False,3,5
13428,1,3,14,17,False,3,5
13429,2,4,14,18,False,3,5
13430,3,9,14,23,False,3,5
13431,4,107,63,170,False,3,5
13432,5,171,127,298,False,3,5
13433,6,297,160,457,False,3,5
13434,7,254,188,442,False,3,5
13435,8,208,163,371,False,3,5
13436,9,195,208,403,False,3,5
13437,10,187,217,404,False,3,5
13438,11,192,220,412,False,3,5
13439,12,190,262,452,False,3,5
13440,13,248,303,551,False,3,5
13441,14,194,267,461,False,3,5
13442,15,166,192,358,False,3,5
13443,16,135,152,287,False,3,5
13444,17,136,148,284,False,3,5
13445,18,92,128,220,False,3,5
13446,19,96,111,207,False,3,5
13447,20,71,86,157,False,3,5
13448,21,48,68,116,False,3,5
13449,22,26,32,58,False,3,5
13450,23,15,29,44,False,3,5
13451,0,7,21,28,False,4,5
13452,1,10,20,30,False,4,5
13453,2,6,19,25,False,4,5
13454,3,9,18,27,False,4,5
13455,4,94,62,156,False,4,5
13456,5,208,119,327,False,4,5
13457,6,260,159,419,False,4,5
13458,7,235,201,436,False,4,5
13459,8,213,194,407,False,4,5
13460,9,220,188,408,False,4,5
13461,10,231,243,474,False,4,5
13462,11,230,303,533,False,4,5
13463,12,215,288,503,False,4,5
13464,13,217,323,540,False,4,5
13465,14,181,194,375,False,4,5
13466,15,131,173,304,False,4,5
13467,16,148,152,300,False,4,5
13468,17,106,129,235,False,4,5
13469,18,100,119,219,False,4,5
13470,19,75,91,166,False,4,5
13471,20,61,80,141,False,4,5
13472,21,54,75,129,False,4,5
13473,22,27,52,79,False,4,5
13474,23,25,40,65,False,4,5
13475,0,10,31,41,False,5,6
13476,1,10,22,32,False,5,6
13477,2,11,22,33,False,5,6
13478,3,8,11,19,False,5,6
13479,4,22,18,40,False,5,6
13480,5,29,24,53,False,5,6
13481,6,34,37,71,False,5,6
13482,7,49,66,115,False,5,6
13483,8,85,66,151,False,5,6
13484,9,106,105,211,False,5,6
13485,10,111,104,215,False,5,6
13486,11,117,132,249,False,5,6
13487,12,120,127,247,False,5,6
13488,13,122,145,267,False,5,6
13489,14,135,134,269,False,5,6
13490,15,97,135,232,False,5,6
13491,16,120,128,248,False,5,6
13492,17,91,113,204,False,5,6
13493,18,81,104,185,False,5,6
13494,19,57,77,134,False,5,6
13495,20,44,64,108,False,5,6
13496,21,27,57,84,False,5,6
13497,22,31,49,80,False,5,6
13498,23,23,37,60,False,5,6
13499,0,15,35,50,True,6,6
13500,1,17,48,65,True,6,6
13501,2,14,20,34,True,6,6
13502,3,11,19,30,True,6,6
13503,4,11,11,22,True,6,6
13504,5,13,14,27,True,6,6
13505,6,23,16,39,True,6,6
13506,7,45,39,84,True,6,6
13507,8,51,63,114,True,6,6
13508,9,101,80,181,True,6,6
13509,10,114,113,227,True,6,6
13510,11,120,141,261,True,6,6
13511,12,161,154,315,True,6,6
13512,13,119,157,276,True,6,6
13513,14,106,177,283,True,6,6
13514,15,126,156,282,True,6,6
13515,16,116,151,267,True,6,6
13516,17,140,171,311,True,6,6
13517,18,109,130,239,True,6,6
13518,19,64,91,155,True,6,6
13519,20,129,75,204,True,6,6
13520,21,43,58,101,True,6,6
13521,22,25,25,50,True,6,6
13522,23,11,17,28,True,6,6
13523,0,7,13,20,False,0,6
13524,1,5,13,18,False,0,6
13525,2,7,5,12,False,0,6
13526,3,12,7,19,False,0,6
13527,4,109,51,160,False,0,6
13528,5,158,110,268,False,0,6
13529,6,245,128,373,False,0,6
13530,7,212,170,382,False,0,6
13531,8,188,134,322,False,0,6
13532,9,179,159,338,False,0,6
13533,10,193,172,365,False,0,6
13534,11,199,211,410,False,0,6
13535,12,218,259,477,False,0,6
13536,13,201,305,506,False,0,6
13537,14,149,240,389,False,0,6
13538,15,156,159,315,False,0,6
13539,16,106,131,237,False,0,6
13540,17,113,119,232,False,0,6
13541,18,92,124,216,False,0,6
13542,19,93,116,209,False,0,6
13543,20,95,92,187,False,0,6
13544,21,48,59,107,False,0,6
13545,22,35,21,56,False,0,6
13546,23,13,20,33,False,0,6
13547,0,6,4,10,False,1,6
13548,1,8,16,24,False,1,6
13549,2,9,13,22,False,1,6
13550,3,25,14,39,False,1,6
13551,4,100,45,145,False,1,6
13552,5,211,117,328,False,1,6
13553,6,231,132,363,False,1,6
13554,7,226,180,406,False,1,6
13555,8,202,168,370,False,1,6
13556,9,195,193,388,False,1,6
13557,10,209,199,408,False,1,6
13558,11,179,221,400,False,1,6
13559,12,182,248,430,False,1,6
13560,13,216,297,513,False,1,6
13561,14,158,212,370,False,1,6
13562,15,138,170,308,False,1,6
13563,16,97,105,202,False,1,6
13564,17,92,146,238,False,1,6
13565,18,96,117,213,False,1,6
13566,19,65,95,160,False,1,6
13567,20,55,287,342,False,1,6
13568,21,40,414,454,False,1,6
13569,22,35,211,246,False,1,6
13570,23,15,110,125,False,1,6
13571,0,19,85,104,False,2,6
13572,1,17,27,44,False,2,6
13573,2,11,25,36,False,2,6
13574,3,20,13,33,False,2,6
13575,4,108,52,160,False,2,6
13576,5,172,105,277,False,2,6
13577,6,267,149,416,False,2,6
13578,7,205,169,374,False,2,6
13579,8,181,165,346,False,2,6
13580,9,178,167,345,False,2,6
13581,10,185,180,365,False,2,6
13582,11,201,188,389,False,2,6
13583,12,203,265,468,False,2,6
13584,13,186,266,452,False,2,6
13585,14,150,238,388,False,2,6
13586,15,140,153,293,False,2,6
13587,16,130,135,265,False,2,6
13588,17,113,131,244,False,2,6
13589,18,91,138,229,False,2,6
13590,19,74,109,183,False,2,6
13591,20,63,91,154,False,2,6
13592,21,34,47,81,False,2,6
13593,22,23,22,45,False,2,6
13594,23,11,18,29,False,2,6
13595,0,7,14,21,False,3,6
13596,1,7,21,28,False,3,6
13597,2,10,13,23,False,3,6
13598,3,13,13,26,False,3,6
13599,4,101,60,161,False,3,6
13600,5,185,89,274,False,3,6
13601,6,240,133,373,False,3,6
13602,7,189,172,361,False,3,6
13603,8,149,143,292,False,3,6
13604,9,162,149,311,False,3,6
13605,10,177,173,350,False,3,6
13606,11,186,198,384,False,3,6
13607,12,185,248,433,False,3,6
13608,13,208,271,479,False,3,6
13609,14,173,219,392,False,3,6
13610,15,119,157,276,False,3,6
13611,16,127,126,253,False,3,6
13612,17,99,137,236,False,3,6
13613,18,102,101,203,False,3,6
13614,19,85,111,196,False,3,6
13615,20,64,77,141,False,3,6
13616,21,37,61,98,False,3,6
13617,22,20,31,51,False,3,6
13618,23,12,21,33,False,3,6
13619,0,11,19,30,False,4,6
13620,1,8,17,25,False,4,6
13621,2,5,12,17,False,4,6
13622,3,13,12,25,False,4,6
13623,4,91,44,135,False,4,6
13624,5,153,104,257,False,4,6
13625,6,204,120,324,False,4,6
13626,7,238,154,392,False,4,6
13627,8,212,158,370,False,4,6
13628,9,177,172,349,False,4,6
13629,10,153,206,359,False,4,6
13630,11,213,185,398,False,4,6
13631,12,215,256,471,False,4,6
13632,13,201,236,437,False,4,6
13633,14,169,222,391,False,4,6
13634,15,114,150,264,False,4,6
13635,16,123,127,250,False,4,6
13636,17,97,118,215,False,4,6
13637,18,94,112,206,False,4,6
13638,19,62,76,138,False,4,6
13639,20,45,55,100,False,4,6
13640,21,33,51,84,False,4,6
13641,22,19,38,57,False,4,6
13642,23,21,27,48,False,4,6
13643,0,10,22,32,False,5,6
13644,1,7,23,30,False,5,6
13645,2,12,11,23,False,5,6
13646,3,9,7,16,False,5,6
13647,4,18,11,29,False,5,6
13648,5,28,21,49,False,5,6
13649,6,18,16,34,False,5,6
13650,7,44,47,91,False,5,6
13651,8,75,70,145,False,5,6
13652,9,103,89,192,False,5,6
13653,10,108,109,217,False,5,6
13654,11,103,110,213,False,5,6
13655,12,113,143,256,False,5,6
13656,13,116,129,245,False,5,6
13657,14,88,129,217,False,5,6
13658,15,102,114,216,False,5,6
13659,16,92,119,211,False,5,6
13660,17,88,98,186,False,5,6
13661,18,79,104,183,False,5,6
13662,19,64,83,147,False,5,6
13663,20,45,69,114,False,5,6
13664,21,29,53,82,False,5,6
13665,22,27,50,77,False,5,6
13666,23,21,41,62,False,5,6
13667,0,15,33,48,True,6,6
13668,1,12,39,51,True,6,6
13669,2,14,24,38,True,6,6
13670,3,8,10,18,True,6,6
13671,4,15,13,28,True,6,6
13672,5,14,14,28,True,6,6
13673,6,25,11,36,True,6,6
13674,7,28,35,63,True,6,6
13675,8,50,45,95,True,6,6
13676,9,75,52,127,True,6,6
13677,10,99,79,178,True,6,6
13678,11,90,116,206,True,6,6
13679,12,111,130,241,True,6,6
13680,13,110,160,270,True,6,6
13681,14,102,125,227,True,6,6
13682,15,108,124,232,True,6,6
13683,16,104,134,238,True,6,6
13684,17,103,120,223,True,6,6
13685,18,96,137,233,True,6,6
13686,19,48,78,126,True,6,6
13687,20,63,83,146,True,6,6
13688,21,34,46,80,True,6,6
13689,22,32,28,60,True,6,6
13690,23,10,16,26,True,6,6
13691,0,8,18,26,True,0,6
13692,1,5,15,20,True,0,6
13693,2,10,15,25,True,0,6
13694,3,10,17,27,True,0,6
13695,4,72,38,110,True,0,6
13696,5,129,94,223,True,0,6
13697,6,172,88,260,True,0,6
13698,7,163,135,298,True,0,6
13699,8,158,137,295,True,0,6
13700,9,195,136,331,True,0,6
13701,10,158,185,343,True,0,6
13702,11,155,163,318,True,0,6
13703,12,172,207,379,True,0,6
13704,13,159,212,371,True,0,6
13705,14,157,197,354,True,0,6
13706,15,124,135,259,True,0,6
13707,16,126,122,248,True,0,6
13708,17,96,148,244,True,0,6
13709,18,97,107,204,True,0,6
13710,19,73,114,187,True,0,6
13711,20,47,84,131,True,0,6
13712,21,28,45,73,True,0,6
13713,22,15,29,44,True,0,6
13714,23,15,17,32,True,0,6
13715,0,6,18,24,True,1,6
13716,1,3,13,16,True,1,6
13717,2,13,10,23,True,1,6
13718,3,15,14,29,True,1,6
13719,4,63,40,103,True,1,6
13720,5,143,79,222,True,1,6
13721,6,183,96,279,True,1,6
13722,7,133,125,258,True,1,6
13723,8,132,129,261,True,1,6
13724,9,157,151,308,True,1,6
13725,10,156,169,325,True,1,6
13726,11,170,160,330,True,1,6
13727,12,168,197,365,True,1,6
13728,13,155,231,386,True,1,6
13729,14,131,192,323,True,1,6
13730,15,100,156,256,True,1,6
13731,16,106,125,231,True,1,6
13732,17,96,115,211,True,1,6
13733,18,79,97,176,True,1,6
13734,19,62,92,154,True,1,6
13735,20,59,88,147,True,1,6
13736,21,29,42,71,True,1,6
13737,22,14,22,36,True,1,6
13738,23,14,16,30,True,1,6
13739,0,12,10,22,True,2,6
13740,1,8,17,25,True,2,6
13741,2,6,10,16,True,2,6
13742,3,13,16,29,True,2,6
13743,4,74,39,113,True,2,6
13744,5,128,97,225,True,2,6
13745,6,164,98,262,True,2,6
13746,7,138,94,232,True,2,6
13747,8,128,122,250,True,2,6
13748,9,148,127,275,True,2,6
13749,10,157,137,294,True,2,6
13750,11,169,173,342,True,2,6
13751,12,175,210,385,True,2,6
13752,13,182,207,389,True,2,6
13753,14,126,193,319,True,2,6
13754,15,107,155,262,True,2,6
13755,16,115,116,231,True,2,6
13756,17,113,125,238,True,2,6
13757,18,91,100,191,True,2,6
13758,19,78,106,184,True,2,6
13759,20,53,67,120,True,2,6
13760,21,21,47,68,True,2,6
13761,22,21,23,44,True,2,6
13762,23,19,16,35,True,2,6
13763,0,9,18,27,True,3,6
13764,1,8,11,19,True,3,6
13765,2,9,14,23,True,3,6
13766,3,14,15,29,True,3,6
13767,4,63,31,94,True,3,6
13768,5,129,79,208,True,3,6
13769,6,161,93,254,True,3,6
13770,7,127,118,245,True,3,6
13771,8,154,132,286,True,3,6
13772,9,156,135,291,True,3,6
13773,10,131,160,291,True,3,6
13774,11,171,173,344,True,3,6
13775,12,176,202,378,True,3,6
13776,13,157,217,374,True,3,6
13777,14,146,164,310,True,3,6
13778,15,107,155,262,True,3,6
13779,16,109,125,234,True,3,6
13780,17,84,101,185,True,3,6
13781,18,95,93,188,True,3,6
13782,19,88,86,174,True,3,6
13783,20,49,77,126,True,3,6
13784,21,43,57,100,True,3,6
13785,22,24,22,46,True,3,6
13786,23,15,34,49,True,3,6
13787,0,13,22,35,True,4,6
13788,1,9,24,33,True,4,6
13789,2,6,12,18,True,4,6
13790,3,5,12,17,True,4,6
13791,4,57,32,89,True,4,6
13792,5,107,75,182,True,4,6
13793,6,143,83,226,True,4,6
13794,7,144,117,261,True,4,6
13795,8,146,113,259,True,4,6
13796,9,187,116,303,True,4,6
13797,10,164,184,348,True,4,6
13798,11,158,153,311,True,4,6
13799,12,163,169,332,True,4,6
13800,13,125,237,362,True,4,6
13801,14,127,161,288,True,4,6
13802,15,106,122,228,True,4,6
13803,16,89,104,193,True,4,6
13804,17,84,116,200,True,4,6
13805,18,83,97,180,True,4,6
13806,19,71,89,160,True,4,6
13807,20,50,71,121,True,4,6
13808,21,32,54,86,True,4,6
13809,22,19,42,61,True,4,6
13810,23,18,27,45,True,4,6
13811,0,12,26,38,True,5,6
13812,1,8,24,32,True,5,6
13813,2,8,13,21,True,5,6
13814,3,4,9,13,True,5,6
13815,4,14,14,28,True,5,6
13816,5,20,21,41,True,5,6
13817,6,27,32,59,True,5,6
13818,7,37,34,71,True,5,6
13819,8,64,64,128,True,5,6
13820,9,89,84,173,True,5,6
13821,10,94,109,203,True,5,6
13822,11,86,119,205,True,5,6
13823,12,111,134,245,True,5,6
13824,13,115,111,226,True,5,6
13825,14,102,113,215,True,5,6
13826,15,99,115,214,True,5,6
13827,16,86,106,192,True,5,6
13828,17,71,108,179,True,5,6
13829,18,67,86,153,True,5,6
13830,19,47,64,111,True,5,6
13831,20,33,61,94,True,5,6
13832,21,35,42,77,True,5,6
13833,22,27,41,68,True,5,6
13834,23,15,37,52,True,5,6
13835,0,13,44,57,True,6,6
13836,1,21,42,63,True,6,6
13837,2,9,21,30,True,6,6
13838,3,12,11,23,True,6,6
13839,4,16,9,25,True,6,6
13840,5,18,16,34,True,6,6
13841,6,17,23,40,True,6,6
13842,7,38,31,69,True,6,6
13843,8,50,44,94,True,6,6
13844,9,56,55,111,True,6,6
13845,10,85,100,185,True,6,6
13846,11,98,117,215,True,6,6
13847,12,117,144,261,True,6,6
13848,13,128,155,283,True,6,6
13849,14,109,142,251,True,6,6
13850,15,94,130,224,True,6,6
13851,16,90,119,209,True,6,6
13852,17,109,160,269,True,6,6
13853,18,94,101,195,True,6,6
13854,19,72,86,158,True,6,6
13855,20,91,72,163,True,6,6
13856,21,25,41,66,True,6,6
13857,22,19,21,40,True,6,6
13858,23,19,18,37,True,6,6
13859,0,5,15,20,True,0,6
13860,1,2,11,13,True,0,6
13861,2,9,8,17,True,0,6
13862,3,11,9,20,True,0,6
13863,4,67,38,105,True,0,6
13864,5,103,87,190,True,0,6
13865,6,120,90,210,True,0,6
13866,7,127,97,224,True,0,6
13867,8,149,120,269,True,0,6
13868,9,141,118,259,True,0,6
13869,10,150,142,292,True,0,6
13870,11,146,150,296,True,0,6
13871,12,171,208,379,True,0,6
13872,13,138,221,359,True,0,6
13873,14,134,201,335,True,0,6
13874,15,117,127,244,True,0,6
13875,16,106,142,248,True,0,6
13876,17,78,103,181,True,0,6
13877,18,84,92,176,True,0,6
13878,19,64,68,132,True,0,6
13879,20,48,60,108,True,0,6
13880,21,35,47,82,True,0,6
13881,22,19,24,43,True,0,6
13882,23,9,15,24,True,0,6
13883,0,7,11,18,True,1,6
13884,1,3,7,10,True,1,6
13885,2,5,4,9,True,1,6
13886,3,17,8,25,True,1,6
13887,4,63,28,91,True,1,6
13888,5,106,87,193,True,1,6
13889,6,132,83,215,True,1,6
13890,7,135,111,246,True,1,6
13891,8,131,127,258,True,1,6
13892,9,140,139,279,True,1,6
13893,10,170,144,314,True,1,6
13894,11,159,170,329,True,1,6
13895,12,161,219,380,True,1,6
13896,13,142,216,358,True,1,6
13897,14,134,170,304,True,1,6
13898,15,122,158,280,True,1,6
13899,16,105,114,219,True,1,6
13900,17,92,101,193,True,1,6
13901,18,79,91,170,True,1,6
13902,19,65,99,164,True,1,6
13903,20,59,64,123,True,1,6
13904,21,39,50,89,True,1,6
13905,22,15,23,38,True,1,6
13906,23,14,13,27,True,1,6
13907,0,9,17,26,True,2,6
13908,1,6,16,22,True,2,6
13909,2,7,9,16,True,2,6
13910,3,16,8,24,True,2,6
13911,4,57,38,95,True,2,6
13912,5,107,75,182,True,2,6
13913,6,125,79,204,True,2,6
13914,7,117,109,226,True,2,6
13915,8,115,125,240,True,2,6
13916,9,144,112,256,True,2,6
13917,10,138,158,296,True,2,6
13918,11,134,159,293,True,2,6
13919,12,160,189,349,True,2,6
13920,13,155,190,345,True,2,6
13921,14,117,135,252,True,2,6
13922,15,99,124,223,True,2,6
13923,16,84,102,186,True,2,6
13924,17,84,82,166,True,2,6
13925,18,79,96,175,True,2,6
13926,19,52,81,133,True,2,6
13927,20,57,69,126,True,2,6
13928,21,43,59,102,True,2,6
13929,22,19,19,38,True,2,6
13930,23,21,27,48,True,2,6
13931,0,7,21,28,True,3,6
13932,1,9,11,20,True,3,6
13933,2,7,10,17,True,3,6
13934,3,17,11,28,True,3,6
13935,4,59,30,89,True,3,6
13936,5,103,77,180,True,3,6
13937,6,126,92,218,True,3,6
13938,7,141,113,254,True,3,6
13939,8,106,111,217,True,3,6
13940,9,120,131,251,True,3,6
13941,10,133,130,263,True,3,6
13942,11,122,140,262,True,3,6
13943,12,144,188,332,True,3,6
13944,13,149,173,322,True,3,6
13945,14,131,120,251,True,3,6
13946,15,92,117,209,True,3,6
13947,16,89,117,206,True,3,6
13948,17,86,83,169,True,3,6
13949,18,80,93,173,True,3,6
13950,19,79,94,173,True,3,6
13951,20,52,314,366,True,3,6
13952,21,43,295,338,True,3,6
13953,22,29,153,182,True,3,6
13954,23,10,92,102,True,3,6
13955,0,9,52,61,True,4,6
13956,1,7,32,39,True,4,6
13957,2,6,13,19,True,4,6
13958,3,8,10,18,True,4,6
13959,4,62,36,98,True,4,6
13960,5,98,73,171,True,4,6
13961,6,96,82,178,True,4,6
13962,7,131,94,225,True,4,6
13963,8,114,111,225,True,4,6
13964,9,131,123,254,True,4,6
13965,10,143,144,287,True,4,6
13966,11,158,137,295,True,4,6
13967,12,161,193,354,True,4,6
13968,13,134,209,343,True,4,6
13969,14,134,151,285,True,4,6
13970,15,110,114,224,True,4,6
13971,16,86,111,197,True,4,6
13972,17,95,107,202,True,4,6
13973,18,80,88,168,True,4,6
13974,19,57,66,123,True,4,6
13975,20,57,71,128,True,4,6
13976,21,38,41,79,True,4,6
13977,22,21,42,63,True,4,6
13978,23,12,32,44,True,4,6
13979,0,17,27,44,True,5,6
13980,1,14,31,45,True,5,6
13981,2,11,15,26,True,5,6
13982,3,7,13,20,True,5,6
13983,4,18,14,32,True,5,6
13984,5,22,25,47,True,5,6
13985,6,28,28,56,True,5,6
13986,7,39,37,76,True,5,6
13987,8,65,54,119,True,5,6
13988,9,70,86,156,True,5,6
13989,10,99,105,204,True,5,6
13990,11,90,75,165,True,5,6
13991,12,84,134,218,True,5,6
13992,13,95,116,211,True,5,6
13993,14,102,122,224,True,5,6
13994,15,98,100,198,True,5,6
13995,16,76,100,176,True,5,6
13996,17,80,80,160,True,5,6
13997,18,63,78,141,True,5,6
13998,19,53,65,118,True,5,6
13999,20,38,58,96,True,5,6
14000,21,30,64,94,True,5,6
14001,22,26,46,72,True,5,6
14002,23,11,25,36,True,5,6
14003,0,22,37,59,True,6,6
14004,1,17,39,56,True,6,6
14005,2,15,28,43,True,6,6
14006,3,10,14,24,True,6,6
14007,4,10,15,25,True,6,6
14008,5,12,15,27,True,6,6
14009,6,26,9,35,True,6,6
14010,7,27,44,71,True,6,6
14011,8,70,56,126,True,6,6
14012,9,77,71,148,True,6,6
14013,10,88,110,198,True,6,6
14014,11,90,103,193,True,6,6
14015,12,114,124,238,True,6,6
14016,13,114,121,235,True,6,6
14017,14,107,167,274,True,6,6
14018,15,102,123,225,True,6,6
14019,16,106,112,218,True,6,6
14020,17,78,85,163,True,6,6
14021,18,119,135,254,True,6,6
14022,19,93,121,214,True,6,6
14023,20,69,90,159,True,6,6
14024,21,38,56,94,True,6,6
14025,22,20,32,52,True,6,6
14026,23,18,23,41,True,6,6
14027,0,6,18,24,True,0,6
14028,1,12,14,26,True,0,6
14029,2,15,14,29,True,0,6
14030,3,9,16,25,True,0,6
14031,4,75,38,113,True,0,6
14032,5,113,93,206,True,0,6
14033,6,140,80,220,True,0,6
14034,7,147,116,263,True,0,6
14035,8,132,126,258,True,0,6
14036,9,149,128,277,True,0,6
14037,10,153,158,311,True,0,6
14038,11,158,174,332,True,0,6
14039,12,181,208,389,True,0,6
14040,13,137,198,335,True,0,6
14041,14,152,165,317,True,0,6
14042,15,107,169,276,True,0,6
14043,16,112,116,228,True,0,6
14044,17,104,129,233,True,0,6
14045,18,80,93,173,True,0,6
14046,19,54,81,135,True,0,6
14047,20,48,67,115,True,0,6
14048,21,35,45,80,True,0,6
14049,22,19,25,44,True,0,6
14050,23,12,13,25,True,0,6
14051,0,4,14,18,True,1,6
14052,1,7,11,18,True,1,6
14053,2,12,8,20,True,1,6
14054,3,8,12,20,True,1,6
14055,4,68,30,98,True,1,6
14056,5,106,71,177,True,1,6
14057,6,121,85,206,True,1,6
14058,7,143,104,247,True,1,6
14059,8,133,111,244,True,1,6
14060,9,160,143,303,True,1,6
14061,10,136,141,277,True,1,6
14062,11,127,178,305,True,1,6
14063,12,147,193,340,True,1,6
14064,13,140,204,344,True,1,6
14065,14,138,171,309,True,1,6
14066,15,115,146,261,True,1,6
14067,16,109,111,220,True,1,6
14068,17,82,105,187,True,1,6
14069,18,87,104,191,True,1,6
14070,19,71,92,163,True,1,6
14071,20,51,73,124,True,1,6
14072,21,27,39,66,True,1,6
14073,22,16,24,40,True,1,6
14074,23,12,23,35,True,1,6
14075,0,8,12,20,True,2,6
14076,1,5,9,14,True,2,6
14077,2,11,15,26,True,2,6
14078,3,6,15,21,True,2,6
14079,4,63,29,92,True,2,6
14080,5,127,78,205,True,2,6
14081,6,139,83,222,True,2,6
14082,7,116,102,218,True,2,6
14083,8,135,103,238,True,2,6
14084,9,138,136,274,True,2,6
14085,10,169,163,332,True,2,6
14086,11,158,179,337,True,2,6
14087,12,165,202,367,True,2,6
14088,13,141,236,377,True,2,6
14089,14,158,185,343,True,2,6
14090,15,128,153,281,True,2,6
14091,16,131,129,260,True,2,6
14092,17,100,117,217,True,2,6
14093,18,82,107,189,True,2,6
14094,19,55,90,145,True,2,6
14095,20,55,57,112,True,2,6
14096,21,36,39,75,True,2,6
14097,22,22,32,54,True,2,6
14098,23,12,25,37,True,2,6
14099,0,10,26,36,True,3,6
14100,1,8,6,14,True,3,6
14101,2,8,16,24,True,3,6
14102,3,13,17,30,True,3,6
14103,4,62,31,93,True,3,6
14104,5,122,92,214,True,3,6
14105,6,146,92,238,True,3,6
14106,7,123,90,213,True,3,6
14107,8,139,105,244,True,3,6
14108,9,146,121,267,True,3,6
14109,10,181,161,342,True,3,6
14110,11,150,158,308,True,3,6
14111,12,162,193,355,True,3,6
14112,13,166,248,414,True,3,6
14113,14,145,224,369,True,3,6
14114,15,119,156,275,True,3,6
14115,16,130,132,262,True,3,6
14116,17,106,133,239,True,3,6
14117,18,89,103,192,True,3,6
14118,19,73,89,162,True,3,6
14119,20,63,71,134,True,3,6
14120,21,39,71,110,True,3,6
14121,22,37,80,117,True,3,6
14122,23,12,37,49,True,3,6
14123,0,9,20,29,True,4,6
14124,1,8,16,24,True,4,6
14125,2,15,18,33,True,4,6
14126,3,15,18,33,True,4,6
14127,4,68,28,96,True,4,6
14128,5,134,87,221,True,4,6
14129,6,118,88,206,True,4,6
14130,7,122,102,224,True,4,6
14131,8,128,113,241,True,4,6
14132,9,174,139,313,True,4,6
14133,10,187,143,330,True,4,6
14134,11,156,167,323,True,4,6
14135,12,163,203,366,True,4,6
14136,13,172,227,399,True,4,6
14137,14,151,168,319,True,4,6
14138,15,127,158,285,True,4,6
14139,16,117,105,222,True,4,6
14140,17,115,103,218,True,4,6
14141,18,69,95,164,True,4,6
14142,19,63,73,136,True,4,6
14143,20,54,66,120,True,4,6
14144,21,33,49,82,True,4,6
14145,22,21,41,62,True,4,6
14146,23,12,23,35,True,4,6
14147,0,15,22,37,True,5,6
14148,1,8,25,33,True,5,6
14149,2,11,24,35,True,5,6
14150,3,10,7,17,True,5,6
14151,4,15,9,24,True,5,6
14152,5,24,26,50,True,5,6
14153,6,30,29,59,True,5,6
14154,7,40,46,86,True,5,6
14155,8,70,61,131,True,5,6
14156,9,110,100,210,True,5,6
14157,10,106,105,211,True,5,6
14158,11,133,129,262,True,5,6
14159,12,96,109,205,True,5,6
14160,13,105,143,248,True,5,6
14161,14,91,124,215,True,5,6
14162,15,88,107,195,True,5,6
14163,16,112,117,229,True,5,6
14164,17,86,118,204,True,5,6
14165,18,60,73,133,True,5,6
14166,19,52,70,122,True,5,6
14167,20,53,69,122,True,5,6
14168,21,40,56,96,True,5,6
14169,22,20,53,73,True,5,6
14170,23,22,43,65,True,5,6
14171,0,15,22,37,True,6,6
14172,1,18,47,65,True,6,6
14173,2,21,31,52,True,6,6
14174,3,11,14,25,True,6,6
14175,4,17,12,29,True,6,6
14176,5,16,11,27,True,6,6
14177,6,35,17,52,True,6,6
14178,7,30,41,71,True,6,6
14179,8,76,58,134,True,6,6
14180,9,74,67,141,True,6,6
14181,10,108,119,227,True,6,6
14182,11,109,123,232,True,6,6
14183,12,114,142,256,True,6,6
14184,13,125,161,286,True,6,6
14185,14,134,187,321,True,6,6
14186,15,144,153,297,True,6,6
14187,16,120,116,236,True,6,6
14188,17,93,123,216,True,6,6
14189,18,97,130,227,True,6,6
14190,19,80,101,181,True,6,6
14191,20,54,75,129,True,6,6
14192,21,46,43,89,True,6,6
14193,22,17,25,42,True,6,6
14194,23,13,17,30,True,6,6
14195,0,10,13,23,False,0,6
14196,1,5,16,21,False,0,6
14197,2,8,10,18,False,0,6
14198,3,13,7,20,False,0,6
14199,4,77,27,104,False,0,6
14200,5,164,100,264,False,0,6
14201,6,194,138,332,False,0,6
14202,7,203,154,357,False,0,6
14203,8,149,127,276,False,0,6
14204,9,190,143,333,False,0,6
14205,10,190,202,392,False,0,6
14206,11,184,197,381,False,0,6
14207,12,187,252,439,False,0,6
14208,13,198,271,469,False,0,6
14209,14,174,219,393,False,0,6
14210,15,162,190,352,False,0,6
14211,16,119,147,266,False,0,6
14212,17,104,108,212,False,0,6
14213,18,86,100,186,False,0,6
14214,19,74,81,155,False,0,6
14215,20,66,81,147,False,0,6
14216,21,58,49,107,False,0,6
14217,22,17,29,46,False,0,6
14218,23,14,16,30,False,0,6
14219,0,7,4,11,False,1,7
14220,1,6,15,21,False,1,7
14221,2,5,11,16,False,1,7
14222,3,12,10,22,False,1,7
14223,4,86,33,119,False,1,7
14224,5,174,105,279,False,1,7
14225,6,192,134,326,False,1,7
14226,7,154,115,269,False,1,7
14227,8,171,151,322,False,1,7
14228,9,164,151,315,False,1,7
14229,10,188,175,363,False,1,7
14230,11,212,188,400,False,1,7
14231,12,180,272,452,False,1,7
14232,13,165,262,427,False,1,7
14233,14,196,238,434,False,1,7
14234,15,150,180,330,False,1,7
14235,16,137,144,281,False,1,7
14236,17,114,162,276,False,1,7
14237,18,104,147,251,False,1,7
14238,19,72,115,187,False,1,7
14239,20,71,85,156,False,1,7
14240,21,45,51,96,False,1,7
14241,22,24,18,42,False,1,7
14242,23,11,21,32,False,1,7
14243,0,6,14,20,False,2,7
14244,1,11,12,23,False,2,7
14245,2,10,12,22,False,2,7
14246,3,11,12,23,False,2,7
14247,4,84,33,117,False,2,7
14248,5,147,112,259,False,2,7
14249,6,189,99,288,False,2,7
14250,7,163,123,286,False,2,7
14251,8,169,139,308,False,2,7
14252,9,181,156,337,False,2,7
14253,10,205,169,374,False,2,7
14254,11,188,176,364,False,2,7
14255,12,166,232,398,False,2,7
14256,13,169,318,487,False,2,7
14257,14,170,232,402,False,2,7
14258,15,136,181,317,False,2,7
14259,16,121,137,258,False,2,7
14260,17,115,136,251,False,2,7
14261,18,95,109,204,False,2,7
14262,19,74,104,178,False,2,7
14263,20,58,71,129,False,2,7
14264,21,33,45,78,False,2,7
14265,22,24,16,40,False,2,7
14266,23,14,13,27,False,2,7
14267,0,8,9,17,False,3,7
14268,1,6,15,21,False,3,7
14269,2,5,8,13,False,3,7
14270,3,15,10,25,False,3,7
14271,4,74,32,106,False,3,7
14272,5,144,88,232,False,3,7
14273,6,186,109,295,False,3,7
14274,7,186,151,337,False,3,7
14275,8,152,120,272,False,3,7
14276,9,210,149,359,False,3,7
14277,10,171,199,370,False,3,7
14278,11,208,198,406,False,3,7
14279,12,177,235,412,False,3,7
14280,13,187,259,446,False,3,7
14281,14,197,229,426,False,3,7
14282,15,132,162,294,False,3,7
14283,16,135,136,271,False,3,7
14284,17,113,127,240,False,3,7
14285,18,98,121,219,False,3,7
14286,19,70,94,164,False,3,7
14287,20,68,66,134,False,3,7
14288,21,41,38,79,False,3,7
14289,22,18,30,48,False,3,7
14290,23,23,22,45,False,3,7
14291,0,11,22,33,False,4,7
14292,1,7,23,30,False,4,7
14293,2,4,15,19,False,4,7
14294,3,16,6,22,False,4,7
14295,4,66,30,96,False,4,7
14296,5,174,100,274,False,4,7
14297,6,189,122,311,False,4,7
14298,7,186,114,300,False,4,7
14299,8,187,139,326,False,4,7
14300,9,204,181,385,False,4,7
14301,10,195,194,389,False,4,7
14302,11,201,201,402,False,4,7
14303,12,192,233,425,False,4,7
14304,13,208,298,506,False,4,7
14305,14,165,206,371,False,4,7
14306,15,159,172,331,False,4,7
14307,16,120,130,250,False,4,7
14308,17,109,117,226,False,4,7
14309,18,76,102,178,False,4,7
14310,19,65,84,149,False,4,7
14311,20,69,60,129,False,4,7
14312,21,42,59,101,False,4,7
14313,22,29,37,66,False,4,7
14314,23,28,35,63,False,4,7
14315,0,18,30,48,False,5,7
14316,1,18,49,67,False,5,7
14317,2,15,27,42,False,5,7
14318,3,12,18,30,False,5,7
14319,4,25,14,39,False,5,7
14320,5,27,21,48,False,5,7
14321,6,41,38,79,False,5,7
14322,7,50,53,103,False,5,7
14323,8,83,64,147,False,5,7
14324,9,110,103,213,False,5,7
14325,10,165,115,280,False,5,7
14326,11,130,130,260,False,5,7
14327,12,139,164,303,False,5,7
14328,13,139,161,300,False,5,7
14329,14,132,192,324,False,5,7
14330,15,90,153,243,False,5,7
14331,16,116,119,235,False,5,7
14332,17,86,127,213,False,5,7
14333,18,85,88,173,False,5,7
14334,19,73,70,143,False,5,7
14335,20,58,78,136,False,5,7
14336,21,41,47,88,False,5,7
14337,22,39,46,85,False,5,7
14338,23,25,31,56,False,5,7
14339,0,27,41,68,True,6,7
14340,1,22,62,84,True,6,7
14341,2,22,46,68,True,6,7
14342,3,11,18,29,True,6,7
14343,4,12,5,17,True,6,7
14344,5,16,16,32,True,6,7
14345,6,33,20,53,True,6,7
14346,7,57,42,99,True,6,7
14347,8,73,47,120,True,6,7
14348,9,79,67,146,True,6,7
14349,10,142,118,260,True,6,7
14350,11,151,145,296,True,6,7
14351,12,161,161,322,True,6,7
14352,13,143,192,335,True,6,7
14353,14,134,192,326,True,6,7
14354,15,130,175,305,True,6,7
14355,16,142,150,292,True,6,7
14356,17,136,147,283,True,6,7
14357,18,105,133,238,True,6,7
14358,19,99,105,204,True,6,7
14359,20,62,89,151,True,6,7
14360,21,37,54,91,True,6,7
14361,22,18,25,43,True,6,7
14362,23,15,14,29,True,6,7
14363,0,7,9,16,False,0,7
14364,1,10,19,29,False,0,7
14365,2,8,9,17,False,0,7
14366,3,19,6,25,False,0,7
14367,4,109,53,162,False,0,7
14368,5,191,135,326,False,0,7
14369,6,273,148,421,False,0,7
14370,7,229,162,391,False,0,7
14371,8,212,146,358,False,0,7
14372,9,190,179,369,False,0,7
14373,10,207,212,419,False,0,7
14374,11,196,196,392,False,0,7
14375,12,186,253,439,False,0,7
14376,13,221,350,571,False,0,7
14377,14,183,233,416,False,0,7
14378,15,171,181,352,False,0,7
14379,16,156,141,297,False,0,7
14380,17,119,123,242,False,0,7
14381,18,103,98,201,False,0,7
14382,19,91,138,229,False,0,7
14383,20,70,70,140,False,0,7
14384,21,38,37,75,False,0,7
14385,22,15,30,45,False,0,7
14386,23,16,19,35,False,0,7
14387,0,8,10,18,False,1,7
14388,1,1,6,7,False,1,7
14389,2,7,7,14,False,1,7
14390,3,14,17,31,False,1,7
14391,4,111,44,155,False,1,7
14392,5,216,133,349,False,1,7
14393,6,294,144,438,False,1,7
14394,7,211,156,367,False,1,7
14395,8,207,170,377,False,1,7
14396,9,213,181,394,False,1,7
14397,10,205,173,378,False,1,7
14398,11,220,224,444,False,1,7
14399,12,239,274,513,False,1,7
14400,13,226,356,582,False,1,7
14401,14,209,251,460,False,1,7
14402,15,143,194,337,False,1,7
14403,16,159,156,315,False,1,7
14404,17,133,159,292,False,1,7
14405,18,117,136,253,False,1,7
14406,19,102,119,221,False,1,7
14407,20,61,307,368,False,1,7
14408,21,44,226,270,False,1,7
14409,22,18,78,96,False,1,7
14410,23,18,27,45,False,1,7
14411,0,21,22,43,False,2,7
14412,1,14,12,26,False,2,7
14413,2,5,8,13,False,2,7
14414,3,17,15,32,False,2,7
14415,4,98,51,149,False,2,7
14416,5,216,138,354,False,2,7
14417,6,280,162,442,False,2,7
14418,7,245,174,419,False,2,7
14419,8,188,159,347,False,2,7
14420,9,186,182,368,False,2,7
14421,10,207,197,404,False,2,7
14422,11,215,217,432,False,2,7
14423,12,219,261,480,False,2,7
14424,13,228,334,562,False,2,7
14425,14,211,286,497,False,2,7
14426,15,153,182,335,False,2,7
14427,16,149,149,298,False,2,7
14428,17,111,132,243,False,2,7
14429,18,105,118,223,False,2,7
14430,19,105,124,229,False,2,7
14431,20,67,88,155,False,2,7
14432,21,46,47,93,False,2,7
14433,22,20,26,46,False,2,7
14434,23,13,20,33,False,2,7
14435,0,10,15,25,False,3,7
14436,1,3,17,20,False,3,7
14437,2,8,6,14,False,3,7
14438,3,14,10,24,False,3,7
14439,4,97,47,144,False,3,7
14440,5,227,126,353,False,3,7
14441,6,258,173,431,False,3,7
14442,7,225,133,358,False,3,7
14443,8,180,152,332,False,3,7
14444,9,189,173,362,False,3,7
14445,10,197,199,396,False,3,7
14446,11,218,201,419,False,3,7
14447,12,204,259,463,False,3,7
14448,13,232,329,561,False,3,7
14449,14,222,274,496,False,3,7
14450,15,146,219,365,False,3,7
14451,16,145,138,283,False,3,7
14452,17,121,142,263,False,3,7
14453,18,116,141,257,False,3,7
14454,19,99,97,196,False,3,7
14455,20,71,87,158,False,3,7
14456,21,48,54,102,False,3,7
14457,22,23,30,53,False,3,7
14458,23,15,19,34,False,3,7
14459,0,13,21,34,False,4,7
14460,1,23,23,46,False,4,7
14461,2,10,24,34,False,4,7
14462,3,16,11,27,False,4,7
14463,4,127,57,184,False,4,7
14464,5,203,113,316,False,4,7
14465,6,269,141,410,False,4,7
14466,7,236,149,385,False,4,7
14467,8,188,161,349,False,4,7
14468,9,222,193,415,False,4,7
14469,10,218,195,413,False,4,7
14470,11,230,228,458,False,4,7
14471,12,276,309,585,False,4,7
14472,13,268,433,701,False,4,7
14473,14,338,373,711,False,4,7
14474,15,163,221,384,False,4,7
14475,16,138,166,304,False,4,7
14476,17,144,130,274,False,4,7
14477,18,121,122,243,False,4,7
14478,19,94,98,192,False,4,7
14479,20,80,92,172,False,4,7
14480,21,58,74,132,False,4,7
14481,22,29,43,72,False,4,7
14482,23,29,40,69,False,4,7
14483,0,20,25,45,False,5,7
14484,1,16,34,50,False,5,7
14485,2,9,20,29,False,5,7
14486,3,12,16,28,False,5,7
14487,4,19,18,37,False,5,7
14488,5,27,29,56,False,5,7
14489,6,24,35,59,False,5,7
14490,7,76,57,133,False,5,7
14491,8,97,67,164,False,5,7
14492,9,112,98,210,False,5,7
14493,10,162,149,311,False,5,7
14494,11,169,171,340,False,5,7
14495,12,169,170,339,False,5,7
14496,13,173,157,330,False,5,7
14497,14,174,210,384,False,5,7
14498,15,135,177,312,False,5,7
14499,16,119,168,287,False,5,7
14500,17,108,126,234,False,5,7
14501,18,103,109,212,False,5,7
14502,19,84,118,202,False,5,7
14503,20,59,74,133,False,5,7
14504,21,36,65,101,False,5,7
14505,22,36,63,99,False,5,7
14506,23,20,46,66,False,5,7
14507,0,19,42,61,True,6,7
14508,1,24,43,67,True,6,7
14509,2,21,28,49,True,6,7
14510,3,20,21,41,True,6,7
14511,4,21,20,41,True,6,7
14512,5,15,11,26,True,6,7
14513,6,27,20,47,True,6,7
14514,7,54,52,106,True,6,7
14515,8,83,69,152,True,6,7
14516,9,93,86,179,True,6,7
14517,10,136,147,283,True,6,7
14518,11,145,165,310,True,6,7
14519,12,181,193,374,True,6,7
14520,13,177,202,379,True,6,7
14521,14,152,231,383,True,6,7
14522,15,169,200,369,True,6,7
14523,16,160,164,324,True,6,7
14524,17,148,155,303,True,6,7
14525,18,173,172,345,True,6,7
14526,19,96,117,213,True,6,7
14527,20,67,93,160,True,6,7
14528,21,35,35,70,True,6,7
14529,22,22,24,46,True,6,7
14530,23,18,29,47,True,6,7
14531,0,8,10,18,False,0,7
14532,1,10,19,29,False,0,7
14533,2,7,11,18,False,0,7
14534,3,14,8,22,False,0,7
14535,4,120,68,188,False,0,7
14536,5,242,150,392,False,0,7
14537,6,362,191,553,False,0,7
14538,7,259,212,471,False,0,7
14539,8,221,177,398,False,0,7
14540,9,219,170,389,False,0,7
14541,10,215,173,388,False,0,7
14542,11,218,220,438,False,0,7
14543,12,237,298,535,False,0,7
14544,13,260,397,657,False,0,7
14545,14,225,315,540,False,0,7
14546,15,153,182,335,False,0,7
14547,16,167,140,307,False,0,7
14548,17,145,176,321,False,0,7
14549,18,99,147,246,False,0,7
14550,19,101,125,226,False,0,7
14551,20,78,70,148,False,0,7
14552,21,45,55,100,False,0,7
14553,22,29,27,56,False,0,7
14554,23,19,34,53,False,0,7
14555,0,12,28,40,False,1,7
14556,1,15,19,34,False,1,7
14557,2,3,11,14,False,1,7
14558,3,19,8,27,False,1,7
14559,4,140,57,197,False,1,7
14560,5,252,145,397,False,1,7
14561,6,324,162,486,False,1,7
14562,7,256,183,439,False,1,7
14563,8,221,161,382,False,1,7
14564,9,248,220,468,False,1,7
14565,10,251,230,481,False,1,7
14566,11,215,211,426,False,1,7
14567,12,220,295,515,False,1,7
14568,13,248,350,598,False,1,7
14569,14,223,305,528,False,1,7
14570,15,141,203,344,False,1,7
14571,16,166,152,318,False,1,7
14572,17,135,160,295,False,1,7
14573,18,123,159,282,False,1,7
14574,19,96,130,226,False,1,7
14575,20,52,103,155,False,1,7
14576,21,47,53,100,False,1,7
14577,22,25,26,51,False,1,7
14578,23,18,38,56,False,1,7
14579,0,15,39,54,False,2,7
14580,1,9,26,35,False,2,7
14581,2,9,10,19,False,2,7
14582,3,17,12,29,False,2,7
14583,4,123,56,179,False,2,7
14584,5,238,128,366,False,2,7
14585,6,335,180,515,False,2,7
14586,7,263,152,415,False,2,7
14587,8,206,197,403,False,2,7
14588,9,226,197,423,False,2,7
14589,10,209,199,408,False,2,7
14590,11,217,230,447,False,2,7
14591,12,237,290,527,False,2,7
14592,13,254,341,595,False,2,7
14593,14,195,283,478,False,2,7
14594,15,151,188,339,False,2,7
14595,16,160,157,317,False,2,7
14596,17,123,169,292,False,2,7
14597,18,120,150,270,False,2,7
14598,19,96,150,246,False,2,7
14599,20,71,79,150,False,2,7
14600,21,41,43,84,False,2,7
14601,22,23,30,53,False,2,7
14602,23,12,39,51,False,2,7
14603,0,17,36,53,False,3,7
14604,1,6,27,33,False,3,7
14605,2,11,14,25,False,3,7
14606,3,14,10,24,False,3,7
14607,4,136,46,182,False,3,7
14608,5,205,145,350,False,3,7
14609,6,375,189,564,False,3,7
14610,7,255,159,414,False,3,7
14611,8,221,220,441,False,3,7
14612,9,219,191,410,False,3,7
14613,10,257,208,465,False,3,7
14614,11,196,218,414,False,3,7
14615,12,241,303,544,False,3,7
14616,13,244,380,624,False,3,7
14617,14,211,275,486,False,3,7
14618,15,177,188,365,False,3,7
14619,16,144,155,299,False,3,7
14620,17,147,158,305,False,3,7
14621,18,143,161,304,False,3,7
14622,19,83,114,197,False,3,7
14623,20,68,82,150,False,3,7
14624,21,43,63,106,False,3,7
14625,22,29,34,63,False,3,7
14626,23,19,34,53,False,3,7
14627,0,13,32,45,False,4,7
14628,1,9,36,45,False,4,7
14629,2,7,18,25,False,4,7
14630,3,15,11,26,False,4,7
14631,4,118,53,171,False,4,7
14632,5,238,142,380,False,4,7
14633,6,338,182,520,False,4,7
14634,7,227,153,380,False,4,7
14635,8,218,183,401,False,4,7
14636,9,203,223,426,False,4,7
14637,10,237,232,469,False,4,7
14638,11,227,219,446,False,4,7
14639,12,206,316,522,False,4,7
14640,13,278,353,631,False,4,7
14641,14,224,268,492,False,4,7
14642,15,166,209,375,False,4,7
14643,16,197,174,371,False,4,7
14644,17,139,165,304,False,4,7
14645,18,95,134,229,False,4,7
14646,19,71,94,165,False,4,7
14647,20,66,80,146,False,4,7
14648,21,48,60,108,False,4,7
14649,22,31,56,87,False,4,7
14650,23,44,53,97,False,4,7
14651,0,23,44,67,False,5,7
14652,1,20,42,62,False,5,7
14653,2,13,31,44,False,5,7
14654,3,11,16,27,False,5,7
14655,4,29,20,49,False,5,7
14656,5,37,27,64,False,5,7
14657,6,35,43,78,False,5,7
14658,7,76,62,138,False,5,7
14659,8,125,84,209,False,5,7
14660,9,129,111,240,False,5,7
14661,10,158,123,281,False,5,7
14662,11,163,147,310,False,5,7
14663,12,181,165,346,False,5,7
14664,13,150,196,346,False,5,7
14665,14,154,192,346,False,5,7
14666,15,126,168,294,False,5,7
14667,16,143,151,294,False,5,7
14668,17,123,136,259,False,5,7
14669,18,108,112,220,False,5,7
14670,19,71,109,180,False,5,7
14671,20,58,56,114,False,5,7
14672,21,61,95,156,False,5,7
14673,22,45,86,131,False,5,7
14674,23,47,69,116,False,5,7
14675,0,22,46,68,True,6,7
14676,1,22,37,59,True,6,7
14677,2,27,44,71,True,6,7
14678,3,11,16,27,True,6,7
14679,4,19,8,27,True,6,7
14680,5,19,22,41,True,6,7
14681,6,33,21,54,True,6,7
14682,7,38,48,86,True,6,7
14683,8,88,78,166,True,6,7
14684,9,121,95,216,True,6,7
14685,10,123,136,259,True,6,7
14686,11,161,180,341,True,6,7
14687,12,185,195,380,True,6,7
14688,13,160,205,365,True,6,7
14689,14,137,205,342,True,6,7
14690,15,179,167,346,True,6,7
14691,16,159,151,310,True,6,7
14692,17,181,181,362,True,6,7
14693,18,152,175,327,True,6,7
14694,19,98,107,205,True,6,7
14695,20,63,97,160,True,6,7
14696,21,27,48,75,True,6,7
14697,22,19,24,43,True,6,7
14698,23,14,19,33,True,6,7
14699,0,8,7,15,False,0,7
14700,1,4,6,10,False,0,7
14701,2,8,6,14,False,0,7
14702,3,14,13,27,False,0,7
14703,4,135,55,190,False,0,7
14704,5,260,164,424,False,0,7
14705,6,425,216,641,False,0,7
14706,7,264,180,444,False,0,7
14707,8,220,178,398,False,0,7
14708,9,194,168,362,False,0,7
14709,10,226,200,426,False,0,7
14710,11,242,224,466,False,0,7
14711,12,237,327,564,False,0,7
14712,13,234,360,594,False,0,7
14713,14,224,301,525,False,0,7
14714,15,174,211,385,False,0,7
14715,16,198,165,363,False,0,7
14716,17,139,141,280,False,0,7
14717,18,112,130,242,False,0,7
14718,19,99,142,241,False,0,7
14719,20,39,83,122,False,0,7
14720,21,35,48,83,False,0,7
14721,22,14,27,41,False,0,7
14722,23,10,14,24,False,0,7
14723,0,4,9,13,False,1,7
14724,1,7,9,16,False,1,7
14725,2,4,9,13,False,1,7
14726,3,16,12,28,False,1,7
14727,4,122,52,174,False,1,7
14728,5,273,168,441,False,1,7
14729,6,410,191,601,False,1,7
14730,7,262,172,434,False,1,7
14731,8,210,196,406,False,1,7
14732,9,222,228,450,False,1,7
14733,10,200,219,419,False,1,7
14734,11,247,209,456,False,1,7
14735,12,210,324,534,False,1,7
14736,13,294,368,662,False,1,7
14737,14,223,309,532,False,1,7
14738,15,166,208,374,False,1,7
14739,16,177,186,363,False,1,7
14740,17,130,157,287,False,1,7
14741,18,140,165,305,False,1,7
14742,19,95,143,238,False,1,7
14743,20,56,91,147,False,1,7
14744,21,38,40,78,False,1,7
14745,22,23,35,58,False,1,7
14746,23,11,22,33,False,1,7
14747,0,9,30,39,False,2,7
14748,1,8,12,20,False,2,7
14749,2,4,19,23,False,2,7
14750,3,15,15,30,False,2,7
14751,4,126,48,174,False,2,7
14752,5,246,154,400,False,2,7
14753,6,412,209,621,False,2,7
14754,7,243,175,418,False,2,7
14755,8,225,184,409,False,2,7
14756,9,227,226,453,False,2,7
14757,10,231,189,420,False,2,7
14758,11,227,196,423,False,2,7
14759,12,235,268,503,False,2,7
14760,13,280,378,658,False,2,7
14761,14,229,300,529,False,2,7
14762,15,161,211,372,False,2,7
14763,16,155,158,313,False,2,7
14764,17,124,147,271,False,2,7
14765,18,121,138,259,False,2,7
14766,19,95,144,239,False,2,7
14767,20,86,81,167,False,2,7
14768,21,40,45,85,False,2,7
14769,22,16,30,46,False,2,7
14770,23,8,25,33,False,2,7
14771,0,8,17,25,False,3,7
14772,1,11,16,27,False,3,7
14773,2,13,20,33,False,3,7
14774,3,14,12,26,False,3,7
14775,4,115,50,165,False,3,7
14776,5,264,147,411,False,3,7
14777,6,384,208,592,False,3,7
14778,7,226,178,404,False,3,7
14779,8,214,164,378,False,3,7
14780,9,215,184,399,False,3,7
14781,10,208,208,416,False,3,7
14782,11,192,228,420,False,3,7
14783,12,237,260,497,False,3,7
14784,13,260,369,629,False,3,7
14785,14,212,284,496,False,3,7
14786,15,183,209,392,False,3,7
14787,16,192,153,345,False,3,7
14788,17,144,211,355,False,3,7
14789,18,101,162,263,False,3,7
14790,19,86,135,221,False,3,7
14791,20,83,67,150,False,3,7
14792,21,41,53,94,False,3,7
14793,22,27,37,64,False,3,7
14794,23,16,77,93,False,3,7
14795,0,14,69,83,False,4,7
14796,1,9,51,60,False,4,7
14797,2,9,19,28,False,4,7
14798,3,14,14,28,False,4,7
14799,4,116,53,169,False,4,7
14800,5,241,129,370,False,4,7
14801,6,370,202,572,False,4,7
14802,7,244,189,433,False,4,7
14803,8,221,174,395,False,4,7
14804,9,238,200,438,False,4,7
14805,10,228,230,458,False,4,7
14806,11,214,268,482,False,4,7
14807,12,229,336,565,False,4,7
14808,13,274,406,680,False,4,7
14809,14,200,282,482,False,4,7
14810,15,140,179,319,False,4,7
14811,16,148,152,300,False,4,7
14812,17,112,141,253,False,4,7
14813,18,110,119,229,False,4,7
14814,19,84,123,207,False,4,7
14815,20,49,91,140,False,4,7
14816,21,60,81,141,False,4,7
14817,22,29,57,86,False,4,7
14818,23,24,41,65,False,4,7
14819,0,23,32,55,False,5,7
14820,1,16,38,54,False,5,7
14821,2,11,28,39,False,5,7
14822,3,8,15,23,False,5,7
14823,4,27,16,43,False,5,7
14824,5,32,22,54,False,5,7
14825,6,33,35,68,False,5,7
14826,7,63,65,128,False,5,7
14827,8,126,92,218,False,5,7
14828,9,149,131,280,False,5,7
14829,10,138,120,258,False,5,7
14830,11,161,147,308,False,5,7
14831,12,150,153,303,False,5,7
14832,13,129,197,326,False,5,7
14833,14,158,162,320,False,5,7
14834,15,138,171,309,False,5,7
14835,16,128,140,268,False,5,7
14836,17,96,99,195,False,5,7
14837,18,87,111,198,False,5,7
14838,19,62,131,193,False,5,7
14839,20,53,62,115,False,5,7
14840,21,39,78,117,False,5,7
14841,22,38,52,90,False,5,7
14842,23,33,53,86,False,5,7
14843,0,36,54,90,True,6,7
14844,1,29,49,78,True,6,7
14845,2,16,51,67,True,6,7
14846,3,13,17,30,True,6,7
14847,4,19,16,35,True,6,7
14848,5,16,35,51,True,6,7
14849,6,35,25,60,True,6,7
14850,7,64,54,118,True,6,7
14851,8,90,77,167,True,6,7
14852,9,98,78,176,True,6,7
14853,10,112,117,229,True,6,7
14854,11,134,162,296,True,6,7
14855,12,145,160,305,True,6,7
14856,13,162,183,345,True,6,7
14857,14,136,191,327,True,6,7
14858,15,179,185,364,True,6,7
14859,16,175,152,327,True,6,7
14860,17,162,175,337,True,6,7
14861,18,128,173,301,True,6,7
14862,19,94,138,232,True,6,7
14863,20,62,88,150,True,6,7
14864,21,28,54,82,True,6,7
14865,22,22,20,42,True,6,7
14866,23,15,20,35,True,6,7
14867,0,4,14,18,False,0,7
14868,1,8,11,19,False,0,7
14869,2,4,7,11,False,0,7
14870,3,9,15,24,False,0,7
14871,4,109,51,160,False,0,7
14872,5,248,139,387,False,0,7
14873,6,399,182,581,False,0,7
14874,7,270,161,431,False,0,7
14875,8,252,180,432,False,0,7
14876,9,247,201,448,False,0,7
14877,10,184,227,411,False,0,7
14878,11,231,220,451,False,0,7
14879,12,223,282,505,False,0,7
14880,13,224,369,593,False,0,7
14881,14,226,301,527,False,0,7
14882,15,185,201,386,False,0,7
14883,16,163,148,311,False,0,7
14884,17,153,165,318,False,0,7
14885,18,102,125,227,False,0,7
14886,19,89,127,216,False,0,7
14887,20,57,72,129,False,0,7
14888,21,31,27,58,False,0,7
14889,22,11,14,25,False,0,7
14890,23,4,14,18,False,0,7
14891,0,7,12,19,False,1,7
14892,1,5,14,19,False,1,7
14893,2,4,8,12,False,1,7
14894,3,16,9,25,False,1,7
14895,4,110,54,164,False,1,7
14896,5,250,139,389,False,1,7
14897,6,405,191,596,False,1,7
14898,7,241,178,419,False,1,7
14899,8,225,178,403,False,1,7
14900,9,217,191,408,False,1,7
14901,10,211,201,412,False,1,7
14902,11,238,239,477,False,1,7
14903,12,237,263,500,False,1,7
14904,13,234,351,585,False,1,7
14905,14,229,263,492,False,1,7
14906,15,175,197,372,False,1,7
14907,16,215,180,395,False,1,7
14908,17,161,177,338,False,1,7
14909,18,131,164,295,False,1,7
14910,19,84,129,213,False,1,7
14911,20,57,100,157,False,1,7
14912,21,28,45,73,False,1,7
14913,22,13,22,35,False,1,7
14914,23,16,23,39,False,1,7
14915,0,5,16,21,False,2,7
14916,1,9,11,20,False,2,7
14917,2,5,11,16,False,2,7
14918,3,18,14,32,False,2,7
14919,4,124,59,183,False,2,7
14920,5,240,147,387,False,2,7
14921,6,382,197,579,False,2,7
14922,7,238,164,402,False,2,7
14923,8,211,177,388,False,2,7
14924,9,190,179,369,False,2,7
14925,10,207,189,396,False,2,7
14926,11,210,208,418,False,2,7
14927,12,216,259,475,False,2,7
14928,13,233,424,657,False,2,7
14929,14,275,399,674,False,2,7
14930,15,239,232,471,False,2,7
14931,16,167,173,340,False,2,7
14932,17,124,152,276,False,2,7
14933,18,131,146,277,False,2,7
14934,19,81,104,185,False,2,7
14935,20,92,112,204,False,2,7
14936,21,32,55,87,False,2,7
14937,22,15,24,39,False,2,7
14938,23,8,22,30,False,2,7
14939,0,7,18,25,False,3,7
14940,1,4,17,21,False,3,7
14941,2,7,15,22,False,3,7
14942,3,17,18,35,False,3,7
14943,4,136,63,199,False,3,7
14944,5,215,155,370,False,3,7
14945,6,398,202,600,False,3,7
14946,7,247,183,430,False,3,7
14947,8,233,180,413,False,3,7
14948,9,262,185,447,False,3,7
14949,10,201,207,408,False,3,7
14950,11,250,226,476,False,3,7
14951,12,213,278,491,False,3,7
14952,13,253,328,581,False,3,7
14953,14,265,298,563,False,3,7
14954,15,193,224,417,False,3,7
14955,16,184,171,355,False,3,7
14956,17,166,171,337,False,3,7
14957,18,118,144,262,False,3,7
14958,19,84,123,207,False,3,7
14959,20,61,116,177,False,3,7
14960,21,39,60,99,False,3,7
14961,22,21,30,51,False,3,7
14962,23,13,23,36,False,3,7
14963,0,9,26,35,False,4,8
14964,1,13,17,30,False,4,8
14965,2,10,17,27,False,4,8
14966,3,13,15,28,False,4,8
14967,4,115,54,169,False,4,8
14968,5,239,151,390,False,4,8
14969,6,413,184,597,False,4,8
14970,7,261,198,459,False,4,8
14971,8,257,169,426,False,4,8
14972,9,277,223,500,False,4,8
14973,10,211,226,437,False,4,8
14974,11,211,236,447,False,4,8
14975,12,250,300,550,False,4,8
14976,13,275,365,640,False,4,8
14977,14,217,276,493,False,4,8
14978,15,135,169,304,False,4,8
14979,16,138,173,311,False,4,8
14980,17,125,139,264,False,4,8
14981,18,116,123,239,False,4,8
14982,19,84,89,173,False,4,8
14983,20,71,73,144,False,4,8
14984,21,49,66,115,False,4,8
14985,22,47,61,108,False,4,8
14986,23,25,36,61,False,4,8
14987,0,21,45,66,False,5,8
14988,1,18,31,49,False,5,8
14989,2,6,19,25,False,5,8
14990,3,9,9,18,False,5,8
14991,4,26,15,41,False,5,8
14992,5,26,17,43,False,5,8
14993,6,41,46,87,False,5,8
14994,7,60,58,118,False,5,8
14995,8,105,82,187,False,5,8
14996,9,133,110,243,False,5,8
14997,10,146,125,271,False,5,8
14998,11,144,160,304,False,5,8
14999,12,134,141,275,False,5,8
15000,13,141,164,305,False,5,8
15001,14,132,170,302,False,5,8
15002,15,110,143,253,False,5,8
15003,16,115,127,242,False,5,8
15004,17,108,120,228,False,5,8
15005,18,78,109,187,False,5,8
15006,19,61,85,146,False,5,8
15007,20,42,74,116,False,5,8
15008,21,38,60,98,False,5,8
15009,22,35,59,94,False,5,8
15010,23,30,46,76,False,5,8
15011,0,30,42,72,True,6,8
15012,1,18,48,66,True,6,8
15013,2,13,28,41,True,6,8
15014,3,13,18,31,True,6,8
15015,4,16,16,32,True,6,8
15016,5,16,14,30,True,6,8
15017,6,39,16,55,True,6,8
15018,7,41,48,89,True,6,8
15019,8,75,74,149,True,6,8
15020,9,107,92,199,True,6,8
15021,10,173,134,307,True,6,8
15022,11,140,169,309,True,6,8
15023,12,158,181,339,True,6,8
15024,13,142,198,340,True,6,8
15025,14,153,214,367,True,6,8
15026,15,141,213,354,True,6,8
15027,16,177,159,336,True,6,8
15028,17,179,180,359,True,6,8
15029,18,139,174,313,True,6,8
15030,19,99,156,255,True,6,8
15031,20,53,75,128,True,6,8
15032,21,36,41,77,True,6,8
15033,22,12,24,36,True,6,8
15034,23,9,16,25,True,6,8
15035,0,9,10,19,False,0,8
15036,1,7,17,24,False,0,8
15037,2,4,4,8,False,0,8
15038,3,19,11,30,False,0,8
15039,4,115,55,170,False,0,8
15040,5,233,146,379,False,0,8
15041,6,416,200,616,False,0,8
15042,7,243,164,407,False,0,8
15043,8,220,175,395,False,0,8
15044,9,218,206,424,False,0,8
15045,10,221,184,405,False,0,8
15046,11,216,238,454,False,0,8
15047,12,220,287,507,False,0,8
15048,13,254,440,694,False,0,8
15049,14,217,349,566,False,0,8
15050,15,161,199,360,False,0,8
15051,16,157,165,322,False,0,8
15052,17,138,167,305,False,0,8
15053,18,131,151,282,False,0,8
15054,19,99,139,238,False,0,8
15055,20,51,102,153,False,0,8
15056,21,25,36,61,False,0,8
15057,22,18,16,34,False,0,8
15058,23,10,13,23,False,0,8
15059,0,6,12,18,False,1,8
15060,1,5,17,22,False,1,8
15061,2,13,12,25,False,1,8
15062,3,19,8,27,False,1,8
15063,4,129,49,178,False,1,8
15064,5,262,172,434,False,1,8
15065,6,399,205,604,False,1,8
15066,7,262,175,437,False,1,8
15067,8,204,180,384,False,1,8
15068,9,193,192,385,False,1,8
15069,10,210,220,430,False,1,8
15070,11,219,231,450,False,1,8
15071,12,229,246,475,False,1,8
15072,13,256,342,598,False,1,8
15073,14,258,413,671,False,1,8
15074,15,200,221,421,False,1,8
15075,16,178,161,339,False,1,8
15076,17,130,150,280,False,1,8
15077,18,122,138,260,False,1,8
15078,19,82,113,195,False,1,8
15079,20,60,80,140,False,1,8
15080,21,32,30,62,False,1,8
15081,22,18,25,43,False,1,8
15082,23,15,18,33,False,1,8
15083,0,8,27,35,False,2,8
15084,1,3,27,30,False,2,8
15085,2,7,19,26,False,2,8
15086,3,11,24,35,False,2,8
15087,4,128,62,190,False,2,8
15088,5,267,145,412,False,2,8
15089,6,368,190,558,False,2,8
15090,7,280,173,453,False,2,8
15091,8,240,166,406,False,2,8
15092,9,222,191,413,False,2,8
15093,10,239,205,444,False,2,8
15094,11,209,232,441,False,2,8
15095,12,205,280,485,False,2,8
15096,13,267,335,602,False,2,8
15097,14,239,298,537,False,2,8
15098,15,176,213,389,False,2,8
15099,16,190,170,360,False,2,8
15100,17,148,153,301,False,2,8
15101,18,115,130,245,False,2,8
15102,19,98,146,244,False,2,8
15103,20,60,104,164,False,2,8
15104,21,23,64,87,False,2,8
15105,22,15,32,47,False,2,8
15106,23,10,23,33,False,2,8
15107,0,3,19,22,False,3,8
15108,1,6,16,22,False,3,8
15109,2,3,13,16,False,3,8
15110,3,16,14,30,False,3,8
15111,4,123,59,182,False,3,8
15112,5,231,156,387,False,3,8
15113,6,401,199,600,False,3,8
15114,7,215,176,391,False,3,8
15115,8,217,177,394,False,3,8
15116,9,211,186,397,False,3,8
15117,10,222,243,465,False,3,8
15118,11,200,206,406,False,3,8
15119,12,241,277,518,False,3,8
15120,13,269,336,605,False,3,8
15121,14,249,300,549,False,3,8
15122,15,186,219,405,False,3,8
15123,16,175,187,362,False,3,8
15124,17,143,167,310,False,3,8
15125,18,121,140,261,False,3,8
15126,19,99,124,223,False,3,8
15127,20,62,91,153,False,3,8
15128,21,37,56,93,False,3,8
15129,22,18,27,45,False,3,8
15130,23,9,33,42,False,3,8
15131,0,3,25,28,False,4,8
15132,1,7,25,32,False,4,8
15133,2,7,13,20,False,4,8
15134,3,15,13,28,False,4,8
15135,4,114,52,166,False,4,8
15136,5,262,148,410,False,4,8
15137,6,380,185,565,False,4,8
15138,7,266,199,465,False,4,8
15139,8,253,196,449,False,4,8
15140,9,252,208,460,False,4,8
15141,10,242,229,471,False,4,8
15142,11,223,248,471,False,4,8
15143,12,214,309,523,False,4,8
15144,13,254,359,613,False,4,8
15145,14,188,274,462,False,4,8
15146,15,159,178,337,False,4,8
15147,16,181,168,349,False,4,8
15148,17,146,136,282,False,4,8
15149,18,133,114,247,False,4,8
15150,19,67,95,162,False,4,8
15151,20,55,107,162,False,4,8
15152,21,55,73,128,False,4,8
15153,22,34,58,92,False,4,8
15154,23,25,41,66,False,4,8
15155,0,16,38,54,False,5,8
15156,1,21,46,67,False,5,8
15157,2,9,25,34,False,5,8
15158,3,10,18,28,False,5,8
15159,4,27,15,42,False,5,8
15160,5,34,23,57,False,5,8
15161,6,37,36,73,False,5,8
15162,7,76,62,138,False,5,8
15163,8,119,78,197,False,5,8
15164,9,156,114,270,False,5,8
15165,10,195,155,350,False,5,8
15166,11,180,158,338,False,5,8
15167,12,189,239,428,False,5,8
15168,13,165,197,362,False,5,8
15169,14,134,224,358,False,5,8
15170,15,126,209,335,False,5,8
15171,16,154,143,297,False,5,8
15172,17,110,162,272,False,5,8
15173,18,151,123,274,False,5,8
15174,19,63,81,144,False,5,8
15175,20,44,62,106,False,5,8
15176,21,51,70,121,False,5,8
15177,22,45,58,103,False,5,8
15178,23,34,57,91,False,5,8
15179,0,30,61,91,True,6,8
15180,1,22,47,69,True,6,8
15181,2,21,37,58,True,6,8
15182,3,14,17,31,True,6,8
15183,4,10,7,17,True,6,8
15184,5,23,20,43,True,6,8
15185,6,47,24,71,True,6,8
15186,7,72,48,120,True,6,8
15187,8,117,60,177,True,6,8
15188,9,119,115,234,True,6,8
15189,10,193,145,338,True,6,8
15190,11,167,186,353,True,6,8
15191,12,212,227,439,True,6,8
15192,13,206,238,444,True,6,8
15193,14,148,252,400,True,6,8
15194,15,149,195,344,True,6,8
15195,16,155,160,315,True,6,8
15196,17,152,187,339,True,6,8
15197,18,123,151,274,True,6,8
15198,19,92,130,222,True,6,8
15199,20,34,74,108,True,6,8
15200,21,31,53,84,True,6,8
15201,22,24,19,43,True,6,8
15202,23,8,16,24,True,6,8
15203,0,9,11,20,False,0,8
15204,1,6,9,15,False,0,8
15205,2,5,13,18,False,0,8
15206,3,11,10,21,False,0,8
15207,4,134,68,202,False,0,8
15208,5,240,133,373,False,0,8
15209,6,388,209,597,False,0,8
15210,7,285,154,439,False,0,8
15211,8,235,191,426,False,0,8
15212,9,235,200,435,False,0,8
15213,10,224,227,451,False,0,8
15214,11,225,207,432,False,0,8
15215,12,217,315,532,False,0,8
15216,13,240,354,594,False,0,8
15217,14,247,315,562,False,0,8
15218,15,212,209,421,False,0,8
15219,16,162,166,328,False,0,8
15220,17,159,162,321,False,0,8
15221,18,110,130,240,False,0,8
15222,19,85,103,188,False,0,8
15223,20,93,165,258,False,0,8
15224,21,60,104,164,False,0,8
15225,22,35,53,88,False,0,8
15226,23,19,39,58,False,0,8
15227,0,11,21,32,False,1,8
15228,1,4,12,16,False,1,8
15229,2,8,6,14,False,1,8
15230,3,18,9,27,False,1,8
15231,4,124,58,182,False,1,8
15232,5,277,158,435,False,1,8
15233,6,426,184,610,False,1,8
15234,7,262,199,461,False,1,8
15235,8,249,217,466,False,1,8
15236,9,204,225,429,False,1,8
15237,10,234,218,452,False,1,8
15238,11,207,215,422,False,1,8
15239,12,193,270,463,False,1,8
15240,13,254,339,593,False,1,8
15241,14,229,315,544,False,1,8
15242,15,182,175,357,False,1,8
15243,16,209,165,374,False,1,8
15244,17,150,158,308,False,1,8
15245,18,133,152,285,False,1,8
15246,19,76,102,178,False,1,8
15247,20,60,91,151,False,1,8
15248,21,36,122,158,False,1,8
15249,22,27,30,57,False,1,8
15250,23,17,19,36,False,1,8
15251,0,18,20,38,False,2,8
15252,1,10,18,28,False,2,8
15253,2,6,15,21,False,2,8
15254,3,12,13,25,False,2,8
15255,4,137,56,193,False,2,8
15256,5,254,148,402,False,2,8
15257,6,409,198,607,False,2,8
15258,7,260,158,418,False,2,8
15259,8,226,198,424,False,2,8
15260,9,202,185,387,False,2,8
15261,10,204,207,411,False,2,8
15262,11,198,249,447,False,2,8
15263,12,247,285,532,False,2,8
15264,13,238,329,567,False,2,8
15265,14,232,296,528,False,2,8
15266,15,208,228,436,False,2,8
15267,16,170,164,334,False,2,8
15268,17,161,179,340,False,2,8
15269,18,140,171,311,False,2,8
15270,19,84,110,194,False,2,8
15271,20,58,121,179,False,2,8
15272,21,34,152,186,False,2,8
15273,22,21,38,59,False,2,8
15274,23,14,15,29,False,2,8
15275,0,12,24,36,False,3,8
15276,1,17,22,39,False,3,8
15277,2,13,7,20,False,3,8
15278,3,20,21,41,False,3,8
15279,4,144,61,205,False,3,8
15280,5,266,133,399,False,3,8
15281,6,450,203,653,False,3,8
15282,7,284,189,473,False,3,8
15283,8,226,160,386,False,3,8
15284,9,245,186,431,False,3,8
15285,10,217,226,443,False,3,8
15286,11,249,222,471,False,3,8
15287,12,205,268,473,False,3,8
15288,13,254,328,582,False,3,8
15289,14,201,305,506,False,3,8
15290,15,190,228,418,False,3,8
15291,16,174,179,353,False,3,8
15292,17,161,172,333,False,3,8
15293,18,118,157,275,False,3,8
15294,19,98,121,219,False,3,8
15295,20,55,90,145,False,3,8
15296,21,35,41,76,False,3,8
15297,22,26,32,58,False,3,8
15298,23,9,27,36,False,3,8
15299,0,9,25,34,False,4,8
15300,1,16,28,44,False,4,8
15301,2,7,23,30,False,4,8
15302,3,19,13,32,False,4,8
15303,4,135,48,183,False,4,8
15304,5,259,143,402,False,4,8
15305,6,340,175,515,False,4,8
15306,7,233,170,403,False,4,8
15307,8,208,152,360,False,4,8
15308,9,225,174,399,False,4,8
15309,10,247,211,458,False,4,8
15310,11,197,224,421,False,4,8
15311,12,221,268,489,False,4,8
15312,13,219,273,492,False,4,8
15313,14,190,212,402,False,4,8
15314,15,138,151,289,False,4,8
15315,16,148,120,268,False,4,8
15316,17,142,109,251,False,4,8
15317,18,87,124,211,False,4,8
15318,19,76,90,166,False,4,8
15319,20,81,85,166,False,4,8
15320,21,45,54,99,False,4,8
15321,22,41,59,100,False,4,8
15322,23,24,57,81,False,4,8
15323,0,21,44,65,False,5,8
15324,1,16,39,55,False,5,8
15325,2,12,29,41,False,5,8
15326,3,15,16,31,False,5,8
15327,4,24,17,41,False,5,8
15328,5,36,22,58,False,5,8
15329,6,48,33,81,False,5,8
15330,7,138,43,181,False,5,8
15331,8,188,55,243,False,5,8
15332,9,231,74,305,False,5,8
15333,10,257,99,356,False,5,8
15334,11,233,101,334,False,5,8
15335,12,217,85,302,False,5,8
15336,13,143,86,229,False,5,8
15337,14,134,73,207,False,5,8
15338,15,120,80,200,False,5,8
15339,16,119,120,239,False,5,8
15340,17,116,82,198,False,5,8
15341,18,105,74,179,False,5,8
15342,19,63,53,116,False,5,8
15343,20,50,46,96,False,5,8
15344,21,49,54,103,False,5,8
15345,22,53,56,109,False,5,8
15346,23,31,48,79,False,5,8
15347,0,28,47,75,True,6,8
15348,1,25,42,67,True,6,8
15349,2,22,38,60,True,6,8
15350,3,12,31,43,True,6,8
15351,4,22,17,39,True,6,8
15352,5,23,15,38,True,6,8
15353,6,47,26,73,True,6,8
15354,7,63,47,110,True,6,8
15355,8,97,37,134,True,6,8
15356,9,113,48,161,True,6,8
15357,10,124,72,196,True,6,8
15358,11,138,89,227,True,6,8
15359,12,161,93,254,True,6,8
15360,13,162,117,279,True,6,8
15361,14,147,93,240,True,6,8
15362,15,146,100,246,True,6,8
15363,16,131,113,244,True,6,8
15364,17,177,111,288,True,6,8
15365,18,135,108,243,True,6,8
15366,19,104,104,208,True,6,8
15367,20,74,74,148,True,6,8
15368,21,33,37,70,True,6,8
15369,22,15,17,32,True,6,8
15370,23,11,18,29,True,6,8
15371,0,8,11,19,False,0,8
15372,1,14,14,28,False,0,8
15373,2,12,16,28,False,0,8
15374,3,29,23,52,False,0,8
15375,4,120,50,170,False,0,8
15376,5,217,115,332,False,0,8
15377,6,280,129,409,False,0,8
15378,7,317,115,432,False,0,8
15379,8,322,106,428,False,0,8
15380,9,325,143,468,False,0,8
15381,10,326,134,460,False,0,8
15382,11,272,170,442,False,0,8
15383,12,271,160,431,False,0,8
15384,13,275,230,505,False,0,8
15385,14,302,184,486,False,0,8
15386,15,270,150,420,False,0,8
15387,16,220,152,372,False,0,8
15388,17,153,124,277,False,0,8
15389,18,115,95,210,False,0,8
15390,19,104,97,201,False,0,8
15391,20,70,58,128,False,0,8
15392,21,29,32,61,False,0,8
15393,22,17,17,34,False,0,8
15394,23,10,12,22,False,0,8
15395,0,11,17,28,False,1,8
15396,1,8,10,18,False,1,8
15397,2,17,13,30,False,1,8
15398,3,25,15,40,False,1,8
15399,4,113,48,161,False,1,8
15400,5,268,130,398,False,1,8
15401,6,367,148,515,False,1,8
15402,7,355,110,465,False,1,8
15403,8,352,125,477,False,1,8
15404,9,358,124,482,False,1,8
15405,10,383,166,549,False,1,8
15406,11,319,176,495,False,1,8
15407,12,349,226,575,False,1,8
15408,13,275,257,532,False,1,8
15409,14,328,225,553,False,1,8
15410,15,356,179,535,False,1,8
15411,16,368,151,519,False,1,8
15412,17,199,171,370,False,1,8
15413,18,160,107,267,False,1,8
15414,19,103,95,198,False,1,8
15415,20,86,93,179,False,1,8
15416,21,39,56,95,False,1,8
15417,22,29,20,49,False,1,8
15418,23,9,17,26,False,1,8
15419,0,8,20,28,False,2,8
15420,1,14,15,29,False,2,8
15421,2,9,17,26,False,2,8
15422,3,14,19,33,False,2,8
15423,4,129,55,184,False,2,8
15424,5,281,110,391,False,2,8
15425,6,400,150,550,False,2,8
15426,7,461,125,586,False,2,8
15427,8,427,137,564,False,2,8
15428,9,458,141,599,False,2,8
15429,10,410,168,578,False,2,8
15430,11,403,159,562,False,2,8
15431,12,328,242,570,False,2,8
15432,13,321,255,576,False,2,8
15433,14,315,200,515,False,2,8
15434,15,282,181,463,False,2,8
15435,16,317,179,496,False,2,8
15436,17,296,194,490,False,2,8
15437,18,117,96,213,False,2,8
15438,19,110,104,214,False,2,8
15439,20,64,62,126,False,2,8
15440,21,39,26,65,False,2,8
15441,22,27,25,52,False,2,8
15442,23,20,27,47,False,2,8
15443,0,13,25,38,False,3,8
15444,1,10,27,37,False,3,8
15445,2,14,19,33,False,3,8
15446,3,15,14,29,False,3,8
15447,4,116,53,169,False,3,8
15448,5,260,112,372,False,3,8
15449,6,418,148,566,False,3,8
15450,7,471,112,583,False,3,8
15451,8,467,153,620,False,3,8
15452,9,525,185,710,False,3,8
15453,10,467,195,662,False,3,8
15454,11,443,192,635,False,3,8
15455,12,334,256,590,False,3,8
15456,13,279,155,434,False,3,8
15457,14,332,263,595,False,3,8
15458,15,426,225,651,False,3,8
15459,16,479,210,689,False,3,8
15460,17,388,178,566,False,3,8
15461,18,198,210,408,False,3,8
15462,19,139,135,274,False,3,8
15463,20,94,82,176,False,3,8
15464,21,52,67,119,False,3,8
15465,22,30,38,68,False,3,8
15466,23,15,30,45,False,3,8
15467,0,10,34,44,False,4,8
15468,1,19,27,46,False,4,8
15469,2,13,18,31,False,4,8
15470,3,19,23,42,False,4,8
15471,4,126,39,165,False,4,8
15472,5,240,108,348,False,4,8
15473,6,398,165,563,False,4,8
15474,7,445,142,587,False,4,8
15475,8,464,163,627,False,4,8
15476,9,439,194,633,False,4,8
15477,10,466,187,653,False,4,8
15478,11,388,221,609,False,4,8
15479,12,395,277,672,False,4,8
15480,13,344,253,597,False,4,8
15481,14,337,236,573,False,4,8
15482,15,355,157,512,False,4,8
15483,16,331,214,545,False,4,8
15484,17,378,163,541,False,4,8
15485,18,169,117,286,False,4,8
15486,19,103,67,170,False,4,8
15487,20,84,39,123,False,4,8
15488,21,63,48,111,False,4,8
15489,22,59,40,99,False,4,8
15490,23,50,26,76,False,4,8
15491,0,41,24,65,False,5,8
15492,1,25,16,41,False,5,8
15493,2,19,31,50,False,5,8
15494,3,20,24,44,False,5,8
15495,4,42,26,68,False,5,8
15496,5,41,34,75,False,5,8
15497,6,87,46,133,False,5,8
15498,7,172,59,231,False,5,8
15499,8,304,77,381,False,5,8
15500,9,345,101,446,False,5,8
15501,10,423,109,532,False,5,8
15502,11,423,141,564,False,5,8
15503,12,373,158,531,False,5,8
15504,13,351,170,521,False,5,8
15505,14,321,153,474,False,5,8
15506,15,317,134,451,False,5,8
15507,16,387,235,622,False,5,8
15508,17,268,152,420,False,5,8
15509,18,120,120,240,False,5,8
15510,19,78,75,153,False,5,8
15511,20,75,72,147,False,5,8
15512,21,64,71,135,False,5,8
15513,22,60,54,114,False,5,8
15514,23,41,39,80,False,5,8
15515,0,44,48,92,True,6,8
15516,1,36,39,75,True,6,8
15517,2,32,29,61,True,6,8
15518,3,13,36,49,True,6,8
15519,4,25,17,42,True,6,8
15520,5,37,28,65,True,6,8
15521,6,92,36,128,True,6,8
15522,7,181,60,241,True,6,8
15523,8,263,51,314,True,6,8
15524,9,373,71,444,True,6,8
15525,10,499,114,613,True,6,8
15526,11,486,117,603,True,6,8
15527,12,475,131,606,True,6,8
15528,13,353,153,506,True,6,8
15529,14,250,149,399,True,6,8
15530,15,279,371,650,True,6,8
15531,16,343,266,609,True,6,8
15532,17,290,170,460,True,6,8
15533,18,158,91,249,True,6,8
15534,19,123,92,215,True,6,8
15535,20,81,72,153,True,6,8
15536,21,32,35,67,True,6,8
15537,22,23,30,53,True,6,8
15538,23,14,14,28,True,6,8
15539,0,11,15,26,False,0,8
15540,1,7,18,25,False,0,8
15541,2,11,16,27,False,0,8
15542,3,31,16,47,False,0,8
15543,4,118,65,183,False,0,8
15544,5,289,168,457,False,0,8
15545,6,426,230,656,False,0,8
15546,7,287,195,482,False,0,8
15547,8,293,236,529,False,0,8
15548,9,268,231,499,False,0,8
15549,10,248,284,532,False,0,8
15550,11,217,287,504,False,0,8
15551,12,237,380,617,False,0,8
15552,13,294,506,800,False,0,8
15553,14,257,425,682,False,0,8
15554,15,213,209,422,False,0,8
15555,16,185,194,379,False,0,8
15556,17,146,176,322,False,0,8
15557,18,133,163,296,False,0,8
15558,19,99,121,220,False,0,8
15559,20,39,125,164,False,0,8
15560,21,20,47,67,False,0,8
15561,22,15,20,35,False,0,8
15562,23,6,12,18,False,0,8
15563,0,4,11,15,False,1,8
15564,1,5,10,15,False,1,8
15565,2,6,4,10,False,1,8
15566,3,11,16,27,False,1,8
15567,4,124,53,177,False,1,8
15568,5,264,166,430,False,1,8
15569,6,381,187,568,False,1,8
15570,7,263,169,432,False,1,8
15571,8,239,173,412,False,1,8
15572,9,219,177,396,False,1,8
15573,10,215,188,403,False,1,8
15574,11,236,231,467,False,1,8
15575,12,216,295,511,False,1,8
15576,13,252,326,578,False,1,8
15577,14,201,284,485,False,1,8
15578,15,179,198,377,False,1,8
15579,16,200,161,361,False,1,8
15580,17,163,187,350,False,1,8
15581,18,134,159,293,False,1,8
15582,19,95,132,227,False,1,8
15583,20,59,100,159,False,1,8
15584,21,34,53,87,False,1,8
15585,22,25,25,50,False,1,8
15586,23,15,23,38,False,1,8
15587,0,7,16,23,False,2,8
15588,1,11,19,30,False,2,8
15589,2,2,11,13,False,2,8
15590,3,10,7,17,False,2,8
15591,4,111,51,162,False,2,8
15592,5,240,165,405,False,2,8
15593,6,391,170,561,False,2,8
15594,7,258,172,430,False,2,8
15595,8,220,179,399,False,2,8
15596,9,204,179,383,False,2,8
15597,10,214,188,402,False,2,8
15598,11,232,239,471,False,2,8
15599,12,227,283,510,False,2,8
15600,13,267,326,593,False,2,8
15601,14,242,277,519,False,2,8
15602,15,202,217,419,False,2,8
15603,16,182,187,369,False,2,8
15604,17,152,169,321,False,2,8
15605,18,121,156,277,False,2,8
15606,19,99,122,221,False,2,8
15607,20,50,93,143,False,2,8
15608,21,20,51,71,False,2,8
15609,22,25,27,52,False,2,8
15610,23,13,27,40,False,2,8
15611,0,6,24,30,False,3,8
15612,1,6,16,22,False,3,8
15613,2,9,12,21,False,3,8
15614,3,9,18,27,False,3,8
15615,4,116,42,158,False,3,8
15616,5,219,149,368,False,3,8
15617,6,405,183,588,False,3,8
15618,7,239,190,429,False,3,8
15619,8,209,197,406,False,3,8
15620,9,205,176,381,False,3,8
15621,10,222,185,407,False,3,8
15622,11,208,220,428,False,3,8
15623,12,233,250,483,False,3,8
15624,13,264,354,618,False,3,8
15625,14,214,317,531,False,3,8
15626,15,192,198,390,False,3,8
15627,16,183,182,365,False,3,8
15628,17,148,171,319,False,3,8
15629,18,126,142,268,False,3,8
15630,19,90,111,201,False,3,8
15631,20,59,105,164,False,3,8
15632,21,36,59,95,False,3,8
15633,22,22,42,64,False,3,8
15634,23,17,40,57,False,3,8
15635,0,8,75,83,False,4,8
15636,1,10,52,62,False,4,8
15637,2,6,39,45,False,4,8
15638,3,17,12,29,False,4,8
15639,4,115,56,171,False,4,8
15640,5,237,141,378,False,4,8
15641,6,370,191,561,False,4,8
15642,7,222,165,387,False,4,8
15643,8,228,188,416,False,4,8
15644,9,222,212,434,False,4,8
15645,10,242,222,464,False,4,8
15646,11,231,235,466,False,4,8
15647,12,251,313,564,False,4,8
15648,13,253,315,568,False,4,8
15649,14,209,283,492,False,4,8
15650,15,184,223,407,False,4,8
15651,16,160,192,352,False,4,8
15652,17,122,134,256,False,4,8
15653,18,95,150,245,False,4,8
15654,19,96,104,200,False,4,8
15655,20,56,96,152,False,4,8
15656,21,50,74,124,False,4,8
15657,22,46,69,115,False,4,8
15658,23,22,54,76,False,4,8
15659,0,18,55,73,False,5,8
15660,1,24,39,63,False,5,8
15661,2,12,26,38,False,5,8
15662,3,9,11,20,False,5,8
15663,4,20,15,35,False,5,8
15664,5,22,25,47,False,5,8
15665,6,41,29,70,False,5,8
15666,7,63,46,109,False,5,8
15667,8,118,90,208,False,5,8
15668,9,149,109,258,False,5,8
15669,10,176,134,310,False,5,8
15670,11,173,180,353,False,5,8
15671,12,178,196,374,False,5,8
15672,13,170,236,406,False,5,8
15673,14,154,192,346,False,5,8
15674,15,135,191,326,False,5,8
15675,16,153,162,315,False,5,8
15676,17,132,128,260,False,5,8
15677,18,89,97,186,False,5,8
15678,19,59,77,136,False,5,8
15679,20,56,78,134,False,5,8
15680,21,39,80,119,False,5,8
15681,22,44,60,104,False,5,8
15682,23,26,64,90,False,5,8
15683,0,18,49,67,True,6,9
15684,1,23,52,75,True,6,9
15685,2,14,29,43,True,6,9
15686,3,15,16,31,True,6,9
15687,4,21,11,32,True,6,9
15688,5,17,13,30,True,6,9
15689,6,54,24,78,True,6,9
15690,7,99,48,147,True,6,9
15691,8,131,64,195,True,6,9
15692,9,129,107,236,True,6,9
15693,10,188,198,386,True,6,9
15694,11,180,202,382,True,6,9
15695,12,213,226,439,True,6,9
15696,13,191,260,451,True,6,9
15697,14,169,217,386,True,6,9
15698,15,164,215,379,True,6,9
15699,16,162,167,329,True,6,9
15700,17,144,172,316,True,6,9
15701,18,112,162,274,True,6,9
15702,19,91,118,209,True,6,9
15703,20,67,62,129,True,6,9
15704,21,26,57,83,True,6,9
15705,22,20,26,46,True,6,9
15706,23,11,17,28,True,6,9
15707,0,9,13,22,False,0,9
15708,1,6,9,15,False,0,9
15709,2,6,6,12,False,0,9
15710,3,19,11,30,False,0,9
15711,4,135,47,182,False,0,9
15712,5,242,161,403,False,0,9
15713,6,414,203,617,False,0,9
15714,7,241,176,417,False,0,9
15715,8,254,191,445,False,0,9
15716,9,208,191,399,False,0,9
15717,10,229,185,414,False,0,9
15718,11,211,218,429,False,0,9
15719,12,215,296,511,False,0,9
15720,13,252,331,583,False,0,9
15721,14,228,324,552,False,0,9
15722,15,218,177,395,False,0,9
15723,16,167,168,335,False,0,9
15724,17,139,140,279,False,0,9
15725,18,108,125,233,False,0,9
15726,19,76,112,188,False,0,9
15727,20,48,80,128,False,0,9
15728,21,29,39,68,False,0,9
15729,22,17,17,34,False,0,9
15730,23,13,8,21,False,0,9
15731,0,10,12,22,False,1,9
15732,1,3,7,10,False,1,9
15733,2,8,8,16,False,1,9
15734,3,14,14,28,False,1,9
15735,4,128,55,183,False,1,9
15736,5,235,126,361,False,1,9
15737,6,428,224,652,False,1,9
15738,7,277,197,474,False,1,9
15739,8,224,163,387,False,1,9
15740,9,214,197,411,False,1,9
15741,10,217,186,403,False,1,9
15742,11,226,223,449,False,1,9
15743,12,234,275,509,False,1,9
15744,13,247,347,594,False,1,9
15745,14,231,302,533,False,1,9
15746,15,195,219,414,False,1,9
15747,16,165,183,348,False,1,9
15748,17,155,132,287,False,1,9
15749,18,123,157,280,False,1,9
15750,19,77,118,195,False,1,9
15751,20,52,109,161,False,1,9
15752,21,40,52,92,False,1,9
15753,22,18,24,42,False,1,9
15754,23,7,22,29,False,1,9
15755,0,7,12,19,False,2,9
15756,1,11,18,29,False,2,9
15757,2,10,7,17,False,2,9
15758,3,18,15,33,False,2,9
15759,4,126,53,179,False,2,9
15760,5,231,147,378,False,2,9
15761,6,455,194,649,False,2,9
15762,7,252,149,401,False,2,9
15763,8,239,178,417,False,2,9
15764,9,229,178,407,False,2,9
15765,10,224,208,432,False,2,9
15766,11,215,206,421,False,2,9
15767,12,218,274,492,False,2,9
15768,13,248,373,621,False,2,9
15769,14,271,369,640,False,2,9
15770,15,235,227,462,False,2,9
15771,16,165,193,358,False,2,9
15772,17,139,153,292,False,2,9
15773,18,112,119,231,False,2,9
15774,19,89,127,216,False,2,9
15775,20,59,97,156,False,2,9
15776,21,36,47,83,False,2,9
15777,22,18,28,46,False,2,9
15778,23,7,15,22,False,2,9
15779,0,10,20,30,False,3,9
15780,1,4,17,21,False,3,9
15781,2,6,20,26,False,3,9
15782,3,15,14,29,False,3,9
15783,4,114,60,174,False,3,9
15784,5,252,126,378,False,3,9
15785,6,401,200,601,False,3,9
15786,7,236,169,405,False,3,9
15787,8,213,165,378,False,3,9
15788,9,203,187,390,False,3,9
15789,10,217,203,420,False,3,9
15790,11,228,218,446,False,3,9
15791,12,223,269,492,False,3,9
15792,13,272,358,630,False,3,9
15793,14,244,351,595,False,3,9
15794,15,209,196,405,False,3,9
15795,16,187,148,335,False,3,9
15796,17,172,172,344,False,3,9
15797,18,94,132,226,False,3,9
15798,19,85,138,223,False,3,9
15799,20,58,105,163,False,3,9
15800,21,42,63,105,False,3,9
15801,22,21,25,46,False,3,9
15802,23,10,15,25,False,3,9
15803,0,18,26,44,False,4,9
15804,1,5,26,31,False,4,9
15805,2,10,16,26,False,4,9
15806,3,18,17,35,False,4,9
15807,4,116,50,166,False,4,9
15808,5,254,141,395,False,4,9
15809,6,391,196,587,False,4,9
15810,7,266,204,470,False,4,9
15811,8,213,174,387,False,4,9
15812,9,226,202,428,False,4,9
15813,10,238,249,487,False,4,9
15814,11,249,268,517,False,4,9
15815,12,224,289,513,False,4,9
15816,13,250,340,590,False,4,9
15817,14,223,303,526,False,4,9
15818,15,179,193,372,False,4,9
15819,16,143,147,290,False,4,9
15820,17,111,134,245,False,4,9
15821,18,65,102,167,False,4,9
15822,19,63,100,163,False,4,9
15823,20,44,71,115,False,4,9
15824,21,29,62,91,False,4,9
15825,22,36,60,96,False,4,9
15826,23,27,41,68,False,4,9
15827,0,23,41,64,False,5,9
15828,1,26,41,67,False,5,9
15829,2,10,26,36,False,5,9
15830,3,6,15,21,False,5,9
15831,4,20,17,37,False,5,9
15832,5,26,28,54,False,5,9
15833,6,27,29,56,False,5,9
15834,7,55,45,100,False,5,9
15835,8,99,71,170,False,5,9
15836,9,104,89,193,False,5,9
15837,10,146,128,274,False,5,9
15838,11,154,147,301,False,5,9
15839,12,157,134,291,False,5,9
15840,13,140,169,309,False,5,9
15841,14,132,189,321,False,5,9
15842,15,136,139,275,False,5,9
15843,16,123,141,264,False,5,9
15844,17,89,113,202,False,5,9
15845,18,67,83,150,False,5,9
15846,19,53,84,137,False,5,9
15847,20,54,76,130,False,5,9
15848,21,50,60,110,False,5,9
15849,22,35,66,101,False,5,9
15850,23,32,54,86,False,5,9
15851,0,29,59,88,True,6,9
15852,1,32,64,96,True,6,9
15853,2,17,46,63,True,6,9
15854,3,10,16,26,True,6,9
15855,4,11,17,28,True,6,9
15856,5,13,15,28,True,6,9
15857,6,26,13,39,True,6,9
15858,7,43,31,74,True,6,9
15859,8,81,50,131,True,6,9
15860,9,115,83,198,True,6,9
15861,10,144,129,273,True,6,9
15862,11,124,153,277,True,6,9
15863,12,140,181,321,True,6,9
15864,13,160,190,350,True,6,9
15865,14,117,167,284,True,6,9
15866,15,143,185,328,True,6,9
15867,16,149,143,292,True,6,9
15868,17,138,153,291,True,6,9
15869,18,104,126,230,True,6,9
15870,19,88,96,184,True,6,9
15871,20,51,81,132,True,6,9
15872,21,33,50,83,True,6,9
15873,22,18,27,45,True,6,9
15874,23,8,18,26,True,6,9
15875,0,3,10,13,True,0,9
15876,1,6,15,21,True,0,9
15877,2,7,10,17,True,0,9
15878,3,16,19,35,True,0,9
15879,4,95,47,142,True,0,9
15880,5,214,120,334,True,0,9
15881,6,312,160,472,True,0,9
15882,7,234,175,409,True,0,9
15883,8,203,140,343,True,0,9
15884,9,221,171,392,True,0,9
15885,10,218,194,412,True,0,9
15886,11,205,222,427,True,0,9
15887,12,224,230,454,True,0,9
15888,13,242,300,542,True,0,9
15889,14,192,252,444,True,0,9
15890,15,162,172,334,True,0,9
15891,16,143,168,311,True,0,9
15892,17,110,127,237,True,0,9
15893,18,91,106,197,True,0,9
15894,19,65,97,162,True,0,9
15895,20,48,74,122,True,0,9
15896,21,27,40,67,True,0,9
15897,22,16,16,32,True,0,9
15898,23,10,13,23,True,0,9
15899,0,6,11,17,True,1,9
15900,1,6,7,13,True,1,9
15901,2,6,6,12,True,1,9
15902,3,25,17,42,True,1,9
15903,4,123,52,175,True,1,9
15904,5,219,146,365,True,1,9
15905,6,341,182,523,True,1,9
15906,7,219,160,379,True,1,9
15907,8,213,162,375,True,1,9
15908,9,204,168,372,True,1,9
15909,10,209,179,388,True,1,9
15910,11,206,212,418,True,1,9
15911,12,236,273,509,True,1,9
15912,13,213,301,514,True,1,9
15913,14,216,274,490,True,1,9
15914,15,180,190,370,True,1,9
15915,16,180,166,346,True,1,9
15916,17,121,152,273,True,1,9
15917,18,98,169,267,True,1,9
15918,19,78,109,187,True,1,9
15919,20,72,89,161,True,1,9
15920,21,30,48,78,True,1,9
15921,22,19,21,40,True,1,9
15922,23,5,14,19,True,1,9
15923,0,9,17,26,True,2,9
15924,1,10,19,29,True,2,9
15925,2,10,10,20,True,2,9
15926,3,18,14,32,True,2,9
15927,4,113,51,164,True,2,9
15928,5,229,132,361,True,2,9
15929,6,306,162,468,True,2,9
15930,7,242,164,406,True,2,9
15931,8,230,147,377,True,2,9
15932,9,223,176,399,True,2,9
15933,10,244,191,435,True,2,9
15934,11,194,232,426,True,2,9
15935,12,204,294,498,True,2,9
15936,13,227,323,550,True,2,9
15937,14,201,319,520,True,2,9
15938,15,170,200,370,True,2,9
15939,16,149,162,311,True,2,9
15940,17,112,130,242,True,2,9
15941,18,91,99,190,True,2,9
15942,19,101,99,200,True,2,9
15943,20,61,96,157,True,2,9
15944,21,50,46,96,True,2,9
15945,22,16,27,43,True,2,9
15946,23,13,17,30,True,2,9
15947,0,6,14,20,True,3,9
15948,1,6,13,19,True,3,9
15949,2,6,16,22,True,3,9
15950,3,18,11,29,True,3,9
15951,4,130,44,174,True,3,9
15952,5,217,131,348,True,3,9
15953,6,277,158,435,True,3,9
15954,7,235,148,383,True,3,9
15955,8,241,149,390,True,3,9
15956,9,228,178,406,True,3,9
15957,10,241,204,445,True,3,9
15958,11,192,246,438,True,3,9
15959,12,195,300,495,True,3,9
15960,13,208,308,516,True,3,9
15961,14,206,252,458,True,3,9
15962,15,181,188,369,True,3,9
15963,16,132,157,289,True,3,9
15964,17,111,118,229,True,3,9
15965,18,94,129,223,True,3,9
15966,19,84,97,181,True,3,9
15967,20,43,76,119,True,3,9
15968,21,35,61,96,True,3,9
15969,22,16,22,38,True,3,9
15970,23,15,19,34,True,3,9
15971,0,4,26,30,True,4,9
15972,1,13,29,42,True,4,9
15973,2,12,20,32,True,4,9
15974,3,13,12,25,True,4,9
15975,4,114,43,157,True,4,9
15976,5,209,113,322,True,4,9
15977,6,255,151,406,True,4,9
15978,7,225,147,372,True,4,9
15979,8,219,165,384,True,4,9
15980,9,231,141,372,True,4,9
15981,10,239,179,418,True,4,9
15982,11,233,240,473,True,4,9
15983,12,233,275,508,True,4,9
15984,13,230,321,551,True,4,9
15985,14,183,261,444,True,4,9
15986,15,167,168,335,True,4,9
15987,16,135,132,267,True,4,9
15988,17,111,122,233,True,4,9
15989,18,103,107,210,True,4,9
15990,19,69,104,173,True,4,9
15991,20,48,87,135,True,4,9
15992,21,47,59,106,True,4,9
15993,22,45,51,96,True,4,9
15994,23,22,48,70,True,4,9
15995,0,30,46,76,True,5,9
15996,1,15,30,45,True,5,9
15997,2,13,34,47,True,5,9
15998,3,9,11,20,True,5,9
15999,4,24,17,41,True,5,9
16000,5,26,12,38,True,5,9
16001,6,32,34,66,True,5,9
16002,7,63,56,119,True,5,9
16003,8,109,68,177,True,5,9
16004,9,128,103,231,True,5,9
16005,10,180,141,321,True,5,9
16006,11,147,175,322,True,5,9
16007,12,141,141,282,True,5,9
16008,13,104,149,253,True,5,9
16009,14,126,156,282,True,5,9
16010,15,124,160,284,True,5,9
16011,16,121,134,255,True,5,9
16012,17,100,102,202,True,5,9
16013,18,75,113,188,True,5,9
16014,19,54,82,136,True,5,9
16015,20,48,62,110,True,5,9
16016,21,39,68,107,True,5,9
16017,22,29,55,84,True,5,9
16018,23,23,51,74,True,5,9
16019,0,22,57,79,True,6,9
16020,1,28,60,88,True,6,9
16021,2,22,48,70,True,6,9
16022,3,12,20,32,True,6,9
16023,4,16,18,34,True,6,9
16024,5,16,16,32,True,6,9
16025,6,20,16,36,True,6,9
16026,7,51,32,83,True,6,9
16027,8,92,58,150,True,6,9
16028,9,111,85,196,True,6,9
16029,10,144,114,258,True,6,9
16030,11,161,177,338,True,6,9
16031,12,182,182,364,True,6,9
16032,13,153,225,378,True,6,9
16033,14,156,216,372,True,6,9
16034,15,144,151,295,True,6,9
16035,16,151,120,271,True,6,9
16036,17,147,142,289,True,6,9
16037,18,112,126,238,True,6,9
16038,19,71,104,175,True,6,9
16039,20,69,82,151,True,6,9
16040,21,27,32,59,True,6,9
16041,22,22,26,48,True,6,9
16042,23,9,16,25,True,6,9
16043,0,6,14,20,False,0,9
16044,1,5,6,11,False,0,9
16045,2,4,7,11,False,0,9
16046,3,18,11,29,False,0,9
16047,4,144,54,198,False,0,9
16048,5,248,128,376,False,0,9
16049,6,401,214,615,False,0,9
16050,7,270,181,451,False,0,9
16051,8,228,175,403,False,0,9
16052,9,223,186,409,False,0,9
16053,10,246,217,463,False,0,9
16054,11,194,235,429,False,0,9
16055,12,201,233,434,False,0,9
16056,13,245,335,580,False,0,9
16057,14,240,260,500,False,0,9
16058,15,192,201,393,False,0,9
16059,16,176,188,364,False,0,9
16060,17,139,142,281,False,0,9
16061,18,108,133,241,False,0,9
16062,19,80,128,208,False,0,9
16063,20,49,71,120,False,0,9
16064,21,32,43,75,False,0,9
16065,22,14,23,37,False,0,9
16066,23,17,13,30,False,0,9
16067,0,1,10,11,False,1,9
16068,1,6,7,13,False,1,9
16069,2,10,7,17,False,1,9
16070,3,21,14,35,False,1,9
16071,4,133,49,182,False,1,9
16072,5,271,157,428,False,1,9
16073,6,436,202,638,False,1,9
16074,7,273,167,440,False,1,9
16075,8,230,185,415,False,1,9
16076,9,251,180,431,False,1,9
16077,10,206,236,442,False,1,9
16078,11,230,204,434,False,1,9
16079,12,248,275,523,False,1,9
16080,13,264,391,655,False,1,9
16081,14,241,300,541,False,1,9
16082,15,231,198,429,False,1,9
16083,16,196,156,352,False,1,9
16084,17,131,149,280,False,1,9
16085,18,132,161,293,False,1,9
16086,19,75,122,197,False,1,9
16087,20,57,89,146,False,1,9
16088,21,36,46,82,False,1,9
16089,22,9,14,23,False,1,9
16090,23,14,18,32,False,1,9
16091,0,6,15,21,False,2,9
16092,1,9,21,30,False,2,9
16093,2,9,8,17,False,2,9
16094,3,21,20,41,False,2,9
16095,4,122,50,172,False,2,9
16096,5,262,148,410,False,2,9
16097,6,421,218,639,False,2,9
16098,7,244,158,402,False,2,9
16099,8,208,174,382,False,2,9
16100,9,207,211,418,False,2,9
16101,10,217,193,410,False,2,9
16102,11,224,222,446,False,2,9
16103,12,227,286,513,False,2,9
16104,13,241,321,562,False,2,9
16105,14,238,276,514,False,2,9
16106,15,217,180,397,False,2,9
16107,16,174,190,364,False,2,9
16108,17,123,146,269,False,2,9
16109,18,120,144,264,False,2,9
16110,19,90,117,207,False,2,9
16111,20,59,77,136,False,2,9
16112,21,36,46,82,False,2,9
16113,22,22,33,55,False,2,9
16114,23,13,14,27,False,2,9
16115,0,8,12,20,False,3,9
16116,1,4,8,12,False,3,9
16117,2,6,17,23,False,3,9
16118,3,21,10,31,False,3,9
16119,4,109,50,159,False,3,9
16120,5,232,140,372,False,3,9
16121,6,396,208,604,False,3,9
16122,7,251,175,426,False,3,9
16123,8,196,190,386,False,3,9
16124,9,224,189,413,False,3,9
16125,10,217,227,444,False,3,9
16126,11,215,268,483,False,3,9
16127,12,226,250,476,False,3,9
16128,13,276,341,617,False,3,9
16129,14,249,293,542,False,3,9
16130,15,243,192,435,False,3,9
16131,16,176,191,367,False,3,9
16132,17,153,162,315,False,3,9
16133,18,101,163,264,False,3,9
16134,19,83,125,208,False,3,9
16135,20,62,83,145,False,3,9
16136,21,38,54,92,False,3,9
16137,22,17,38,55,False,3,9
16138,23,19,43,62,False,3,9
16139,0,13,47,60,False,4,9
16140,1,12,35,47,False,4,9
16141,2,10,22,32,False,4,9
16142,3,15,25,40,False,4,9
16143,4,111,50,161,False,4,9
16144,5,224,130,354,False,4,9
16145,6,355,199,554,False,4,9
16146,7,245,166,411,False,4,9
16147,8,218,178,396,False,4,9
16148,9,218,196,414,False,4,9
16149,10,237,212,449,False,4,9
16150,11,244,234,478,False,4,9
16151,12,263,287,550,False,4,9
16152,13,265,371,636,False,4,9
16153,14,210,259,469,False,4,9
16154,15,154,154,308,False,4,9
16155,16,155,166,321,False,4,9
16156,17,125,160,285,False,4,9
16157,18,87,90,177,False,4,9
16158,19,69,86,155,False,4,9
16159,20,55,72,127,False,4,9
16160,21,43,81,124,False,4,9
16161,22,46,62,108,False,4,9
16162,23,18,43,61,False,4,9
16163,0,29,41,70,False,5,9
16164,1,17,47,64,False,5,9
16165,2,13,32,45,False,5,9
16166,3,12,14,26,False,5,9
16167,4,21,17,38,False,5,9
16168,5,29,30,59,False,5,9
16169,6,57,39,96,False,5,9
16170,7,61,50,111,False,5,9
16171,8,121,81,202,False,5,9
16172,9,129,122,251,False,5,9
16173,10,183,141,324,False,5,9
16174,11,167,140,307,False,5,9
16175,12,156,178,334,False,5,9
16176,13,143,186,329,False,5,9
16177,14,130,176,306,False,5,9
16178,15,128,159,287,False,5,9
16179,16,128,144,272,False,5,9
16180,17,110,110,220,False,5,9
16181,18,80,84,164,False,5,9
16182,19,59,76,135,False,5,9
16183,20,42,72,114,False,5,9
16184,21,36,55,91,False,5,9
16185,22,36,55,91,False,5,9
16186,23,31,66,97,False,5,9
16187,0,30,47,77,True,6,9
16188,1,21,57,78,True,6,9
16189,2,13,29,42,True,6,9
16190,3,17,26,43,True,6,9
16191,4,10,10,20,True,6,9
16192,5,23,22,45,True,6,9
16193,6,30,15,45,True,6,9
16194,7,52,36,88,True,6,9
16195,8,105,58,163,True,6,9
16196,9,118,107,225,True,6,9
16197,10,162,153,315,True,6,9
16198,11,167,191,358,True,6,9
16199,12,198,211,409,True,6,9
16200,13,205,215,420,True,6,9
16201,14,169,251,420,True,6,9
16202,15,162,197,359,True,6,9
16203,16,148,168,316,True,6,9
16204,17,128,165,293,True,6,9
16205,18,108,151,259,True,6,9
16206,19,68,110,178,True,6,9
16207,20,131,86,217,True,6,9
16208,21,55,40,95,True,6,9
16209,22,15,25,40,True,6,9
16210,23,14,24,38,True,6,9
16211,0,13,11,24,False,0,9
16212,1,16,16,32,False,0,9
16213,2,12,10,22,False,0,9
16214,3,24,13,37,False,0,9
16215,4,132,56,188,False,0,9
16216,5,254,163,417,False,0,9
16217,6,403,198,601,False,0,9
16218,7,262,161,423,False,0,9
16219,8,208,160,368,False,0,9
16220,9,210,179,389,False,0,9
16221,10,193,184,377,False,0,9
16222,11,225,204,429,False,0,9
16223,12,223,271,494,False,0,9
16224,13,253,325,578,False,0,9
16225,14,211,273,484,False,0,9
16226,15,185,165,350,False,0,9
16227,16,171,190,361,False,0,9
16228,17,135,158,293,False,0,9
16229,18,96,140,236,False,0,9
16230,19,91,137,228,False,0,9
16231,20,67,88,155,False,0,9
16232,21,32,37,69,False,0,9
16233,22,11,17,28,False,0,9
16234,23,16,21,37,False,0,9
16235,0,6,11,17,False,1,9
16236,1,10,6,16,False,1,9
16237,2,8,8,16,False,1,9
16238,3,21,9,30,False,1,9
16239,4,119,51,170,False,1,9
16240,5,248,161,409,False,1,9
16241,6,430,180,610,False,1,9
16242,7,273,191,464,False,1,9
16243,8,238,189,427,False,1,9
16244,9,207,187,394,False,1,9
16245,10,205,177,382,False,1,9
16246,11,223,220,443,False,1,9
16247,12,207,254,461,False,1,9
16248,13,244,382,626,False,1,9
16249,14,226,315,541,False,1,9
16250,15,186,167,353,False,1,9
16251,16,208,189,397,False,1,9
16252,17,140,150,290,False,1,9
16253,18,119,142,261,False,1,9
16254,19,83,101,184,False,1,9
16255,20,59,87,146,False,1,9
16256,21,29,28,57,False,1,9
16257,22,12,25,37,False,1,9
16258,23,16,22,38,False,1,9
16259,0,11,30,41,False,2,9
16260,1,12,28,40,False,2,9
16261,2,8,31,39,False,2,9
16262,3,23,27,50,False,2,9
16263,4,102,53,155,False,2,9
16264,5,244,140,384,False,2,9
16265,6,399,217,616,False,2,9
16266,7,267,149,416,False,2,9
16267,8,242,200,442,False,2,9
16268,9,230,189,419,False,2,9
16269,10,215,221,436,False,2,9
16270,11,199,213,412,False,2,9
16271,12,253,267,520,False,2,9
16272,13,255,332,587,False,2,9
16273,14,234,300,534,False,2,9
16274,15,216,197,413,False,2,9
16275,16,172,162,334,False,2,9
16276,17,140,171,311,False,2,9
16277,18,114,135,249,False,2,9
16278,19,86,109,195,False,2,9
16279,20,53,99,152,False,2,9
16280,21,33,49,82,False,2,9
16281,22,17,26,43,False,2,9
16282,23,12,17,29,False,2,9
16283,0,5,17,22,False,3,9
16284,1,7,25,32,False,3,9
16285,2,9,15,24,False,3,9
16286,3,17,12,29,False,3,9
16287,4,117,45,162,False,3,9
16288,5,223,153,376,False,3,9
16289,6,415,189,604,False,3,9
16290,7,271,144,415,False,3,9
16291,8,243,185,428,False,3,9
16292,9,240,183,423,False,3,9
16293,10,211,209,420,False,3,9
16294,11,193,186,379,False,3,9
16295,12,197,270,467,False,3,9
16296,13,267,355,622,False,3,9
16297,14,240,307,547,False,3,9
16298,15,184,218,402,False,3,9
16299,16,182,170,352,False,3,9
16300,17,133,179,312,False,3,9
16301,18,124,134,258,False,3,9
16302,19,89,144,233,False,3,9
16303,20,52,94,146,False,3,9
16304,21,30,66,96,False,3,9
16305,22,26,34,60,False,3,9
16306,23,15,39,54,False,3,9
16307,0,8,21,29,False,4,9
16308,1,7,21,28,False,4,9
16309,2,13,19,32,False,4,9
16310,3,21,16,37,False,4,9
16311,4,119,52,171,False,4,9
16312,5,229,124,353,False,4,9
16313,6,408,190,598,False,4,9
16314,7,254,157,411,False,4,9
16315,8,225,171,396,False,4,9
16316,9,211,190,401,False,4,9
16317,10,235,255,490,False,4,9
16318,11,237,254,491,False,4,9
16319,12,229,287,516,False,4,9
16320,13,275,345,620,False,4,9
16321,14,188,274,462,False,4,9
16322,15,188,170,358,False,4,9
16323,16,146,154,300,False,4,9
16324,17,120,161,281,False,4,9
16325,18,84,96,180,False,4,9
16326,19,65,74,139,False,4,9
16327,20,59,69,128,False,4,9
16328,21,51,58,109,False,4,9
16329,22,42,48,90,False,4,9
16330,23,29,46,75,False,4,9
16331,0,29,28,57,False,5,9
16332,1,20,40,60,False,5,9
16333,2,13,30,43,False,5,9
16334,3,12,8,20,False,5,9
16335,4,19,9,28,False,5,9
16336,5,24,20,44,False,5,9
16337,6,50,33,83,False,5,9
16338,7,78,66,144,False,5,9
16339,8,117,86,203,False,5,9
16340,9,176,99,275,False,5,9
16341,10,199,140,339,False,5,9
16342,11,175,176,351,False,5,9
16343,12,171,199,370,False,5,9
16344,13,134,225,359,False,5,9
16345,14,200,175,375,False,5,9
16346,15,158,168,326,False,5,9
16347,16,147,183,330,False,5,9
16348,17,142,118,260,False,5,9
16349,18,79,102,181,False,5,9
16350,19,61,93,154,False,5,9
16351,20,56,76,132,False,5,9
16352,21,38,83,121,False,5,9
16353,22,47,63,110,False,5,9
16354,23,36,56,92,False,5,9
16355,0,29,73,102,True,6,9
16356,1,27,64,91,True,6,9
16357,2,25,47,72,True,6,9
16358,3,6,19,25,True,6,9
16359,4,9,11,20,True,6,9
16360,5,16,11,27,True,6,9
16361,6,19,19,38,True,6,9
16362,7,33,19,52,True,6,9
16363,8,53,34,87,True,6,9
16364,9,137,79,216,True,6,9
16365,10,152,103,255,True,6,9
16366,11,183,173,356,True,6,9
16367,12,196,214,410,True,6,9
16368,13,201,217,418,True,6,9
16369,14,180,253,433,True,6,9
16370,15,190,246,436,True,6,9
16371,16,166,183,349,True,6,9
16372,17,137,194,331,True,6,9
16373,18,145,156,301,True,6,9
16374,19,98,136,234,True,6,9
16375,20,82,106,188,True,6,9
16376,21,52,57,109,True,6,9
16377,22,23,38,61,True,6,9
16378,23,23,24,47,True,6,9
16379,0,11,11,22,False,0,9
16380,1,10,12,22,False,0,9
16381,2,6,18,24,False,0,9
16382,3,12,8,20,False,0,9
16383,4,19,14,33,False,0,9
16384,5,128,54,182,False,0,9
16385,6,258,152,410,False,0,9
16386,7,386,224,610,False,0,9
16387,8,302,192,494,False,0,9
16388,9,219,185,404,False,0,9
16389,10,226,180,406,False,0,9
16390,11,211,176,387,False,0,9
16391,12,227,254,481,False,0,9
16392,13,213,267,480,False,0,9
16393,14,248,330,578,False,0,9
16394,15,256,296,552,False,0,9
16395,16,214,199,413,False,0,9
16396,17,179,160,339,False,0,9
16397,18,134,143,277,False,0,9
16398,19,107,124,231,False,0,9
16399,20,79,117,196,False,0,9
16400,21,44,97,141,False,0,9
16401,22,21,37,58,False,0,9
16402,23,9,17,26,False,0,9
16403,0,11,14,25,False,1,9
16404,1,5,11,16,False,1,9
16405,2,7,12,19,False,1,9
16406,3,10,11,21,False,1,9
16407,4,24,15,39,False,1,9
16408,5,126,53,179,False,1,9
16409,6,288,151,439,False,1,9
16410,7,404,190,594,False,1,9
16411,8,256,171,427,False,1,9
16412,9,222,179,401,False,1,9
16413,10,237,204,441,False,1,9
16414,11,216,240,456,False,1,9
16415,12,196,208,404,False,1,9
16416,13,263,286,549,False,1,9
16417,14,245,366,611,False,1,9
16418,15,230,306,536,False,1,9
16419,16,232,200,432,False,1,9
16420,17,177,142,319,False,1,9
16421,18,141,145,286,False,1,9
16422,19,98,123,221,False,1,9
16423,20,79,116,195,False,1,9
16424,21,46,91,137,False,1,9
16425,22,27,58,85,False,1,9
16426,23,19,19,38,False,1,9
16427,0,4,26,30,False,2,10
16428,1,9,26,35,False,2,10
16429,2,11,18,29,False,2,10
16430,3,10,14,24,False,2,10
16431,4,21,14,35,False,2,10
16432,5,118,64,182,False,2,10
16433,6,223,165,388,False,2,10
16434,7,415,211,626,False,2,10
16435,8,271,167,438,False,2,10
16436,9,238,159,397,False,2,10
16437,10,216,203,419,False,2,10
16438,11,239,200,439,False,2,10
16439,12,217,205,422,False,2,10
16440,13,247,256,503,False,2,10
16441,14,239,363,602,False,2,10
16442,15,263,309,572,False,2,10
16443,16,243,216,459,False,2,10
16444,17,193,187,380,False,2,10
16445,18,153,152,305,False,2,10
16446,19,107,150,257,False,2,10
16447,20,90,131,221,False,2,10
16448,21,62,76,138,False,2,10
16449,22,35,47,82,False,2,10
16450,23,16,28,44,False,2,10
16451,0,6,9,15,False,3,10
16452,1,4,8,12,False,3,10
16453,2,6,17,23,False,3,10
16454,3,12,9,21,False,3,10
16455,4,22,11,33,False,3,10
16456,5,124,52,176,False,3,10
16457,6,244,168,412,False,3,10
16458,7,428,218,646,False,3,10
16459,8,240,161,401,False,3,10
16460,9,198,161,359,False,3,10
16461,10,265,176,441,False,3,10
16462,11,247,239,486,False,3,10
16463,12,236,222,458,False,3,10
16464,13,228,301,529,False,3,10
16465,14,233,343,576,False,3,10
16466,15,270,319,589,False,3,10
16467,16,191,215,406,False,3,10
16468,17,176,192,368,False,3,10
16469,18,147,180,327,False,3,10
16470,19,104,187,291,False,3,10
16471,20,89,114,203,False,3,10
16472,21,67,87,154,False,3,10
16473,22,25,55,80,False,3,10
16474,23,26,26,52,False,3,10
16475,0,10,30,40,False,4,10
16476,1,9,17,26,False,4,10
16477,2,6,25,31,False,4,10
16478,3,13,22,35,False,4,10
16479,4,16,14,30,False,4,10
16480,5,127,59,186,False,4,10
16481,6,265,153,418,False,4,10
16482,7,393,186,579,False,4,10
16483,8,247,163,410,False,4,10
16484,9,204,205,409,False,4,10
16485,10,225,181,406,False,4,10
16486,11,248,208,456,False,4,10
16487,12,227,234,461,False,4,10
16488,13,299,276,575,False,4,10
16489,14,237,394,631,False,4,10
16490,15,215,296,511,False,4,10
16491,16,168,185,353,False,4,10
16492,17,154,162,316,False,4,10
16493,18,139,119,258,False,4,10
16494,19,88,135,223,False,4,10
16495,20,84,83,167,False,4,10
16496,21,69,93,162,False,4,10
16497,22,42,64,106,False,4,10
16498,23,40,43,83,False,4,10
16499,0,24,38,62,False,5,10
16500,1,15,48,63,False,5,10
16501,2,13,38,51,False,5,10
16502,3,11,28,39,False,5,10
16503,4,14,15,29,False,5,10
16504,5,21,15,36,False,5,10
16505,6,29,14,43,False,5,10
16506,7,62,38,100,False,5,10
16507,8,81,59,140,False,5,10
16508,9,163,89,252,False,5,10
16509,10,146,112,258,False,5,10
16510,11,196,144,340,False,5,10
16511,12,180,176,356,False,5,10
16512,13,177,221,398,False,5,10
16513,14,154,251,405,False,5,10
16514,15,144,187,331,False,5,10
16515,16,119,160,279,False,5,10
16516,17,126,138,264,False,5,10
16517,18,126,107,233,False,5,10
16518,19,74,104,178,False,5,10
16519,20,54,90,144,False,5,10
16520,21,45,76,121,False,5,10
16521,22,44,73,117,False,5,10
16522,23,34,64,98,False,5,10
16523,0,34,43,77,True,6,10
16524,1,31,52,83,True,6,10
16525,2,22,45,67,True,6,10
16526,3,9,55,64,True,6,10
16527,4,17,21,38,True,6,10
16528,5,18,12,30,True,6,10
16529,6,18,10,28,True,6,10
16530,7,31,17,48,True,6,10
16531,8,60,45,105,True,6,10
16532,9,103,60,163,True,6,10
16533,10,152,113,265,True,6,10
16534,11,177,197,374,True,6,10
16535,12,181,221,402,True,6,10
16536,13,246,212,458,True,6,10
16537,14,192,221,413,True,6,10
16538,15,195,253,448,True,6,10
16539,16,252,211,463,True,6,10
16540,17,172,201,373,True,6,10
16541,18,135,206,341,True,6,10
16542,19,148,156,304,True,6,10
16543,20,81,94,175,True,6,10
16544,21,59,58,117,True,6,10
16545,22,29,40,69,True,6,10
16546,23,20,17,37,True,6,10
16547,0,10,18,28,False,0,10
16548,1,5,10,15,False,0,10
16549,2,6,12,18,False,0,10
16550,3,7,6,13,False,0,10
16551,4,16,12,28,False,0,10
16552,5,126,57,183,False,0,10
16553,6,236,168,404,False,0,10
16554,7,375,200,575,False,0,10
16555,8,275,187,462,False,0,10
16556,9,259,186,445,False,0,10
16557,10,236,188,424,False,0,10
16558,11,205,170,375,False,0,10
16559,12,211,195,406,False,0,10
16560,13,203,231,434,False,0,10
16561,14,237,337,574,False,0,10
16562,15,229,276,505,False,0,10
16563,16,238,213,451,False,0,10
16564,17,201,161,362,False,0,10
16565,18,121,158,279,False,0,10
16566,19,129,135,264,False,0,10
16567,20,77,133,210,False,0,10
16568,21,66,106,172,False,0,10
16569,22,29,41,70,False,0,10
16570,23,16,26,42,False,0,10
16571,0,6,10,16,False,1,10
16572,1,9,18,27,False,1,10
16573,2,4,11,15,False,1,10
16574,3,10,11,21,False,1,10
16575,4,17,17,34,False,1,10
16576,5,123,64,187,False,1,10
16577,6,212,145,357,False,1,10
16578,7,414,224,638,False,1,10
16579,8,254,156,410,False,1,10
16580,9,264,186,450,False,1,10
16581,10,217,191,408,False,1,10
16582,11,209,218,427,False,1,10
16583,12,205,221,426,False,1,10
16584,13,224,251,475,False,1,10
16585,14,260,331,591,False,1,10
16586,15,187,315,502,False,1,10
16587,16,219,189,408,False,1,10
16588,17,192,143,335,False,1,10
16589,18,151,141,292,False,1,10
16590,19,131,128,259,False,1,10
16591,20,78,147,225,False,1,10
16592,21,66,78,144,False,1,10
16593,22,40,32,72,False,1,10
16594,23,12,20,32,False,1,10
16595,0,11,16,27,False,2,10
16596,1,3,15,18,False,2,10
16597,2,10,15,25,False,2,10
16598,3,8,6,14,False,2,10
16599,4,17,16,33,False,2,10
16600,5,136,58,194,False,2,10
16601,6,245,173,418,False,2,10
16602,7,416,212,628,False,2,10
16603,8,287,175,462,False,2,10
16604,9,238,164,402,False,2,10
16605,10,226,172,398,False,2,10
16606,11,228,226,454,False,2,10
16607,12,213,219,432,False,2,10
16608,13,264,276,540,False,2,10
16609,14,256,367,623,False,2,10
16610,15,233,297,530,False,2,10
16611,16,212,212,424,False,2,10
16612,17,211,165,376,False,2,10
16613,18,131,153,284,False,2,10
16614,19,101,132,233,False,2,10
16615,20,96,123,219,False,2,10
16616,21,59,100,159,False,2,10
16617,22,30,58,88,False,2,10
16618,23,15,28,43,False,2,10
16619,0,18,19,37,False,3,10
16620,1,6,21,27,False,3,10
16621,2,4,14,18,False,3,10
16622,3,11,12,23,False,3,10
16623,4,13,17,30,False,3,10
16624,5,136,51,187,False,3,10
16625,6,273,152,425,False,3,10
16626,7,392,214,606,False,3,10
16627,8,294,165,459,False,3,10
16628,9,263,169,432,False,3,10
16629,10,207,191,398,False,3,10
16630,11,226,219,445,False,3,10
16631,12,221,212,433,False,3,10
16632,13,267,259,526,False,3,10
16633,14,254,357,611,False,3,10
16634,15,258,289,547,False,3,10
16635,16,222,207,429,False,3,10
16636,17,211,166,377,False,3,10
16637,18,174,181,355,False,3,10
16638,19,127,135,262,False,3,10
16639,20,101,133,234,False,3,10
16640,21,69,107,176,False,3,10
16641,22,35,213,248,False,3,10
16642,23,21,82,103,False,3,10
16643,0,8,24,32,False,4,10
16644,1,10,25,35,False,4,10
16645,2,9,30,39,False,4,10
16646,3,9,13,22,False,4,10
16647,4,15,14,29,False,4,10
16648,5,122,57,179,False,4,10
16649,6,255,162,417,False,4,10
16650,7,368,184,552,False,4,10
16651,8,252,159,411,False,4,10
16652,9,242,157,399,False,4,10
16653,10,236,193,429,False,4,10
16654,11,257,220,477,False,4,10
16655,12,228,247,475,False,4,10
16656,13,260,323,583,False,4,10
16657,14,307,395,702,False,4,10
16658,15,214,291,505,False,4,10
16659,16,177,198,375,False,4,10
16660,17,153,148,301,False,4,10
16661,18,138,120,258,False,4,10
16662,19,105,101,206,False,4,10
16663,20,62,83,145,False,4,10
16664,21,68,94,162,False,4,10
16665,22,49,59,108,False,4,10
16666,23,34,46,80,False,4,10
16667,0,35,44,79,False,5,10
16668,1,22,37,59,False,5,10
16669,2,19,46,65,False,5,10
16670,3,9,33,42,False,5,10
16671,4,13,23,36,False,5,10
16672,5,21,20,41,False,5,10
16673,6,50,17,67,False,5,10
16674,7,80,41,121,False,5,10
16675,8,81,57,138,False,5,10
16676,9,126,85,211,False,5,10
16677,10,165,124,289,False,5,10
16678,11,201,171,372,False,5,10
16679,12,187,174,361,False,5,10
16680,13,173,220,393,False,5,10
16681,14,169,216,385,False,5,10
16682,15,143,239,382,False,5,10
16683,16,160,182,342,False,5,10
16684,17,129,145,274,False,5,10
16685,18,127,119,246,False,5,10
16686,19,73,108,181,False,5,10
16687,20,49,84,133,False,5,10
16688,21,45,54,99,False,5,10
16689,22,48,71,119,False,5,10
16690,23,44,77,121,False,5,10
16691,0,28,62,90,True,6,10
16692,1,33,42,75,True,6,10
16693,2,26,52,78,True,6,10
16694,3,19,43,62,True,6,10
16695,4,15,29,44,True,6,10
16696,5,17,16,33,True,6,10
16697,6,18,14,32,True,6,10
16698,7,30,18,48,True,6,10
16699,8,54,40,94,True,6,10
16700,9,80,77,157,True,6,10
16701,10,129,98,227,True,6,10
16702,11,187,137,324,True,6,10
16703,12,162,175,337,True,6,10
16704,13,187,240,427,True,6,10
16705,14,194,237,431,True,6,10
16706,15,169,220,389,True,6,10
16707,16,209,215,424,True,6,10
16708,17,161,147,308,True,6,10
16709,18,164,167,331,True,6,10
16710,19,124,142,266,True,6,10
16711,20,69,120,189,True,6,10
16712,21,53,71,124,True,6,10
16713,22,27,44,71,True,6,10
16714,23,16,27,43,True,6,10
16715,0,11,21,32,False,0,10
16716,1,4,9,13,False,0,10
16717,2,6,15,21,False,0,10
16718,3,7,13,20,False,0,10
16719,4,15,19,34,False,0,10
16720,5,121,50,171,False,0,10
16721,6,233,150,383,False,0,10
16722,7,357,199,556,False,0,10
16723,8,287,157,444,False,0,10
16724,9,224,168,392,False,0,10
16725,10,229,162,391,False,0,10
16726,11,202,212,414,False,0,10
16727,12,256,209,465,False,0,10
16728,13,223,229,452,False,0,10
16729,14,235,330,565,False,0,10
16730,15,286,297,583,False,0,10
16731,16,197,203,400,False,0,10
16732,17,166,163,329,False,0,10
16733,18,145,137,282,False,0,10
16734,19,98,114,212,False,0,10
16735,20,80,116,196,False,0,10
16736,21,51,84,135,False,0,10
16737,22,27,45,72,False,0,10
16738,23,20,26,46,False,0,10
16739,0,12,12,24,False,1,10
16740,1,7,7,14,False,1,10
16741,2,8,11,19,False,1,10
16742,3,5,5,10,False,1,10
16743,4,17,14,31,False,1,10
16744,5,125,57,182,False,1,10
16745,6,266,148,414,False,1,10
16746,7,443,196,639,False,1,10
16747,8,256,170,426,False,1,10
16748,9,252,236,488,False,1,10
16749,10,228,177,405,False,1,10
16750,11,212,203,415,False,1,10
16751,12,238,215,453,False,1,10
16752,13,224,275,499,False,1,10
16753,14,252,326,578,False,1,10
16754,15,257,317,574,False,1,10
16755,16,203,198,401,False,1,10
16756,17,184,179,363,False,1,10
16757,18,144,148,292,False,1,10
16758,19,118,137,255,False,1,10
16759,20,79,114,193,False,1,10
16760,21,64,85,149,False,1,10
16761,22,28,42,70,False,1,10
16762,23,17,30,47,False,1,10
16763,0,8,13,21,False,2,10
16764,1,6,12,18,False,2,10
16765,2,4,14,18,False,2,10
16766,3,11,7,18,False,2,10
16767,4,17,16,33,False,2,10
16768,5,122,53,175,False,2,10
16769,6,247,146,393,False,2,10
16770,7,405,195,600,False,2,10
16771,8,260,156,416,False,2,10
16772,9,257,199,456,False,2,10
16773,10,248,194,442,False,2,10
16774,11,265,228,493,False,2,10
16775,12,218,218,436,False,2,10
16776,13,237,280,517,False,2,10
16777,14,264,354,618,False,2,10
16778,15,242,306,548,False,2,10
16779,16,204,216,420,False,2,10
16780,17,185,175,360,False,2,10
16781,18,141,140,281,False,2,10
16782,19,118,121,239,False,2,10
16783,20,88,122,210,False,2,10
16784,21,55,90,145,False,2,10
16785,22,30,145,175,False,2,10
16786,23,21,38,59,False,2,10
16787,0,10,17,27,False,3,10
16788,1,4,25,29,False,3,10
16789,2,9,15,24,False,3,10
16790,3,9,9,18,False,3,10
16791,4,15,17,32,False,3,10
16792,5,107,47,154,False,3,10
16793,6,240,143,383,False,3,10
16794,7,395,225,620,False,3,10
16795,8,260,197,457,False,3,10
16796,9,236,165,401,False,3,10
16797,10,238,175,413,False,3,10
16798,11,224,206,430,False,3,10
16799,12,241,196,437,False,3,10
16800,13,227,284,511,False,3,10
16801,14,254,401,655,False,3,10
16802,15,286,342,628,False,3,10
16803,16,231,205,436,False,3,10
16804,17,168,167,335,False,3,10
16805,18,148,172,320,False,3,10
16806,19,104,144,248,False,3,10
16807,20,92,131,223,False,3,10
16808,21,67,112,179,False,3,10
16809,22,38,71,109,False,3,10
16810,23,24,39,63,False,3,10
16811,0,11,26,37,False,4,10
16812,1,7,15,22,False,4,10
16813,2,7,24,31,False,4,10
16814,3,11,13,24,False,4,10
16815,4,20,14,34,False,4,10
16816,5,117,53,170,False,4,10
16817,6,248,137,385,False,4,10
16818,7,435,217,652,False,4,10
16819,8,280,174,454,False,4,10
16820,9,226,170,396,False,4,10
16821,10,237,172,409,False,4,10
16822,11,227,245,472,False,4,10
16823,12,217,219,436,False,4,10
16824,13,268,301,569,False,4,10
16825,14,280,387,667,False,4,10
16826,15,227,285,512,False,4,10
16827,16,182,196,378,False,4,10
16828,17,197,158,355,False,4,10
16829,18,129,142,271,False,4,10
16830,19,106,126,232,False,4,10
16831,20,63,99,162,False,4,10
16832,21,78,85,163,False,4,10
16833,22,42,62,104,False,4,10
16834,23,47,58,105,False,4,10
16835,0,28,44,72,False,5,10
16836,1,23,45,68,False,5,10
16837,2,13,41,54,False,5,10
16838,3,12,32,44,False,5,10
16839,4,10,15,25,False,5,10
16840,5,19,20,39,False,5,10
16841,6,31,21,52,False,5,10
16842,7,44,36,80,False,5,10
16843,8,58,43,101,False,5,10
16844,9,98,80,178,False,5,10
16845,10,162,130,292,False,5,10
16846,11,209,157,366,False,5,10
16847,12,185,177,362,False,5,10
16848,13,176,207,383,False,5,10
16849,14,176,175,351,False,5,10
16850,15,153,173,326,False,5,10
16851,16,157,151,308,False,5,10
16852,17,154,176,330,False,5,10
16853,18,101,118,219,False,5,10
16854,19,97,95,192,False,5,10
16855,20,44,88,132,False,5,10
16856,21,57,77,134,False,5,10
16857,22,51,68,119,False,5,10
16858,23,48,70,118,False,5,10
16859,0,42,66,108,True,6,10
16860,1,22,51,73,True,6,10
16861,2,36,66,102,True,6,10
16862,3,22,55,77,True,6,10
16863,4,13,23,36,True,6,10
16864,5,13,12,25,True,6,10
16865,6,24,17,41,True,6,10
16866,7,39,23,62,True,6,10
16867,8,54,44,98,True,6,10
16868,9,117,64,181,True,6,10
16869,10,120,90,210,True,6,10
16870,11,148,141,289,True,6,10
16871,12,172,198,370,True,6,10
16872,13,171,180,351,True,6,10
16873,14,169,214,383,True,6,10
16874,15,186,244,430,True,6,10
16875,16,180,186,366,True,6,10
16876,17,157,172,329,True,6,10
16877,18,156,158,314,True,6,10
16878,19,114,144,258,True,6,10
16879,20,82,107,189,True,6,10
16880,21,44,60,104,True,6,10
16881,22,36,58,94,True,6,10
16882,23,18,32,50,True,6,10
16883,0,10,25,35,False,0,10
16884,1,7,9,16,False,0,10
16885,2,4,11,15,False,0,10
16886,3,17,5,22,False,0,10
16887,4,16,18,34,False,0,10
16888,5,123,49,172,False,0,10
16889,6,241,161,402,False,0,10
16890,7,388,215,603,False,0,10
16891,8,297,175,472,False,0,10
16892,9,255,169,424,False,0,10
16893,10,248,176,424,False,0,10
16894,11,248,203,451,False,0,10
16895,12,210,212,422,False,0,10
16896,13,261,281,542,False,0,10
16897,14,242,335,577,False,0,10
16898,15,278,285,563,False,0,10
16899,16,193,181,374,False,0,10
16900,17,160,153,313,False,0,10
16901,18,127,138,265,False,0,10
16902,19,107,113,220,False,0,10
16903,20,86,119,205,False,0,10
16904,21,71,74,145,False,0,10
16905,22,33,45,78,False,0,10
16906,23,28,29,57,False,0,10
16907,0,11,17,28,False,1,10
16908,1,7,5,12,False,1,10
16909,2,6,4,10,False,1,10
16910,3,10,12,22,False,1,10
16911,4,22,18,40,False,1,10
16912,5,116,51,167,False,1,10
16913,6,252,164,416,False,1,10
16914,7,369,234,603,False,1,10
16915,8,262,169,431,False,1,10
16916,9,253,178,431,False,1,10
16917,10,238,186,424,False,1,10
16918,11,203,201,404,False,1,10
16919,12,210,176,386,False,1,10
16920,13,224,244,468,False,1,10
16921,14,259,309,568,False,1,10
16922,15,235,305,540,False,1,10
16923,16,186,195,381,False,1,10
16924,17,199,165,364,False,1,10
16925,18,134,156,290,False,1,10
16926,19,108,120,228,False,1,10
16927,20,84,107,191,False,1,10
16928,21,74,106,180,False,1,10
16929,22,38,43,81,False,1,10
16930,23,19,31,50,False,1,10
16931,0,17,21,38,False,2,10
16932,1,8,23,31,False,2,10
16933,2,16,20,36,False,2,10
16934,3,14,14,28,False,2,10
16935,4,20,18,38,False,2,10
16936,5,121,57,178,False,2,10
16937,6,233,153,386,False,2,10
16938,7,387,231,618,False,2,10
16939,8,299,178,477,False,2,10
16940,9,223,170,393,False,2,10
16941,10,207,193,400,False,2,10
16942,11,219,207,426,False,2,10
16943,12,233,209,442,False,2,10
16944,13,217,276,493,False,2,10
16945,14,258,311,569,False,2,10
16946,15,248,307,555,False,2,10
16947,16,213,198,411,False,2,10
16948,17,171,157,328,False,2,10
16949,18,143,156,299,False,2,10
16950,19,91,151,242,False,2,10
16951,20,84,113,197,False,2,10
16952,21,89,93,182,False,2,10
16953,22,41,56,97,False,2,10
16954,23,29,27,56,False,2,10
16955,0,14,22,36,False,3,10
16956,1,17,15,32,False,3,10
16957,2,13,14,27,False,3,10
16958,3,9,7,16,False,3,10
16959,4,22,16,38,False,3,10
16960,5,125,63,188,False,3,10
16961,6,282,167,449,False,3,10
16962,7,406,247,653,False,3,10
16963,8,278,186,464,False,3,10
16964,9,247,156,403,False,3,10
16965,10,207,187,394,False,3,10
16966,11,220,195,415,False,3,10
16967,12,207,237,444,False,3,10
16968,13,249,272,521,False,3,10
16969,14,275,353,628,False,3,10
16970,15,260,303,563,False,3,10
16971,16,201,204,405,False,3,10
16972,17,170,163,333,False,3,10
16973,18,158,155,313,False,3,10
16974,19,101,139,240,False,3,10
16975,20,96,129,225,False,3,10
16976,21,77,79,156,False,3,10
16977,22,39,59,98,False,3,10
16978,23,22,33,55,False,3,10
16979,0,10,17,27,False,4,10
16980,1,16,19,35,False,4,10
16981,2,9,24,33,False,4,10
16982,3,14,13,27,False,4,10
16983,4,23,14,37,False,4,10
16984,5,125,64,189,False,4,10
16985,6,249,163,412,False,4,10
16986,7,393,212,605,False,4,10
16987,8,274,145,419,False,4,10
16988,9,255,174,429,False,4,10
16989,10,268,177,445,False,4,10
16990,11,204,216,420,False,4,10
16991,12,254,231,485,False,4,10
16992,13,273,300,573,False,4,10
16993,14,254,380,634,False,4,10
16994,15,242,317,559,False,4,10
16995,16,209,204,413,False,4,10
16996,17,160,173,333,False,4,10
16997,18,153,181,334,False,4,10
16998,19,79,108,187,False,4,10
16999,20,61,84,145,False,4,10
17000,21,65,87,152,False,4,10
17001,22,62,65,127,False,4,10
17002,23,49,54,103,False,4,10
17003,0,19,36,55,False,5,10
17004,1,21,41,62,False,5,10
17005,2,28,58,86,False,5,10
17006,3,17,37,54,False,5,10
17007,4,11,13,24,False,5,10
17008,5,31,18,49,False,5,10
17009,6,33,21,54,False,5,10
17010,7,41,36,77,False,5,10
17011,8,55,49,104,False,5,10
17012,9,122,74,196,False,5,10
17013,10,142,111,253,False,5,10
17014,11,147,138,285,False,5,10
17015,12,168,139,307,False,5,10
17016,13,180,202,382,False,5,10
17017,14,173,186,359,False,5,10
17018,15,152,160,312,False,5,10
17019,16,155,195,350,False,5,10
17020,17,147,178,325,False,5,10
17021,18,118,126,244,False,5,10
17022,19,80,120,200,False,5,10
17023,20,54,79,133,False,5,10
17024,21,56,77,133,False,5,10
17025,22,46,76,122,False,5,10
17026,23,53,60,113,False,5,10
17027,0,32,45,77,True,6,10
17028,1,31,56,87,True,6,10
17029,2,27,61,88,True,6,10
17030,3,24,44,68,True,6,10
17031,4,20,17,37,True,6,10
17032,5,12,12,24,True,6,10
17033,6,27,16,43,True,6,10
17034,7,27,16,43,True,6,10
17035,8,54,40,94,True,6,10
17036,9,109,50,159,True,6,10
17037,10,117,85,202,True,6,10
17038,11,138,147,285,True,6,10
17039,12,161,180,341,True,6,10
17040,13,204,188,392,True,6,10
17041,14,174,214,388,True,6,10
17042,15,207,218,425,True,6,10
17043,16,164,207,371,True,6,10
17044,17,149,149,298,True,6,10
17045,18,139,177,316,True,6,10
17046,19,138,129,267,True,6,10
17047,20,97,100,197,True,6,10
17048,21,62,60,122,True,6,10
17049,22,32,36,68,True,6,10
17050,23,25,25,50,True,6,10
17051,0,6,20,26,False,0,10
17052,1,5,10,15,False,0,10
17053,2,11,14,25,False,0,10
17054,3,8,7,15,False,0,10
17055,4,21,13,34,False,0,10
17056,5,129,64,193,False,0,10
17057,6,243,167,410,False,0,10
17058,7,376,206,582,False,0,10
17059,8,283,164,447,False,0,10
17060,9,200,166,366,False,0,10
17061,10,238,183,421,False,0,10
17062,11,241,215,456,False,0,10
17063,12,235,221,456,False,0,10
17064,13,230,274,504,False,0,10
17065,14,255,342,597,False,0,10
17066,15,249,307,556,False,0,10
17067,16,191,188,379,False,0,10
17068,17,175,155,330,False,0,10
17069,18,131,147,278,False,0,10
17070,19,108,130,238,False,0,10
17071,20,80,97,177,False,0,10
17072,21,60,84,144,False,0,10
17073,22,33,54,87,False,0,10
17074,23,17,15,32,False,0,10
17075,0,7,16,23,False,1,10
17076,1,10,8,18,False,1,10
17077,2,7,3,10,False,1,10
17078,3,9,9,18,False,1,10
17079,4,24,17,41,False,1,10
17080,5,117,59,176,False,1,10
17081,6,233,133,366,False,1,10
17082,7,369,213,582,False,1,10
17083,8,258,161,419,False,1,10
17084,9,230,163,393,False,1,10
17085,10,221,162,383,False,1,10
17086,11,234,210,444,False,1,10
17087,12,237,231,468,False,1,10
17088,13,260,271,531,False,1,10
17089,14,258,305,563,False,1,10
17090,15,230,302,532,False,1,10
17091,16,205,182,387,False,1,10
17092,17,177,173,350,False,1,10
17093,18,141,132,273,False,1,10
17094,19,114,147,261,False,1,10
17095,20,84,122,206,False,1,10
17096,21,74,84,158,False,1,10
17097,22,31,49,80,False,1,10
17098,23,20,35,55,False,1,10
17099,0,13,14,27,False,2,10
17100,1,6,14,20,False,2,10
17101,2,4,14,18,False,2,10
17102,3,14,8,22,False,2,10
17103,4,15,15,30,False,2,10
17104,5,122,57,179,False,2,10
17105,6,244,145,389,False,2,10
17106,7,420,221,641,False,2,10
17107,8,265,157,422,False,2,10
17108,9,188,158,346,False,2,10
17109,10,238,176,414,False,2,10
17110,11,230,190,420,False,2,10
17111,12,207,222,429,False,2,10
17112,13,244,238,482,False,2,10
17113,14,244,334,578,False,2,10
17114,15,237,315,552,False,2,10
17115,16,192,175,367,False,2,10
17116,17,177,179,356,False,2,10
17117,18,137,161,298,False,2,10
17118,19,109,129,238,False,2,10
17119,20,93,104,197,False,2,10
17120,21,53,110,163,False,2,10
17121,22,41,76,117,False,2,10
17122,23,13,29,42,False,2,10
17123,0,6,19,25,False,3,10
17124,1,10,25,35,False,3,10
17125,2,8,20,28,False,3,10
17126,3,9,20,29,False,3,10
17127,4,14,16,30,False,3,10
17128,5,130,54,184,False,3,10
17129,6,236,155,391,False,3,10
17130,7,402,224,626,False,3,10
17131,8,243,150,393,False,3,10
17132,9,233,200,433,False,3,10
17133,10,237,185,422,False,3,10
17134,11,227,224,451,False,3,10
17135,12,224,221,445,False,3,10
17136,13,278,245,523,False,3,10
17137,14,260,345,605,False,3,10
17138,15,269,294,563,False,3,10
17139,16,219,188,407,False,3,10
17140,17,201,208,409,False,3,10
17141,18,155,174,329,False,3,10
17142,19,106,137,243,False,3,10
17143,20,90,130,220,False,3,10
17144,21,64,125,189,False,3,10
17145,22,38,77,115,False,3,10
17146,23,23,110,133,False,3,10
17147,0,15,35,50,False,4,11
17148,1,14,17,31,False,4,11
17149,2,11,24,35,False,4,11
17150,3,10,18,28,False,4,11
17151,4,12,19,31,False,4,11
17152,5,117,53,170,False,4,11
17153,6,234,133,367,False,4,11
17154,7,381,210,591,False,4,11
17155,8,255,144,399,False,4,11
17156,9,224,178,402,False,4,11
17157,10,241,192,433,False,4,11
17158,11,256,218,474,False,4,11
17159,12,246,202,448,False,4,11
17160,13,280,306,586,False,4,11
17161,14,271,384,655,False,4,11
17162,15,215,299,514,False,4,11
17163,16,198,211,409,False,4,11
17164,17,198,194,392,False,4,11
17165,18,137,156,293,False,4,11
17166,19,93,120,213,False,4,11
17167,20,63,88,151,False,4,11
17168,21,65,97,162,False,4,11
17169,22,65,90,155,False,4,11
17170,23,53,78,131,False,4,11
17171,0,32,54,86,False,5,11
17172,1,16,43,59,False,5,11
17173,2,19,37,56,False,5,11
17174,3,12,28,40,False,5,11
17175,4,8,18,26,False,5,11
17176,5,22,13,35,False,5,11
17177,6,31,23,54,False,5,11
17178,7,58,32,90,False,5,11
17179,8,60,59,119,False,5,11
17180,9,127,72,199,False,5,11
17181,10,129,124,253,False,5,11
17182,11,156,142,298,False,5,11
17183,12,184,153,337,False,5,11
17184,13,209,170,379,False,5,11
17185,14,251,195,446,False,5,11
17186,15,222,184,406,False,5,11
17187,16,142,378,520,False,5,11
17188,17,139,165,304,False,5,11
17189,18,102,170,272,False,5,11
17190,19,89,103,192,False,5,11
17191,20,72,91,163,False,5,11
17192,21,50,65,115,False,5,11
17193,22,44,68,112,False,5,11
17194,23,38,69,107,False,5,11
17195,0,40,48,88,True,6,11
17196,1,18,46,64,True,6,11
17197,2,17,57,74,True,6,11
17198,3,21,40,61,True,6,11
17199,4,16,26,42,True,6,11
17200,5,15,18,33,True,6,11
17201,6,15,13,28,True,6,11
17202,7,39,18,57,True,6,11
17203,8,49,44,93,True,6,11
17204,9,107,64,171,True,6,11
17205,10,127,98,225,True,6,11
17206,11,154,168,322,True,6,11
17207,12,171,166,337,True,6,11
17208,13,217,189,406,True,6,11
17209,14,165,215,380,True,6,11
17210,15,182,228,410,True,6,11
17211,16,165,215,380,True,6,11
17212,17,154,185,339,True,6,11
17213,18,114,150,264,True,6,11
17214,19,119,147,266,True,6,11
17215,20,78,113,191,True,6,11
17216,21,64,85,149,True,6,11
17217,22,31,46,77,True,6,11
17218,23,23,28,51,True,6,11
17219,0,6,18,24,False,0,11
17220,1,8,19,27,False,0,11
17221,2,5,16,21,False,0,11
17222,3,15,13,28,False,0,11
17223,4,17,18,35,False,0,11
17224,5,131,54,185,False,0,11
17225,6,242,152,394,False,0,11
17226,7,411,229,640,False,0,11
17227,8,276,187,463,False,0,11
17228,9,226,140,366,False,0,11
17229,10,238,177,415,False,0,11
17230,11,229,209,438,False,0,11
17231,12,216,218,434,False,0,11
17232,13,206,283,489,False,0,11
17233,14,267,351,618,False,0,11
17234,15,327,423,750,False,0,11
17235,16,237,207,444,False,0,11
17236,17,176,189,365,False,0,11
17237,18,124,137,261,False,0,11
17238,19,98,124,222,False,0,11
17239,20,78,129,207,False,0,11
17240,21,60,263,323,False,0,11
17241,22,33,173,206,False,0,11
17242,23,15,60,75,False,0,11
17243,0,13,43,56,False,1,11
17244,1,8,27,35,False,1,11
17245,2,6,26,32,False,1,11
17246,3,10,30,40,False,1,11
17247,4,18,17,35,False,1,11
17248,5,134,56,190,False,1,11
17249,6,239,166,405,False,1,11
17250,7,393,244,637,False,1,11
17251,8,304,144,448,False,1,11
17252,9,206,172,378,False,1,11
17253,10,209,196,405,False,1,11
17254,11,237,195,432,False,1,11
17255,12,194,223,417,False,1,11
17256,13,223,252,475,False,1,11
17257,14,252,321,573,False,1,11
17258,15,234,284,518,False,1,11
17259,16,209,184,393,False,1,11
17260,17,220,176,396,False,1,11
17261,18,152,160,312,False,1,11
17262,19,122,133,255,False,1,11
17263,20,72,115,187,False,1,11
17264,21,56,83,139,False,1,11
17265,22,44,96,140,False,1,11
17266,23,21,23,44,False,1,11
17267,0,13,17,30,False,2,11
17268,1,4,12,16,False,2,11
17269,2,5,12,17,False,2,11
17270,3,7,8,15,False,2,11
17271,4,17,13,30,False,2,11
17272,5,125,59,184,False,2,11
17273,6,239,153,392,False,2,11
17274,7,389,200,589,False,2,11
17275,8,302,177,479,False,2,11
17276,9,221,181,402,False,2,11
17277,10,226,184,410,False,2,11
17278,11,254,209,463,False,2,11
17279,12,229,231,460,False,2,11
17280,13,243,247,490,False,2,11
17281,14,260,341,601,False,2,11
17282,15,245,300,545,False,2,11
17283,16,182,175,357,False,2,11
17284,17,177,159,336,False,2,11
17285,18,152,139,291,False,2,11
17286,19,111,121,232,False,2,11
17287,20,103,146,249,False,2,11
17288,21,68,128,196,False,2,11
17289,22,30,57,87,False,2,11
17290,23,20,40,60,False,2,11
17291,0,19,22,41,False,3,11
17292,1,6,18,24,False,3,11
17293,2,11,28,39,False,3,11
17294,3,7,11,18,False,3,11
17295,4,15,13,28,False,3,11
17296,5,114,50,164,False,3,11
17297,6,257,170,427,False,3,11
17298,7,445,326,771,False,3,11
17299,8,287,223,510,False,3,11
17300,9,244,167,411,False,3,11
17301,10,256,199,455,False,3,11
17302,11,212,222,434,False,3,11
17303,12,245,225,470,False,3,11
17304,13,251,260,511,False,3,11
17305,14,275,379,654,False,3,11
17306,15,246,327,573,False,3,11
17307,16,229,197,426,False,3,11
17308,17,202,195,397,False,3,11
17309,18,151,171,322,False,3,11
17310,19,125,137,262,False,3,11
17311,20,84,132,216,False,3,11
17312,21,73,380,453,False,3,11
17313,22,31,73,104,False,3,11
17314,23,18,29,47,False,3,11
17315,0,18,36,54,False,4,11
17316,1,10,25,35,False,4,11
17317,2,11,23,34,False,4,11
17318,3,9,15,24,False,4,11
17319,4,24,19,43,False,4,11
17320,5,106,60,166,False,4,11
17321,6,257,147,404,False,4,11
17322,7,394,228,622,False,4,11
17323,8,284,215,499,False,4,11
17324,9,272,169,441,False,4,11
17325,10,233,200,433,False,4,11
17326,11,239,199,438,False,4,11
17327,12,250,261,511,False,4,11
17328,13,290,311,601,False,4,11
17329,14,353,444,797,False,4,11
17330,15,267,342,609,False,4,11
17331,16,200,199,399,False,4,11
17332,17,195,179,374,False,4,11
17333,18,141,175,316,False,4,11
17334,19,95,159,254,False,4,11
17335,20,82,87,169,False,4,11
17336,21,67,80,147,False,4,11
17337,22,50,91,141,False,4,11
17338,23,48,72,120,False,4,11
17339,0,36,59,95,False,5,11
17340,1,31,44,75,False,5,11
17341,2,25,37,62,False,5,11
17342,3,19,44,63,False,5,11
17343,4,20,21,41,False,5,11
17344,5,11,8,19,False,5,11
17345,6,31,19,50,False,5,11
17346,7,47,34,81,False,5,11
17347,8,76,66,142,False,5,11
17348,9,116,85,201,False,5,11
17349,10,170,97,267,False,5,11
17350,11,189,137,326,False,5,11
17351,12,198,180,378,False,5,11
17352,13,189,206,395,False,5,11
17353,14,159,229,388,False,5,11
17354,15,148,199,347,False,5,11
17355,16,148,170,318,False,5,11
17356,17,143,173,316,False,5,11
17357,18,115,133,248,False,5,11
17358,19,80,105,185,False,5,11
17359,20,50,88,138,False,5,11
17360,21,67,73,140,False,5,11
17361,22,53,57,110,False,5,11
17362,23,45,68,113,False,5,11
17363,0,43,59,102,True,6,11
17364,1,34,52,86,True,6,11
17365,2,36,46,82,True,6,11
17366,3,20,43,63,True,6,11
17367,4,17,24,41,True,6,11
17368,5,18,11,29,True,6,11
17369,6,21,27,48,True,6,11
17370,7,29,21,50,True,6,11
17371,8,47,40,87,True,6,11
17372,9,92,62,154,True,6,11
17373,10,120,89,209,True,6,11
17374,11,153,111,264,True,6,11
17375,12,177,161,338,True,6,11
17376,13,219,173,392,True,6,11
17377,14,152,158,310,True,6,11
17378,15,138,177,315,True,6,11
17379,16,145,165,310,True,6,11
17380,17,136,158,294,True,6,11
17381,18,145,150,295,True,6,11
17382,19,102,129,231,True,6,11
17383,20,60,98,158,True,6,11
17384,21,46,80,126,True,6,11
17385,22,44,48,92,True,6,11
17386,23,20,29,49,True,6,11
17387,0,10,18,28,False,0,11
17388,1,10,22,32,False,0,11
17389,2,8,14,22,False,0,11
17390,3,22,12,34,False,0,11
17391,4,20,11,31,False,0,11
17392,5,117,66,183,False,0,11
17393,6,258,151,409,False,0,11
17394,7,384,197,581,False,0,11
17395,8,275,175,450,False,0,11
17396,9,227,189,416,False,0,11
17397,10,196,183,379,False,0,11
17398,11,229,203,432,False,0,11
17399,12,224,181,405,False,0,11
17400,13,225,253,478,False,0,11
17401,14,237,325,562,False,0,11
17402,15,233,319,552,False,0,11
17403,16,217,192,409,False,0,11
17404,17,191,161,352,False,0,11
17405,18,127,143,270,False,0,11
17406,19,111,138,249,False,0,11
17407,20,66,120,186,False,0,11
17408,21,79,103,182,False,0,11
17409,22,47,70,117,False,0,11
17410,23,16,24,40,False,0,11
17411,0,13,13,26,False,1,11
17412,1,9,17,26,False,1,11
17413,2,13,12,25,False,1,11
17414,3,14,13,27,False,1,11
17415,4,17,16,33,False,1,11
17416,5,113,56,169,False,1,11
17417,6,235,155,390,False,1,11
17418,7,413,200,613,False,1,11
17419,8,250,185,435,False,1,11
17420,9,226,165,391,False,1,11
17421,10,243,203,446,False,1,11
17422,11,235,210,445,False,1,11
17423,12,260,227,487,False,1,11
17424,13,212,246,458,False,1,11
17425,14,249,333,582,False,1,11
17426,15,252,277,529,False,1,11
17427,16,192,182,374,False,1,11
17428,17,181,167,348,False,1,11
17429,18,152,156,308,False,1,11
17430,19,124,133,257,False,1,11
17431,20,88,140,228,False,1,11
17432,21,66,379,445,False,1,11
17433,22,31,267,298,False,1,11
17434,23,16,60,76,False,1,11
17435,0,18,20,38,False,2,11
17436,1,12,34,46,False,2,11
17437,2,11,24,35,False,2,11
17438,3,18,16,34,False,2,11
17439,4,14,21,35,False,2,11
17440,5,107,44,151,False,2,11
17441,6,244,162,406,False,2,11
17442,7,374,183,557,False,2,11
17443,8,306,174,480,False,2,11
17444,9,251,184,435,False,2,11
17445,10,235,194,429,False,2,11
17446,11,253,197,450,False,2,11
17447,12,244,245,489,False,2,11
17448,13,235,274,509,False,2,11
17449,14,265,307,572,False,2,11
17450,15,221,292,513,False,2,11
17451,16,206,188,394,False,2,11
17452,17,179,171,350,False,2,11
17453,18,157,161,318,False,2,11
17454,19,123,121,244,False,2,11
17455,20,62,119,181,False,2,11
17456,21,69,124,193,False,2,11
17457,22,41,74,115,False,2,11
17458,23,27,49,76,False,2,11
17459,0,15,31,46,False,3,11
17460,1,10,32,42,False,3,11
17461,2,13,30,43,False,3,11
17462,3,12,16,28,False,3,11
17463,4,19,19,38,False,3,11
17464,5,101,54,155,False,3,11
17465,6,259,139,398,False,3,11
17466,7,427,190,617,False,3,11
17467,8,269,178,447,False,3,11
17468,9,252,216,468,False,3,11
17469,10,247,191,438,False,3,11
17470,11,264,247,511,False,3,11
17471,12,236,235,471,False,3,11
17472,13,272,264,536,False,3,11
17473,14,264,366,630,False,3,11
17474,15,290,351,641,False,3,11
17475,16,216,225,441,False,3,11
17476,17,203,174,377,False,3,11
17477,18,149,166,315,False,3,11
17478,19,129,152,281,False,3,11
17479,20,88,119,207,False,3,11
17480,21,64,117,181,False,3,11
17481,22,48,91,139,False,3,11
17482,23,30,60,90,False,3,11
17483,0,25,49,74,False,4,11
17484,1,19,39,58,False,4,11
17485,2,13,34,47,False,4,11
17486,3,13,20,33,False,4,11
17487,4,17,16,33,False,4,11
17488,5,112,52,164,False,4,11
17489,6,217,149,366,False,4,11
17490,7,356,199,555,False,4,11
17491,8,294,180,474,False,4,11
17492,9,259,183,442,False,4,11
17493,10,265,206,471,False,4,11
17494,11,275,256,531,False,4,11
17495,12,288,266,554,False,4,11
17496,13,304,292,596,False,4,11
17497,14,280,384,664,False,4,11
17498,15,240,294,534,False,4,11
17499,16,191,204,395,False,4,11
17500,17,165,171,336,False,4,11
17501,18,148,167,315,False,4,11
17502,19,133,156,289,False,4,11
17503,20,50,103,153,False,4,11
17504,21,64,99,163,False,4,11
17505,22,41,84,125,False,4,11
17506,23,38,64,102,False,4,11
17507,0,35,41,76,False,5,11
17508,1,27,51,78,False,5,11
17509,2,21,43,64,False,5,11
17510,3,14,33,47,False,5,11
17511,4,14,19,33,False,5,11
17512,5,23,14,37,False,5,11
17513,6,33,19,52,False,5,11
17514,7,31,30,61,False,5,11
17515,8,50,37,87,False,5,11
17516,9,106,76,182,False,5,11
17517,10,137,113,250,False,5,11
17518,11,202,153,355,False,5,11
17519,12,345,198,543,False,5,11
17520,13,384,218,602,False,5,11
17521,14,284,249,533,False,5,11
17522,15,174,227,401,False,5,11
17523,16,148,201,349,False,5,11
17524,17,135,145,280,False,5,11
17525,18,102,166,268,False,5,11
17526,19,98,125,223,False,5,11
17527,20,69,95,164,False,5,11
17528,21,52,73,125,False,5,11
17529,22,54,70,124,False,5,11
17530,23,42,75,117,False,5,11
17531,0,43,59,102,True,6,11
17532,1,31,46,77,True,6,11
17533,2,28,54,82,True,6,11
17534,3,26,48,74,True,6,11
17535,4,18,23,41,True,6,11
17536,5,20,18,38,True,6,11
17537,6,15,13,28,True,6,11
17538,7,28,14,42,True,6,11
17539,8,61,38,99,True,6,11
17540,9,81,57,138,True,6,11
17541,10,130,80,210,True,6,11
17542,11,172,168,340,True,6,11
17543,12,231,185,416,True,6,11
17544,13,204,175,379,True,6,11
17545,14,174,168,342,True,6,11
17546,15,182,240,422,True,6,11
17547,16,160,165,325,True,6,11
17548,17,102,118,220,True,6,11
17549,18,148,174,322,True,6,11
17550,19,135,152,287,True,6,11
17551,20,89,111,200,True,6,11
17552,21,72,79,151,True,6,11
17553,22,34,37,71,True,6,11
17554,23,26,25,51,True,6,11
17555,0,9,15,24,False,0,11
17556,1,9,11,20,False,0,11
17557,2,4,10,14,False,0,11
17558,3,6,11,17,False,0,11
17559,4,19,16,35,False,0,11
17560,5,95,58,153,False,0,11
17561,6,222,138,360,False,0,11
17562,7,412,191,603,False,0,11
17563,8,272,162,434,False,0,11
17564,9,241,195,436,False,0,11
17565,10,231,197,428,False,0,11
17566,11,238,234,472,False,0,11
17567,12,236,213,449,False,0,11
17568,13,251,266,517,False,0,11
17569,14,265,351,616,False,0,11
17570,15,261,393,654,False,0,11
17571,16,187,206,393,False,0,11
17572,17,156,148,304,False,0,11
17573,18,115,148,263,False,0,11
17574,19,121,128,249,False,0,11
17575,20,85,107,192,False,0,11
17576,21,64,63,127,False,0,11
17577,22,29,65,94,False,0,11
17578,23,26,68,94,False,0,11
17579,0,16,26,42,False,1,11
17580,1,18,21,39,False,1,11
17581,2,4,11,15,False,1,11
17582,3,16,12,28,False,1,11
17583,4,22,11,33,False,1,11
17584,5,111,55,166,False,1,11
17585,6,222,141,363,False,1,11
17586,7,380,189,569,False,1,11
17587,8,278,149,427,False,1,11
17588,9,231,186,417,False,1,11
17589,10,277,219,496,False,1,11
17590,11,224,236,460,False,1,11
17591,12,238,257,495,False,1,11
17592,13,275,294,569,False,1,11
17593,14,279,396,675,False,1,11
17594,15,262,333,595,False,1,11
17595,16,187,182,369,False,1,11
17596,17,161,164,325,False,1,11
17597,18,135,151,286,False,1,11
17598,19,109,189,298,False,1,11
17599,20,81,123,204,False,1,11
17600,21,71,85,156,False,1,11
17601,22,36,51,87,False,1,11
17602,23,30,27,57,False,1,11
17603,0,18,25,43,False,2,11
17604,1,13,22,35,False,2,11
17605,2,6,21,27,False,2,11
17606,3,16,15,31,False,2,11
17607,4,20,18,38,False,2,11
17608,5,109,46,155,False,2,11
17609,6,243,136,379,False,2,11
17610,7,366,178,544,False,2,11
17611,8,278,148,426,False,2,11
17612,9,244,215,459,False,2,11
17613,10,250,213,463,False,2,11
17614,11,274,233,507,False,2,11
17615,12,259,270,529,False,2,11
17616,13,283,366,649,False,2,11
17617,14,267,369,636,False,2,11
17618,15,282,340,622,False,2,11
17619,16,195,225,420,False,2,11
17620,17,166,175,341,False,2,11
17621,18,146,153,299,False,2,11
17622,19,110,202,312,False,2,11
17623,20,100,106,206,False,2,11
17624,21,69,89,158,False,2,11
17625,22,45,71,116,False,2,11
17626,23,33,40,73,False,2,11
17627,0,21,42,63,False,3,11
17628,1,13,45,58,False,3,11
17629,2,14,32,46,False,3,11
17630,3,16,21,37,False,3,11
17631,4,14,23,37,False,3,11
17632,5,96,45,141,False,3,11
17633,6,209,120,329,False,3,11
17634,7,262,155,417,False,3,11
17635,8,257,144,401,False,3,11
17636,9,278,202,480,False,3,11
17637,10,280,213,493,False,3,11
17638,11,286,242,528,False,3,11
17639,12,275,262,537,False,3,11
17640,13,304,325,629,False,3,11
17641,14,284,392,676,False,3,11
17642,15,238,344,582,False,3,11
17643,16,219,235,454,False,3,11
17644,17,181,191,372,False,3,11
17645,18,134,191,325,False,3,11
17646,19,129,168,297,False,3,11
17647,20,103,114,217,False,3,11
17648,21,85,471,556,False,3,11
17649,22,34,478,512,False,3,11
17650,23,38,167,205,False,3,11
17651,0,22,33,55,False,4,11
17652,1,13,24,37,False,4,11
17653,2,12,32,44,False,4,11
17654,3,15,22,37,False,4,11
17655,4,19,18,37,False,4,11
17656,5,90,40,130,False,4,11
17657,6,171,109,280,False,4,11
17658,7,223,121,344,False,4,11
17659,8,213,147,360,False,4,11
17660,9,211,185,396,False,4,11
17661,10,277,213,490,False,4,11
17662,11,264,254,518,False,4,11
17663,12,290,236,526,False,4,11
17664,13,289,335,624,False,4,11
17665,14,353,391,744,False,4,11
17666,15,195,289,484,False,4,11
17667,16,170,171,341,False,4,11
17668,17,154,143,297,False,4,11
17669,18,139,140,279,False,4,11
17670,19,96,121,217,False,4,11
17671,20,69,92,161,False,4,11
17672,21,56,63,119,False,4,11
17673,22,52,67,119,False,4,11
17674,23,41,59,100,False,4,11
17675,0,26,31,57,False,5,11
17676,1,23,29,52,False,5,11
17677,2,18,38,56,False,5,11
17678,3,21,31,52,False,5,11
17679,4,15,20,35,False,5,11
17680,5,20,15,35,False,5,11
17681,6,20,22,42,False,5,11
17682,7,22,33,55,False,5,11
17683,8,50,44,94,False,5,11
17684,9,83,78,161,False,5,11
17685,10,115,105,220,False,5,11
17686,11,176,162,338,False,5,11
17687,12,179,150,329,False,5,11
17688,13,180,177,357,False,5,11
17689,14,170,175,345,False,5,11
17690,15,124,135,259,False,5,11
17691,16,123,130,253,False,5,11
17692,17,111,122,233,False,5,11
17693,18,80,94,174,False,5,11
17694,19,82,74,156,False,5,11
17695,20,61,71,132,False,5,11
17696,21,55,63,118,False,5,11
17697,22,36,44,80,False,5,11
17698,23,17,37,54,False,5,11
17699,0,13,22,35,True,6,11
17700,1,12,11,23,True,6,11
17701,2,8,12,20,True,6,11
17702,3,7,10,17,True,6,11
17703,4,8,6,14,True,6,11
17704,5,12,4,16,True,6,11
17705,6,13,15,28,True,6,11
17706,7,22,12,34,True,6,11
17707,8,28,35,63,True,6,11
17708,9,73,50,123,True,6,11
17709,10,110,89,199,True,6,11
17710,11,108,127,235,True,6,11
17711,12,152,111,263,True,6,11
17712,13,152,130,282,True,6,11
17713,14,163,137,300,True,6,11
17714,15,154,139,293,True,6,11
17715,16,83,80,163,True,6,11
17716,17,49,42,91,True,6,11
17717,18,25,37,62,True,6,11
17718,19,59,40,99,True,6,11
17719,20,44,61,105,True,6,11
17720,21,76,125,201,True,6,11
17721,22,87,64,151,True,6,11
17722,23,66,62,128,True,6,11
17723,0,27,36,63,True,0,11
17724,1,12,18,30,True,0,11
17725,2,7,9,16,True,0,11
17726,3,8,6,14,True,0,11
17727,4,4,5,9,True,0,11
17728,5,10,7,17,True,0,11
17729,6,11,12,23,True,0,11
17730,7,11,11,22,True,0,11
17731,8,10,10,20,True,0,11
17732,9,30,23,53,True,0,11
17733,10,45,30,75,True,0,11
17734,11,59,93,152,True,0,11
17735,12,95,100,195,True,0,11
17736,13,137,124,261,True,0,11
17737,14,111,97,208,True,0,11
17738,15,82,125,207,True,0,11
17739,16,98,78,176,True,0,11
17740,17,80,80,160,True,0,11
17741,18,71,69,140,True,0,11
17742,19,66,86,152,True,0,11
17743,20,62,68,130,True,0,11
17744,21,45,69,114,True,0,11
17745,22,28,31,59,True,0,11
17746,23,14,25,39,True,0,11
17747,0,16,24,40,True,1,11
17748,1,19,17,36,True,1,11
17749,2,10,16,26,True,1,11
17750,3,5,16,21,True,1,11
17751,4,6,7,13,True,1,11
17752,5,10,13,23,True,1,11
17753,6,14,10,24,True,1,11
17754,7,13,15,28,True,1,11
17755,8,22,21,43,True,1,11
17756,9,33,28,61,True,1,11
17757,10,68,58,126,True,1,11
17758,11,75,94,169,True,1,11
17759,12,97,105,202,True,1,11
17760,13,109,131,240,True,1,11
17761,14,121,137,258,True,1,11
17762,15,108,111,219,True,1,11
17763,16,90,104,194,True,1,11
17764,17,102,99,201,True,1,11
17765,18,113,132,245,True,1,11
17766,19,120,117,237,True,1,11
17767,20,84,100,184,True,1,11
17768,21,61,58,119,True,1,11
17769,22,35,52,87,True,1,11
17770,23,26,44,70,True,1,11
17771,0,22,33,55,True,2,11
17772,1,22,44,66,True,2,11
17773,2,18,38,56,True,2,11
17774,3,19,43,62,True,2,11
17775,4,21,29,50,True,2,11
17776,5,53,33,86,True,2,11
17777,6,73,66,139,True,2,11
17778,7,99,67,166,True,2,11
17779,8,119,70,189,True,2,11
17780,9,120,80,200,True,2,11
17781,10,134,95,229,True,2,11
17782,11,167,149,316,True,2,11
17783,12,193,154,347,True,2,11
17784,13,193,206,399,True,2,11
17785,14,183,169,352,True,2,11
17786,15,150,159,309,True,2,11
17787,16,126,156,282,True,2,11
17788,17,119,95,214,True,2,11
17789,18,91,89,180,True,2,11
17790,19,88,100,188,True,2,11
17791,20,59,79,138,True,2,11
17792,21,44,68,112,True,2,11
17793,22,41,50,91,True,2,11
17794,23,26,38,64,True,2,11
17795,0,16,18,34,True,3,11
17796,1,14,25,39,True,3,11
17797,2,11,17,28,True,3,11
17798,3,7,21,28,True,3,11
17799,4,16,16,32,True,3,11
17800,5,42,21,63,True,3,11
17801,6,89,56,145,True,3,11
17802,7,92,72,164,True,3,11
17803,8,115,78,193,True,3,11
17804,9,111,71,182,True,3,11
17805,10,165,109,274,True,3,11
17806,11,143,115,258,True,3,11
17807,12,172,148,320,True,3,11
17808,13,201,169,370,True,3,11
17809,14,156,194,350,True,3,11
17810,15,146,147,293,True,3,11
17811,16,155,137,292,True,3,11
17812,17,112,118,230,True,3,11
17813,18,126,115,241,True,3,11
17814,19,68,132,200,True,3,11
17815,20,70,88,158,True,3,11
17816,21,36,63,99,True,3,11
17817,22,37,45,82,True,3,11
17818,23,26,35,61,True,3,11
17819,0,22,37,59,True,4,11
17820,1,15,18,33,True,4,11
17821,2,12,24,36,True,4,11
17822,3,8,16,24,True,4,11
17823,4,13,14,27,True,4,11
17824,5,47,19,66,True,4,11
17825,6,72,53,125,True,4,11
17826,7,94,64,158,True,4,11
17827,8,112,75,187,True,4,11
17828,9,129,87,216,True,4,11
17829,10,149,114,263,True,4,11
17830,11,165,156,321,True,4,11
17831,12,197,162,359,True,4,11
17832,13,178,177,355,True,4,11
17833,14,166,176,342,True,4,11
17834,15,105,140,245,True,4,11
17835,16,129,101,230,True,4,11
17836,17,107,87,194,True,4,11
17837,18,110,88,198,True,4,11
17838,19,76,87,163,True,4,11
17839,20,53,86,139,True,4,11
17840,21,48,82,130,True,4,11
17841,22,37,60,97,True,4,11
17842,23,26,32,58,True,4,11
17843,0,24,42,66,True,5,11
17844,1,24,31,55,True,5,11
17845,2,22,37,59,True,5,11
17846,3,10,29,39,True,5,11
17847,4,8,11,19,True,5,11
17848,5,13,12,25,True,5,11
17849,6,21,22,43,True,5,11
17850,7,21,20,41,True,5,11
17851,8,38,27,65,True,5,11
17852,9,59,50,109,True,5,11
17853,10,86,59,145,True,5,11
17854,11,99,95,194,True,5,11
17855,12,134,94,228,True,5,11
17856,13,107,117,224,True,5,11
17857,14,125,142,267,True,5,11
17858,15,111,123,234,True,5,11
17859,16,132,100,232,True,5,11
17860,17,96,86,182,True,5,11
17861,18,88,82,170,True,5,11
17862,19,67,97,164,True,5,11
17863,20,67,65,132,True,5,11
17864,21,42,60,102,True,5,11
17865,22,44,55,99,True,5,11
17866,23,29,61,90,True,5,11
17867,0,19,28,47,True,6,11
17868,1,17,26,43,True,6,11
17869,2,22,39,61,True,6,11
17870,3,8,19,27,True,6,11
17871,4,7,7,14,True,6,11
17872,5,9,8,17,True,6,11
17873,6,6,12,18,True,6,11
17874,7,22,13,35,True,6,11
17875,8,23,32,55,True,6,11
17876,9,42,39,81,True,6,11
17877,10,39,42,81,True,6,11
17878,11,92,107,199,True,6,11
17879,12,130,113,243,True,6,11
17880,13,137,125,262,True,6,11
17881,14,126,148,274,True,6,11
17882,15,126,155,281,True,6,11
17883,16,127,125,252,True,6,11
17884,17,114,100,214,True,6,11
17885,18,80,94,174,True,6,11
17886,19,80,81,161,True,6,11
17887,20,63,71,134,True,6,11
17888,21,62,71,133,True,6,11
17889,22,61,44,105,True,6,11
17890,23,48,96,144,True,6,11
17891,0,71,81,152,True,0,0
17892,1,68,73,141,True,0,0
17893,2,41,61,102,True,0,0
17894,3,35,46,81,True,0,0
17895,4,22,31,53,True,0,0
17896,5,23,30,53,True,0,0
17897,6,20,28,48,True,0,0
17898,7,15,12,27,True,0,0
17899,8,19,13,32,True,0,0
17900,9,26,12,38,True,0,0
17901,10,32,34,66,True,0,0
17902,11,57,66,123,True,0,0
17903,12,77,73,150,True,0,0
17904,13,120,93,213,True,0,0
17905,14,112,140,252,True,0,0
17906,15,126,129,255,True,0,0
17907,16,117,115,232,True,0,0
17908,17,110,109,219,True,0,0
17909,18,104,110,214,True,0,0
17910,19,87,94,181,True,0,0
17911,20,80,79,159,True,0,0
17912,21,37,48,85,True,0,0
17913,22,26,22,48,True,0,0
17914,23,19,18,37,True,0,0
17915,0,12,22,34,False,1,0
17916,1,9,17,26,False,1,0
17917,2,8,5,13,False,1,0
17918,3,4,5,9,False,1,0
17919,4,22,6,28,False,1,0
17920,5,117,53,170,False,1,0
17921,6,228,138,366,False,1,0
17922,7,351,174,525,False,1,0
17923,8,199,127,326,False,1,0
17924,9,180,131,311,False,1,0
17925,10,178,129,307,False,1,0
17926,11,208,153,361,False,1,0
17927,12,195,172,367,False,1,0
17928,13,180,223,403,False,1,0
17929,14,204,320,524,False,1,0
17930,15,207,257,464,False,1,0
17931,16,121,165,286,False,1,0
17932,17,144,107,251,False,1,0
17933,18,108,115,223,False,1,0
17934,19,86,96,182,False,1,0
17935,20,73,80,153,False,1,0
17936,21,61,66,127,False,1,0
17937,22,34,45,79,False,1,0
17938,23,16,23,39,False,1,0
17939,0,12,24,36,False,2,0
17940,1,7,10,17,False,2,0
17941,2,1,7,8,False,2,0
17942,3,9,9,18,False,2,0
17943,4,23,13,36,False,2,0
17944,5,106,38,144,False,2,0
17945,6,233,131,364,False,2,0
17946,7,379,183,562,False,2,0
17947,8,210,132,342,False,2,0
17948,9,202,141,343,False,2,0
17949,10,216,174,390,False,2,0
17950,11,191,204,395,False,2,0
17951,12,218,185,403,False,2,0
17952,13,230,240,470,False,2,0
17953,14,205,329,534,False,2,0
17954,15,207,269,476,False,2,0
17955,16,139,169,308,False,2,0
17956,17,145,134,279,False,2,0
17957,18,110,134,244,False,2,0
17958,19,92,114,206,False,2,0
17959,20,82,99,181,False,2,0
17960,21,53,64,117,False,2,0
17961,22,25,40,65,False,2,0
17962,23,17,27,44,False,2,0
17963,0,19,21,40,False,3,0
17964,1,7,9,16,False,3,0
17965,2,3,13,16,False,3,0
17966,3,8,9,17,False,3,0
17967,4,10,10,20,False,3,0
17968,5,97,43,140,False,3,0
17969,6,238,132,370,False,3,0
17970,7,392,172,564,False,3,0
17971,8,231,159,390,False,3,0
17972,9,207,144,351,False,3,0
17973,10,215,138,353,False,3,0
17974,11,199,176,375,False,3,0
17975,12,203,206,409,False,3,0
17976,13,223,261,484,False,3,0
17977,14,205,331,536,False,3,0
17978,15,196,292,488,False,3,0
17979,16,184,183,367,False,3,0
17980,17,172,137,309,False,3,0
17981,18,109,128,237,False,3,0
17982,19,105,127,232,False,3,0
17983,20,74,129,203,False,3,0
17984,21,51,80,131,False,3,0
17985,22,30,53,83,False,3,0
17986,23,20,26,46,False,3,0
17987,0,13,23,36,False,4,0
17988,1,11,23,34,False,4,0
17989,2,5,20,25,False,4,0
17990,3,7,12,19,False,4,0
17991,4,19,13,32,False,4,0
17992,5,101,44,145,False,4,0
17993,6,231,138,369,False,4,0
17994,7,367,168,535,False,4,0
17995,8,270,169,439,False,4,0
17996,9,217,151,368,False,4,0
17997,10,215,163,378,False,4,0
17998,11,182,190,372,False,4,0
17999,12,214,204,418,False,4,0
18000,13,245,267,512,False,4,0
18001,14,253,373,626,False,4,0
18002,15,205,278,483,False,4,0
18003,16,150,172,322,False,4,0
18004,17,138,137,275,False,4,0
18005,18,120,109,229,False,4,0
18006,19,80,103,183,False,4,0
18007,20,76,63,139,False,4,0
18008,21,46,53,99,False,4,0
18009,22,58,63,121,False,4,0
18010,23,26,50,76,False,4,0
18011,0,16,28,44,False,5,0
18012,1,23,49,72,False,5,0
18013,2,16,35,51,False,5,0
18014,3,19,16,35,False,5,0
18015,4,8,7,15,False,5,0
18016,5,12,13,25,False,5,0
18017,6,24,18,42,False,5,0
18018,7,37,32,69,False,5,0
18019,8,44,33,77,False,5,0
18020,9,84,59,143,False,5,0
18021,10,113,82,195,False,5,0
18022,11,126,117,243,False,5,0
18023,12,138,145,283,False,5,0
18024,13,156,130,286,False,5,0
18025,14,161,170,331,False,5,0
18026,15,150,140,290,False,5,0
18027,16,112,135,247,False,5,0
18028,17,141,156,297,False,5,0
18029,18,111,120,231,False,5,0
18030,19,81,84,165,False,5,0
18031,20,73,69,142,False,5,0
18032,21,52,62,114,False,5,0
18033,22,60,71,131,False,5,0
18034,23,42,64,106,False,5,0
18035,0,33,38,71,True,6,0
18036,1,32,52,84,True,6,0
18037,2,30,53,83,True,6,0
18038,3,20,48,68,True,6,0
18039,4,15,8,23,True,6,0
18040,5,14,18,32,True,6,0
18041,6,11,16,27,True,6,0
18042,7,21,13,34,True,6,0
18043,8,42,21,63,True,6,0
18044,9,79,37,116,True,6,0
18045,10,89,57,146,True,6,0
18046,11,117,103,220,True,6,0
18047,12,130,112,242,True,6,0
18048,13,161,151,312,True,6,0
18049,14,174,193,367,True,6,0
18050,15,182,220,402,True,6,0
18051,16,138,167,305,True,6,0
18052,17,134,144,278,True,6,0
18053,18,145,158,303,True,6,0
18054,19,100,132,232,True,6,0
18055,20,81,96,177,True,6,0
18056,21,43,64,107,True,6,0
18057,22,27,44,71,True,6,0
18058,23,14,18,32,True,6,0
18059,0,5,20,25,False,0,0
18060,1,4,10,14,False,0,0
18061,2,9,9,18,False,0,0
18062,3,11,9,20,False,0,0
18063,4,16,17,33,False,0,0
18064,5,129,46,175,False,0,0
18065,6,250,144,394,False,0,0
18066,7,401,199,600,False,0,0
18067,8,244,161,405,False,0,0
18068,9,209,151,360,False,0,0
18069,10,200,175,375,False,0,0
18070,11,198,195,393,False,0,0
18071,12,218,218,436,False,0,0
18072,13,206,238,444,False,0,0
18073,14,230,313,543,False,0,0
18074,15,234,317,551,False,0,0
18075,16,185,190,375,False,0,0
18076,17,147,135,282,False,0,0
18077,18,121,126,247,False,0,0
18078,19,104,126,230,False,0,0
18079,20,86,113,199,False,0,0
18080,21,51,87,138,False,0,0
18081,22,26,43,69,False,0,0
18082,23,19,31,50,False,0,0
18083,0,7,16,23,False,1,0
18084,1,3,11,14,False,1,0
18085,2,4,14,18,False,1,0
18086,3,7,9,16,False,1,0
18087,4,18,15,33,False,1,0
18088,5,105,46,151,False,1,0
18089,6,242,158,400,False,1,0
18090,7,393,207,600,False,1,0
18091,8,246,159,405,False,1,0
18092,9,200,161,361,False,1,0
18093,10,230,182,412,False,1,0
18094,11,203,201,404,False,1,0
18095,12,231,173,404,False,1,0
18096,13,219,264,483,False,1,0
18097,14,236,369,605,False,1,0
18098,15,244,304,548,False,1,0
18099,16,173,191,364,False,1,0
18100,17,160,148,308,False,1,0
18101,18,137,127,264,False,1,0
18102,19,105,130,235,False,1,0
18103,20,79,116,195,False,1,0
18104,21,47,110,157,False,1,0
18105,22,35,48,83,False,1,0
18106,23,16,19,35,False,1,0
18107,0,10,18,28,False,2,0
18108,1,8,20,28,False,2,0
18109,2,3,17,20,False,2,0
18110,3,6,11,17,False,2,0
18111,4,18,17,35,False,2,0
18112,5,103,48,151,False,2,0
18113,6,269,156,425,False,2,0
18114,7,374,199,573,False,2,0
18115,8,242,150,392,False,2,0
18116,9,205,174,379,False,2,0
18117,10,218,190,408,False,2,0
18118,11,218,184,402,False,2,0
18119,12,205,207,412,False,2,0
18120,13,233,229,462,False,2,0
18121,14,214,360,574,False,2,0
18122,15,235,322,557,False,2,0
18123,16,185,183,368,False,2,0
18124,17,176,157,333,False,2,0
18125,18,130,120,250,False,2,0
18126,19,117,121,238,False,2,0
18127,20,79,124,203,False,2,0
18128,21,70,80,150,False,2,0
18129,22,37,82,119,False,2,0
18130,23,11,61,72,False,2,0
18131,0,13,29,42,False,3,0
18132,1,3,11,14,False,3,0
18133,2,12,11,23,False,3,0
18134,3,7,13,20,False,3,0
18135,4,21,15,36,False,3,0
18136,5,105,39,144,False,3,0
18137,6,240,156,396,False,3,0
18138,7,369,197,566,False,3,0
18139,8,253,148,401,False,3,0
18140,9,207,179,386,False,3,0
18141,10,219,191,410,False,3,0
18142,11,198,212,410,False,3,0
18143,12,206,235,441,False,3,0
18144,13,235,242,477,False,3,0
18145,14,244,318,562,False,3,0
18146,15,221,281,502,False,3,0
18147,16,173,173,346,False,3,0
18148,17,178,153,331,False,3,0
18149,18,147,141,288,False,3,0
18150,19,101,137,238,False,3,0
18151,20,82,104,186,False,3,0
18152,21,69,99,168,False,3,0
18153,22,49,62,111,False,3,0
18154,23,27,27,54,False,3,0
18155,0,11,14,25,False,4,0
18156,1,9,21,30,False,4,0
18157,2,12,15,27,False,4,0
18158,3,13,16,29,False,4,0
18159,4,17,17,34,False,4,0
18160,5,111,41,152,False,4,0
18161,6,250,137,387,False,4,0
18162,7,342,189,531,False,4,0
18163,8,242,169,411,False,4,0
18164,9,231,178,409,False,4,0
18165,10,222,139,361,False,4,0
18166,11,244,215,459,False,4,0
18167,12,240,235,475,False,4,0
18168,13,230,264,494,False,4,0
18169,14,223,316,539,False,4,0
18170,15,213,273,486,False,4,0
18171,16,169,177,346,False,4,0
18172,17,154,156,310,False,4,0
18173,18,127,121,248,False,4,0
18174,19,82,95,177,False,4,0
18175,20,83,73,156,False,4,0
18176,21,56,103,159,False,4,0
18177,22,59,60,119,False,4,0
18178,23,33,40,73,False,4,0
18179,0,20,37,57,False,5,0
18180,1,25,46,71,False,5,0
18181,2,18,47,65,False,5,0
18182,3,12,26,38,False,5,0
18183,4,8,13,21,False,5,0
18184,5,22,12,34,False,5,0
18185,6,35,19,54,False,5,0
18186,7,43,36,79,False,5,0
18187,8,54,58,112,False,5,0
18188,9,90,70,160,False,5,0
18189,10,95,79,174,False,5,0
18190,11,144,107,251,False,5,0
18191,12,151,127,278,False,5,0
18192,13,126,141,267,False,5,0
18193,14,147,194,341,False,5,0
18194,15,132,157,289,False,5,0
18195,16,122,138,260,False,5,0
18196,17,143,160,303,False,5,0
18197,18,100,127,227,False,5,0
18198,19,75,82,157,False,5,0
18199,20,61,79,140,False,5,0
18200,21,32,73,105,False,5,0
18201,22,50,75,125,False,5,0
18202,23,40,73,113,False,5,0
18203,0,40,45,85,True,6,0
18204,1,21,47,68,True,6,0
18205,2,28,63,91,True,6,0
18206,3,19,50,69,True,6,0
18207,4,9,22,31,True,6,0
18208,5,15,13,28,True,6,0
18209,6,16,11,27,True,6,0
18210,7,24,10,34,True,6,0
18211,8,42,33,75,True,6,0
18212,9,90,68,158,True,6,0
18213,10,127,72,199,True,6,0
18214,11,124,133,257,True,6,0
18215,12,158,161,319,True,6,0
18216,13,181,211,392,True,6,0
18217,14,157,173,330,True,6,0
18218,15,163,225,388,True,6,0
18219,16,161,185,346,True,6,0
18220,17,142,125,267,True,6,0
18221,18,161,162,323,True,6,0
18222,19,112,157,269,True,6,0
18223,20,75,104,179,True,6,0
18224,21,67,91,158,True,6,0
18225,22,26,48,74,True,6,0
18226,23,14,18,32,True,6,0
18227,0,6,13,19,False,0,0
18228,1,5,7,12,False,0,0
18229,2,6,7,13,False,0,0
18230,3,11,11,22,False,0,0
18231,4,19,13,32,False,0,0
18232,5,129,58,187,False,0,0
18233,6,276,168,444,False,0,0
18234,7,393,222,615,False,0,0
18235,8,294,161,455,False,0,0
18236,9,229,179,408,False,0,0
18237,10,225,178,403,False,0,0
18238,11,195,205,400,False,0,0
18239,12,240,204,444,False,0,0
18240,13,262,250,512,False,0,0
18241,14,250,351,601,False,0,0
18242,15,217,325,542,False,0,0
18243,16,195,211,406,False,0,0
18244,17,209,166,375,False,0,0
18245,18,124,162,286,False,0,0
18246,19,101,133,234,False,0,0
18247,20,83,117,200,False,0,0
18248,21,62,72,134,False,0,0
18249,22,41,55,96,False,0,0
18250,23,20,27,47,False,0,0
18251,0,7,13,20,False,1,0
18252,1,5,9,14,False,1,0
18253,2,1,7,8,False,1,0
18254,3,6,7,13,False,1,0
18255,4,13,15,28,False,1,0
18256,5,108,43,151,False,1,0
18257,6,276,140,416,False,1,0
18258,7,392,196,588,False,1,0
18259,8,253,161,414,False,1,0
18260,9,223,214,437,False,1,0
18261,10,260,164,424,False,1,0
18262,11,219,171,390,False,1,0
18263,12,213,209,422,False,1,0
18264,13,221,266,487,False,1,0
18265,14,259,340,599,False,1,0
18266,15,204,289,493,False,1,0
18267,16,180,235,415,False,1,0
18268,17,183,153,336,False,1,0
18269,18,145,150,295,False,1,0
18270,19,101,131,232,False,1,0
18271,20,86,120,206,False,1,0
18272,21,72,94,166,False,1,0
18273,22,26,72,98,False,1,0
18274,23,16,45,61,False,1,0
18275,0,18,20,38,False,2,0
18276,1,15,22,37,False,2,0
18277,2,11,12,23,False,2,0
18278,3,7,9,16,False,2,0
18279,4,20,10,30,False,2,0
18280,5,120,48,168,False,2,0
18281,6,248,154,402,False,2,0
18282,7,382,196,578,False,2,0
18283,8,250,179,429,False,2,0
18284,9,239,142,381,False,2,0
18285,10,217,199,416,False,2,0
18286,11,221,207,428,False,2,0
18287,12,218,218,436,False,2,0
18288,13,219,250,469,False,2,0
18289,14,240,311,551,False,2,0
18290,15,206,285,491,False,2,0
18291,16,186,189,375,False,2,0
18292,17,176,150,326,False,2,0
18293,18,149,134,283,False,2,0
18294,19,96,127,223,False,2,0
18295,20,74,106,180,False,2,0
18296,21,75,254,329,False,2,0
18297,22,38,201,239,False,2,0
18298,23,14,75,89,False,2,0
18299,0,16,41,57,False,3,0
18300,1,11,42,53,False,3,0
18301,2,7,22,29,False,3,0
18302,3,18,18,36,False,3,0
18303,4,18,17,35,False,3,0
18304,5,110,54,164,False,3,0
18305,6,251,137,388,False,3,0
18306,7,362,192,554,False,3,0
18307,8,259,181,440,False,3,0
18308,9,227,177,404,False,3,0
18309,10,217,190,407,False,3,0
18310,11,183,219,402,False,3,0
18311,12,187,194,381,False,3,0
18312,13,243,231,474,False,3,0
18313,14,286,418,704,False,3,0
18314,15,268,383,651,False,3,0
18315,16,167,178,345,False,3,0
18316,17,168,161,329,False,3,0
18317,18,141,141,282,False,3,0
18318,19,106,107,213,False,3,0
18319,20,84,116,200,False,3,0
18320,21,57,90,147,False,3,0
18321,22,40,61,101,False,3,0
18322,23,16,34,50,False,3,0
18323,0,15,32,47,False,4,0
18324,1,14,26,40,False,4,0
18325,2,16,23,39,False,4,0
18326,3,14,28,42,False,4,0
18327,4,18,14,32,False,4,0
18328,5,110,62,172,False,4,0
18329,6,251,154,405,False,4,0
18330,7,397,194,591,False,4,0
18331,8,258,150,408,False,4,0
18332,9,224,164,388,False,4,0
18333,10,233,168,401,False,4,0
18334,11,213,205,418,False,4,0
18335,12,224,193,417,False,4,0
18336,13,270,303,573,False,4,0
18337,14,265,335,600,False,4,0
18338,15,195,331,526,False,4,0
18339,16,162,164,326,False,4,0
18340,17,139,146,285,False,4,0
18341,18,103,112,215,False,4,0
18342,19,112,92,204,False,4,0
18343,20,63,89,152,False,4,0
18344,21,53,82,135,False,4,0
18345,22,53,77,130,False,4,0
18346,23,29,65,94,False,4,0
18347,0,29,55,84,False,5,0
18348,1,20,51,71,False,5,0
18349,2,15,47,62,False,5,0
18350,3,8,24,32,False,5,0
18351,4,15,13,28,False,5,0
18352,5,22,16,38,False,5,0
18353,6,32,18,50,False,5,0
18354,7,55,27,82,False,5,0
18355,8,63,42,105,False,5,0
18356,9,101,70,171,False,5,0
18357,10,127,113,240,False,5,0
18358,11,140,117,257,False,5,0
18359,12,148,124,272,False,5,0
18360,13,159,145,304,False,5,0
18361,14,141,196,337,False,5,0
18362,15,137,135,272,False,5,0
18363,16,127,132,259,False,5,0
18364,17,139,119,258,False,5,0
18365,18,117,105,222,False,5,0
18366,19,93,108,201,False,5,0
18367,20,42,63,105,False,5,0
18368,21,50,57,107,False,5,0
18369,22,41,85,126,False,5,0
18370,23,44,57,101,False,5,0
18371,0,26,53,79,True,6,0
18372,1,28,56,84,True,6,0
18373,2,32,56,88,True,6,0
18374,3,18,47,65,True,6,0
18375,4,12,25,37,True,6,0
18376,5,14,15,29,True,6,0
18377,6,18,23,41,True,6,0
18378,7,17,16,33,True,6,0
18379,8,33,31,64,True,6,0
18380,9,75,67,142,True,6,0
18381,10,97,61,158,True,6,0
18382,11,109,136,245,True,6,0
18383,12,138,151,289,True,6,0
18384,13,163,157,320,True,6,0
18385,14,163,157,320,True,6,0
18386,15,137,195,332,True,6,0
18387,16,144,152,296,True,6,0
18388,17,146,116,262,True,6,0
18389,18,146,146,292,True,6,0
18390,19,106,131,237,True,6,0
18391,20,78,111,189,True,6,0
18392,21,55,87,142,True,6,0
18393,22,32,58,90,True,6,0
18394,23,20,27,47,True,6,0
18395,0,6,21,27,False,0,0
18396,1,5,11,16,False,0,0
18397,2,5,9,14,False,0,0
18398,3,7,10,17,False,0,0
18399,4,24,14,38,False,0,0
18400,5,120,52,172,False,0,0
18401,6,212,163,375,False,0,0
18402,7,415,202,617,False,0,0
18403,8,283,184,467,False,0,0
18404,9,199,153,352,False,0,0
18405,10,201,173,374,False,0,0
18406,11,196,205,401,False,0,0
18407,12,215,194,409,False,0,0
18408,13,199,228,427,False,0,0
18409,14,244,328,572,False,0,0
18410,15,241,293,534,False,0,0
18411,16,216,207,423,False,0,0
18412,17,203,168,371,False,0,0
18413,18,132,135,267,False,0,0
18414,19,95,122,217,False,0,0
18415,20,78,119,197,False,0,0
18416,21,74,81,155,False,0,0
18417,22,39,57,96,False,0,0
18418,23,30,27,57,False,0,0
18419,0,9,12,21,False,1,0
18420,1,6,5,11,False,1,0
18421,2,2,7,9,False,1,0
18422,3,11,10,21,False,1,0
18423,4,21,15,36,False,1,0
18424,5,110,49,159,False,1,0
18425,6,249,136,385,False,1,0
18426,7,398,210,608,False,1,0
18427,8,258,164,422,False,1,0
18428,9,226,162,388,False,1,0
18429,10,455,200,655,False,1,0
18430,11,489,219,708,False,1,0
18431,12,221,221,442,False,1,0
18432,13,241,270,511,False,1,0
18433,14,247,359,606,False,1,0
18434,15,279,328,607,False,1,0
18435,16,191,215,406,False,1,0
18436,17,189,150,339,False,1,0
18437,18,145,147,292,False,1,0
18438,19,131,160,291,False,1,0
18439,20,85,113,198,False,1,0
18440,21,67,87,154,False,1,0
18441,22,41,47,88,False,1,0
18442,23,10,20,30,False,1,0
18443,0,9,26,35,False,2,0
18444,1,3,27,30,False,2,0
18445,2,7,33,40,False,2,0
18446,3,13,30,43,False,2,0
18447,4,19,37,56,False,2,0
18448,5,114,42,156,False,2,0
18449,6,258,164,422,False,2,0
18450,7,394,202,596,False,2,0
18451,8,237,137,374,False,2,0
18452,9,238,137,375,False,2,0
18453,10,233,204,437,False,2,0
18454,11,245,214,459,False,2,0
18455,12,226,215,441,False,2,0
18456,13,261,271,532,False,2,0
18457,14,231,324,555,False,2,0
18458,15,239,298,537,False,2,0
18459,16,207,207,414,False,2,0
18460,17,198,175,373,False,2,0
18461,18,138,158,296,False,2,0
18462,19,116,150,266,False,2,0
18463,20,90,129,219,False,2,0
18464,21,77,98,175,False,2,0
18465,22,44,46,90,False,2,0
18466,23,18,31,49,False,2,0
18467,0,13,16,29,False,3,0
18468,1,3,18,21,False,3,0
18469,2,7,23,30,False,3,0
18470,3,8,9,17,False,3,0
18471,4,17,12,29,False,3,0
18472,5,125,47,172,False,3,0
18473,6,251,175,426,False,3,0
18474,7,404,195,599,False,3,0
18475,8,262,167,429,False,3,0
18476,9,238,188,426,False,3,0
18477,10,214,175,389,False,3,0
18478,11,230,199,429,False,3,0
18479,12,234,204,438,False,3,0
18480,13,227,268,495,False,3,0
18481,14,260,354,614,False,3,0
18482,15,236,329,565,False,3,0
18483,16,194,225,419,False,3,0
18484,17,205,169,374,False,3,0
18485,18,157,171,328,False,3,0
18486,19,108,133,241,False,3,0
18487,20,81,111,192,False,3,0
18488,21,79,84,163,False,3,0
18489,22,29,55,84,False,3,0
18490,23,20,44,64,False,3,0
18491,0,12,27,39,False,4,0
18492,1,12,24,36,False,4,0
18493,2,10,31,41,False,4,0
18494,3,12,15,27,False,4,0
18495,4,20,10,30,False,4,0
18496,5,104,48,152,False,4,0
18497,6,237,165,402,False,4,0
18498,7,397,223,620,False,4,0
18499,8,278,156,434,False,4,0
18500,9,222,174,396,False,4,0
18501,10,251,194,445,False,4,0
18502,11,248,224,472,False,4,0
18503,12,202,204,406,False,4,0
18504,13,222,286,508,False,4,0
18505,14,261,362,623,False,4,0
18506,15,240,299,539,False,4,0
18507,16,167,192,359,False,4,0
18508,17,156,137,293,False,4,0
18509,18,113,156,269,False,4,0
18510,19,84,117,201,False,4,0
18511,20,80,84,164,False,4,0
18512,21,57,66,123,False,4,0
18513,22,49,69,118,False,4,0
18514,23,36,61,97,False,4,0
18515,0,24,41,65,False,5,0
18516,1,29,38,67,False,5,0
18517,2,17,46,63,False,5,0
18518,3,14,30,44,False,5,0
18519,4,20,12,32,False,5,0
18520,5,19,14,33,False,5,0
18521,6,19,20,39,False,5,0
18522,7,42,33,75,False,5,0
18523,8,66,48,114,False,5,0
18524,9,99,69,168,False,5,0
18525,10,129,85,214,False,5,0
18526,11,161,117,278,False,5,0
18527,12,176,154,330,False,5,0
18528,13,161,187,348,False,5,0
18529,14,143,213,356,False,5,0
18530,15,133,175,308,False,5,0
18531,16,160,196,356,False,5,0
18532,17,139,141,280,False,5,0
18533,18,150,133,283,False,5,0
18534,19,81,110,191,False,5,0
18535,20,54,68,122,False,5,0
18536,21,52,72,124,False,5,0
18537,22,40,72,112,False,5,0
18538,23,48,62,110,False,5,0
18539,0,45,59,104,True,6,0
18540,1,38,80,118,True,6,0
18541,2,30,60,90,True,6,0
18542,3,12,39,51,True,6,0
18543,4,20,22,42,True,6,0
18544,5,17,17,34,True,6,0
18545,6,17,16,33,True,6,0
18546,7,32,21,53,True,6,0
18547,8,50,34,84,True,6,0
18548,9,93,56,149,True,6,0
18549,10,111,69,180,True,6,0
18550,11,164,140,304,True,6,0
18551,12,159,181,340,True,6,0
18552,13,187,193,380,True,6,0
18553,14,188,212,400,True,6,0
18554,15,133,208,341,True,6,0
18555,16,178,179,357,True,6,0
18556,17,137,150,287,True,6,0
18557,18,138,154,292,True,6,0
18558,19,121,143,264,True,6,0
18559,20,76,93,169,True,6,0
18560,21,47,63,110,True,6,0
18561,22,31,43,74,True,6,0
18562,23,19,22,41,True,6,0
18563,0,9,16,25,False,0,0
18564,1,12,12,24,False,0,0
18565,2,3,13,16,False,0,0
18566,3,8,2,10,False,0,0
18567,4,21,16,37,False,0,0
18568,5,123,56,179,False,0,0
18569,6,235,164,399,False,0,0
18570,7,406,198,604,False,0,0
18571,8,281,162,443,False,0,0
18572,9,243,144,387,False,0,0
18573,10,220,183,403,False,0,0
18574,11,217,199,416,False,0,0
18575,12,237,175,412,False,0,0
18576,13,206,237,443,False,0,0
18577,14,247,382,629,False,0,0
18578,15,225,302,527,False,0,0
18579,16,188,197,385,False,0,0
18580,17,182,143,325,False,0,0
18581,18,127,141,268,False,0,0
18582,19,110,133,243,False,0,0
18583,20,87,126,213,False,0,0
18584,21,73,77,150,False,0,0
18585,22,29,45,74,False,0,0
18586,23,14,26,40,False,0,0
18587,0,14,18,32,False,1,0
18588,1,6,9,15,False,1,0
18589,2,9,13,22,False,1,0
18590,3,4,7,11,False,1,0
18591,4,20,16,36,False,1,0
18592,5,114,52,166,False,1,0
18593,6,249,170,419,False,1,0
18594,7,394,209,603,False,1,0
18595,8,285,166,451,False,1,0
18596,9,246,186,432,False,1,0
18597,10,232,201,433,False,1,0
18598,11,234,189,423,False,1,0
18599,12,228,210,438,False,1,0
18600,13,241,258,499,False,1,0
18601,14,237,354,591,False,1,0
18602,15,222,319,541,False,1,0
18603,16,227,213,440,False,1,0
18604,17,214,155,369,False,1,0
18605,18,142,139,281,False,1,0
18606,19,113,163,276,False,1,0
18607,20,92,126,218,False,1,0
18608,21,61,98,159,False,1,0
18609,22,29,66,95,False,1,0
18610,23,18,21,39,False,1,0
18611,0,9,16,25,False,2,0
18612,1,7,14,21,False,2,0
18613,2,4,16,20,False,2,0
18614,3,5,6,11,False,2,0
18615,4,30,13,43,False,2,0
18616,5,119,52,171,False,2,0
18617,6,262,152,414,False,2,0
18618,7,419,207,626,False,2,0
18619,8,261,163,424,False,2,0
18620,9,254,160,414,False,2,0
18621,10,240,183,423,False,2,0
18622,11,224,190,414,False,2,0
18623,12,215,208,423,False,2,0
18624,13,199,258,457,False,2,0
18625,14,244,313,557,False,2,0
18626,15,240,291,531,False,2,0
18627,16,190,181,371,False,2,0
18628,17,174,160,334,False,2,0
18629,18,149,168,317,False,2,0
18630,19,106,136,242,False,2,0
18631,20,94,111,205,False,2,0
18632,21,69,92,161,False,2,0
18633,22,37,70,107,False,2,0
18634,23,19,26,45,False,2,0
18635,0,13,25,38,False,3,1
18636,1,7,14,21,False,3,1
18637,2,6,11,17,False,3,1
18638,3,9,11,20,False,3,1
18639,4,21,18,39,False,3,1
18640,5,117,46,163,False,3,1
18641,6,246,129,375,False,3,1
18642,7,405,207,612,False,3,1
18643,8,263,166,429,False,3,1
18644,9,246,162,408,False,3,1
18645,10,225,166,391,False,3,1
18646,11,205,216,421,False,3,1
18647,12,216,190,406,False,3,1
18648,13,219,236,455,False,3,1
18649,14,247,333,580,False,3,1
18650,15,208,294,502,False,3,1
18651,16,160,181,341,False,3,1
18652,17,198,191,389,False,3,1
18653,18,144,140,284,False,3,1
18654,19,112,147,259,False,3,1
18655,20,90,130,220,False,3,1
18656,21,69,372,441,False,3,1
18657,22,37,263,300,False,3,1
18658,23,17,111,128,False,3,1
18659,0,18,60,78,False,4,1
18660,1,9,62,71,False,4,1
18661,2,11,55,66,False,4,1
18662,3,11,11,22,False,4,1
18663,4,18,13,31,False,4,1
18664,5,109,47,156,False,4,1
18665,6,219,115,334,False,4,1
18666,7,323,169,492,False,4,1
18667,8,265,158,423,False,4,1
18668,9,227,172,399,False,4,1
18669,10,234,162,396,False,4,1
18670,11,197,196,393,False,4,1
18671,12,223,212,435,False,4,1
18672,13,221,277,498,False,4,1
18673,14,247,329,576,False,4,1
18674,15,197,255,452,False,4,1
18675,16,129,167,296,False,4,1
18676,17,147,146,293,False,4,1
18677,18,112,119,231,False,4,1
18678,19,89,96,185,False,4,1
18679,20,69,76,145,False,4,1
18680,21,57,95,152,False,4,1
18681,22,37,82,119,False,4,1
18682,23,34,51,85,False,4,1
18683,0,30,45,75,False,5,1
18684,1,21,44,65,False,5,1
18685,2,16,67,83,False,5,1
18686,3,18,23,41,False,5,1
18687,4,10,16,26,False,5,1
18688,5,17,16,33,False,5,1
18689,6,30,30,60,False,5,1
18690,7,35,28,63,False,5,1
18691,8,70,47,117,False,5,1
18692,9,84,72,156,False,5,1
18693,10,126,94,220,False,5,1
18694,11,125,109,234,False,5,1
18695,12,123,134,257,False,5,1
18696,13,133,142,275,False,5,1
18697,14,147,169,316,False,5,1
18698,15,131,165,296,False,5,1
18699,16,115,154,269,False,5,1
18700,17,127,126,253,False,5,1
18701,18,94,103,197,False,5,1
18702,19,98,97,195,False,5,1
18703,20,53,75,128,False,5,1
18704,21,45,66,111,False,5,1
18705,22,50,63,113,False,5,1
18706,23,35,56,91,False,5,1
18707,0,46,42,88,True,6,1
18708,1,28,55,83,True,6,1
18709,2,33,64,97,True,6,1
18710,3,17,46,63,True,6,1
18711,4,16,15,31,True,6,1
18712,5,15,12,27,True,6,1
18713,6,16,21,37,True,6,1
18714,7,29,15,44,True,6,1
18715,8,55,43,98,True,6,1
18716,9,75,61,136,True,6,1
18717,10,111,66,177,True,6,1
18718,11,134,148,282,True,6,1
18719,12,140,168,308,True,6,1
18720,13,176,169,345,True,6,1
18721,14,142,174,316,True,6,1
18722,15,142,183,325,True,6,1
18723,16,167,173,340,True,6,1
18724,17,139,125,264,True,6,1
18725,18,158,174,332,True,6,1
18726,19,115,137,252,True,6,1
18727,20,85,110,195,True,6,1
18728,21,64,90,154,True,6,1
18729,22,30,49,79,True,6,1
18730,23,8,23,31,True,6,1
18731,0,7,20,27,False,0,1
18732,1,7,19,26,False,0,1
18733,2,5,11,16,False,0,1
18734,3,12,8,20,False,0,1
18735,4,19,12,31,False,0,1
18736,5,112,53,165,False,0,1
18737,6,247,131,378,False,0,1
18738,7,367,192,559,False,0,1
18739,8,261,157,418,False,0,1
18740,9,216,177,393,False,0,1
18741,10,199,147,346,False,0,1
18742,11,209,211,420,False,0,1
18743,12,237,205,442,False,0,1
18744,13,212,234,446,False,0,1
18745,14,219,325,544,False,0,1
18746,15,216,327,543,False,0,1
18747,16,182,186,368,False,0,1
18748,17,170,161,331,False,0,1
18749,18,130,139,269,False,0,1
18750,19,104,111,215,False,0,1
18751,20,84,111,195,False,0,1
18752,21,57,90,147,False,0,1
18753,22,32,48,80,False,0,1
18754,23,18,26,44,False,0,1
18755,0,10,17,27,False,1,1
18756,1,8,9,17,False,1,1
18757,2,4,5,9,False,1,1
18758,3,5,5,10,False,1,1
18759,4,21,11,32,False,1,1
18760,5,121,51,172,False,1,1
18761,6,245,144,389,False,1,1
18762,7,373,176,549,False,1,1
18763,8,241,153,394,False,1,1
18764,9,202,176,378,False,1,1
18765,10,223,172,395,False,1,1
18766,11,195,197,392,False,1,1
18767,12,207,196,403,False,1,1
18768,13,221,244,465,False,1,1
18769,14,224,344,568,False,1,1
18770,15,223,285,508,False,1,1
18771,16,193,204,397,False,1,1
18772,17,148,134,282,False,1,1
18773,18,126,135,261,False,1,1
18774,19,117,166,283,False,1,1
18775,20,76,103,179,False,1,1
18776,21,57,94,151,False,1,1
18777,22,34,39,73,False,1,1
18778,23,17,26,43,False,1,1
18779,0,12,26,38,False,2,1
18780,1,8,18,26,False,2,1
18781,2,3,16,19,False,2,1
18782,3,7,14,21,False,2,1
18783,4,22,20,42,False,2,1
18784,5,116,49,165,False,2,1
18785,6,257,148,405,False,2,1
18786,7,342,189,531,False,2,1
18787,8,273,162,435,False,2,1
18788,9,202,180,382,False,2,1
18789,10,205,173,378,False,2,1
18790,11,208,186,394,False,2,1
18791,12,222,207,429,False,2,1
18792,13,212,264,476,False,2,1
18793,14,217,326,543,False,2,1
18794,15,244,430,674,False,2,1
18795,16,195,195,390,False,2,1
18796,17,169,157,326,False,2,1
18797,18,132,149,281,False,2,1
18798,19,119,121,240,False,2,1
18799,20,81,103,184,False,2,1
18800,21,64,360,424,False,2,1
18801,22,26,234,260,False,2,1
18802,23,17,80,97,False,2,1
18803,0,15,47,62,False,3,1
18804,1,11,15,26,False,3,1
18805,2,11,25,36,False,3,1
18806,3,12,17,29,False,3,1
18807,4,20,18,38,False,3,1
18808,5,96,42,138,False,3,1
18809,6,249,142,391,False,3,1
18810,7,381,220,601,False,3,1
18811,8,283,152,435,False,3,1
18812,9,217,165,382,False,3,1
18813,10,236,185,421,False,3,1
18814,11,211,189,400,False,3,1
18815,12,208,195,403,False,3,1
18816,13,193,233,426,False,3,1
18817,14,256,359,615,False,3,1
18818,15,231,298,529,False,3,1
18819,16,190,206,396,False,3,1
18820,17,175,142,317,False,3,1
18821,18,136,160,296,False,3,1
18822,19,119,142,261,False,3,1
18823,20,80,111,191,False,3,1
18824,21,67,85,152,False,3,1
18825,22,33,52,85,False,3,1
18826,23,19,31,50,False,3,1
18827,0,21,22,43,False,4,1
18828,1,12,20,32,False,4,1
18829,2,10,23,33,False,4,1
18830,3,9,12,21,False,4,1
18831,4,22,12,34,False,4,1
18832,5,101,41,142,False,4,1
18833,6,258,149,407,False,4,1
18834,7,386,177,563,False,4,1
18835,8,265,166,431,False,4,1
18836,9,167,150,317,False,4,1
18837,10,198,162,360,False,4,1
18838,11,199,191,390,False,4,1
18839,12,222,213,435,False,4,1
18840,13,244,285,529,False,4,1
18841,14,268,380,648,False,4,1
18842,15,210,282,492,False,4,1
18843,16,166,160,326,False,4,1
18844,17,145,162,307,False,4,1
18845,18,127,132,259,False,4,1
18846,19,82,93,175,False,4,1
18847,20,71,91,162,False,4,1
18848,21,46,74,120,False,4,1
18849,22,58,64,122,False,4,1
18850,23,33,52,85,False,4,1
18851,0,32,48,80,False,5,1
18852,1,20,40,60,False,5,1
18853,2,14,41,55,False,5,1
18854,3,20,25,45,False,5,1
18855,4,8,19,27,False,5,1
18856,5,21,18,39,False,5,1
18857,6,27,17,44,False,5,1
18858,7,37,38,75,False,5,1
18859,8,66,53,119,False,5,1
18860,9,123,65,188,False,5,1
18861,10,194,127,321,False,5,1
18862,11,146,144,290,False,5,1
18863,12,149,125,274,False,5,1
18864,13,178,177,355,False,5,1
18865,14,126,173,299,False,5,1
18866,15,143,151,294,False,5,1
18867,16,126,140,266,False,5,1
18868,17,125,125,250,False,5,1
18869,18,110,120,230,False,5,1
18870,19,92,100,192,False,5,1
18871,20,51,79,130,False,5,1
18872,21,44,66,110,False,5,1
18873,22,43,89,132,False,5,1
18874,23,37,70,107,False,5,1
18875,0,37,47,84,True,6,1
18876,1,35,65,100,True,6,1
18877,2,36,74,110,True,6,1
18878,3,17,40,57,True,6,1
18879,4,16,23,39,True,6,1
18880,5,16,12,28,True,6,1
18881,6,13,16,29,True,6,1
18882,7,21,11,32,True,6,1
18883,8,32,27,59,True,6,1
18884,9,89,48,137,True,6,1
18885,10,84,70,154,True,6,1
18886,11,123,118,241,True,6,1
18887,12,154,161,315,True,6,1
18888,13,191,175,366,True,6,1
18889,14,170,188,358,True,6,1
18890,15,161,245,406,True,6,1
18891,16,144,141,285,True,6,1
18892,17,144,150,294,True,6,1
18893,18,154,138,292,True,6,1
18894,19,111,151,262,True,6,1
18895,20,75,87,162,True,6,1
18896,21,60,63,123,True,6,1
18897,22,26,41,67,True,6,1
18898,23,17,25,42,True,6,1
18899,0,14,22,36,False,0,1
18900,1,9,10,19,False,0,1
18901,2,7,13,20,False,0,1
18902,3,12,5,17,False,0,1
18903,4,21,15,36,False,0,1
18904,5,124,67,191,False,0,1
18905,6,234,129,363,False,0,1
18906,7,394,215,609,False,0,1
18907,8,247,159,406,False,0,1
18908,9,215,137,352,False,0,1
18909,10,173,135,308,False,0,1
18910,11,180,178,358,False,0,1
18911,12,216,183,399,False,0,1
18912,13,187,212,399,False,0,1
18913,14,232,341,573,False,0,1
18914,15,250,315,565,False,0,1
18915,16,174,184,358,False,0,1
18916,17,158,151,309,False,0,1
18917,18,138,141,279,False,0,1
18918,19,115,124,239,False,0,1
18919,20,79,117,196,False,0,1
18920,21,61,74,135,False,0,1
18921,22,40,40,80,False,0,1
18922,23,13,24,37,False,0,1
18923,0,11,17,28,False,1,1
18924,1,12,11,23,False,1,1
18925,2,7,9,16,False,1,1
18926,3,6,9,15,False,1,1
18927,4,14,11,25,False,1,1
18928,5,115,41,156,False,1,1
18929,6,257,131,388,False,1,1
18930,7,402,183,585,False,1,1
18931,8,249,169,418,False,1,1
18932,9,217,216,433,False,1,1
18933,10,219,170,389,False,1,1
18934,11,223,174,397,False,1,1
18935,12,215,185,400,False,1,1
18936,13,208,232,440,False,1,1
18937,14,225,306,531,False,1,1
18938,15,231,293,524,False,1,1
18939,16,183,182,365,False,1,1
18940,17,198,178,376,False,1,1
18941,18,136,153,289,False,1,1
18942,19,126,125,251,False,1,1
18943,20,86,122,208,False,1,1
18944,21,73,102,175,False,1,1
18945,22,35,48,83,False,1,1
18946,23,12,19,31,False,1,1
18947,0,7,14,21,False,2,1
18948,1,19,21,40,False,2,1
18949,2,12,19,31,False,2,1
18950,3,7,9,16,False,2,1
18951,4,17,16,33,False,2,1
18952,5,97,49,146,False,2,1
18953,6,225,134,359,False,2,1
18954,7,394,192,586,False,2,1
18955,8,308,162,470,False,2,1
18956,9,234,167,401,False,2,1
18957,10,233,189,422,False,2,1
18958,11,234,222,456,False,2,1
18959,12,196,181,377,False,2,1
18960,13,230,242,472,False,2,1
18961,14,258,336,594,False,2,1
18962,15,236,292,528,False,2,1
18963,16,214,198,412,False,2,1
18964,17,198,185,383,False,2,1
18965,18,131,170,301,False,2,1
18966,19,131,160,291,False,2,1
18967,20,93,141,234,False,2,1
18968,21,51,407,458,False,2,1
18969,22,33,281,314,False,2,1
18970,23,15,83,98,False,2,1
18971,0,14,23,37,False,3,1
18972,1,11,26,37,False,3,1
18973,2,8,28,36,False,3,1
18974,3,10,10,20,False,3,1
18975,4,14,21,35,False,3,1
18976,5,121,44,165,False,3,1
18977,6,262,156,418,False,3,1
18978,7,391,202,593,False,3,1
18979,8,262,182,444,False,3,1
18980,9,240,156,396,False,3,1
18981,10,312,205,517,False,3,1
18982,11,237,203,440,False,3,1
18983,12,221,226,447,False,3,1
18984,13,206,252,458,False,3,1
18985,14,268,335,603,False,3,1
18986,15,224,284,508,False,3,1
18987,16,191,227,418,False,3,1
18988,17,159,145,304,False,3,1
18989,18,145,161,306,False,3,1
18990,19,109,119,228,False,3,1
18991,20,84,135,219,False,3,1
18992,21,68,88,156,False,3,1
18993,22,23,59,82,False,3,1
18994,23,16,33,49,False,3,1
18995,0,15,36,51,False,4,1
18996,1,12,32,44,False,4,1
18997,2,11,38,49,False,4,1
18998,3,10,12,22,False,4,1
18999,4,22,16,38,False,4,1
19000,5,111,48,159,False,4,1
19001,6,249,129,378,False,4,1
19002,7,405,197,602,False,4,1
19003,8,243,161,404,False,4,1
19004,9,220,171,391,False,4,1
19005,10,219,196,415,False,4,1
19006,11,194,186,380,False,4,1
19007,12,220,227,447,False,4,1
19008,13,248,268,516,False,4,1
19009,14,289,368,657,False,4,1
19010,15,202,312,514,False,4,1
19011,16,162,161,323,False,4,1
19012,17,178,164,342,False,4,1
19013,18,123,136,259,False,4,1
19014,19,86,95,181,False,4,1
19015,20,83,83,166,False,4,1
19016,21,64,87,151,False,4,1
19017,22,58,84,142,False,4,1
19018,23,25,40,65,False,4,1
19019,0,26,40,66,False,5,1
19020,1,32,46,78,False,5,1
19021,2,16,37,53,False,5,1
19022,3,15,35,50,False,5,1
19023,4,17,10,27,False,5,1
19024,5,31,12,43,False,5,1
19025,6,24,25,49,False,5,1
19026,7,37,32,69,False,5,1
19027,8,68,52,120,False,5,1
19028,9,106,82,188,False,5,1
19029,10,121,119,240,False,5,1
19030,11,163,145,308,False,5,1
19031,12,160,151,311,False,5,1
19032,13,166,199,365,False,5,1
19033,14,160,190,350,False,5,1
19034,15,136,168,304,False,5,1
19035,16,128,142,270,False,5,1
19036,17,140,139,279,False,5,1
19037,18,101,137,238,False,5,1
19038,19,78,101,179,False,5,1
19039,20,52,80,132,False,5,1
19040,21,53,64,117,False,5,1
19041,22,45,59,104,False,5,1
19042,23,40,64,104,False,5,1
19043,0,37,58,95,True,6,1
19044,1,31,47,78,True,6,1
19045,2,33,63,96,True,6,1
19046,3,14,42,56,True,6,1
19047,4,17,18,35,True,6,1
19048,5,16,8,24,True,6,1
19049,6,15,10,25,True,6,1
19050,7,42,13,55,True,6,1
19051,8,54,34,88,True,6,1
19052,9,98,52,150,True,6,1
19053,10,140,87,227,True,6,1
19054,11,156,129,285,True,6,1
19055,12,153,148,301,True,6,1
19056,13,179,176,355,True,6,1
19057,14,167,191,358,True,6,1
19058,15,146,225,371,True,6,1
19059,16,162,186,348,True,6,1
19060,17,138,168,306,True,6,1
19061,18,140,160,300,True,6,1
19062,19,112,129,241,True,6,1
19063,20,71,95,166,True,6,1
19064,21,58,83,141,True,6,1
19065,22,26,53,79,True,6,1
19066,23,24,17,41,True,6,1
19067,0,11,13,24,False,0,1
19068,1,7,15,22,False,0,1
19069,2,11,13,24,False,0,1
19070,3,11,11,22,False,0,1
19071,4,13,10,23,False,0,1
19072,5,106,48,154,False,0,1
19073,6,244,151,395,False,0,1
19074,7,412,196,608,False,0,1
19075,8,274,173,447,False,0,1
19076,9,205,171,376,False,0,1
19077,10,216,158,374,False,0,1
19078,11,192,194,386,False,0,1
19079,12,223,215,438,False,0,1
19080,13,206,256,462,False,0,1
19081,14,246,332,578,False,0,1
19082,15,215,305,520,False,0,1
19083,16,193,180,373,False,0,1
19084,17,164,178,342,False,0,1
19085,18,151,127,278,False,0,1
19086,19,107,127,234,False,0,1
19087,20,85,130,215,False,0,1
19088,21,64,93,157,False,0,1
19089,22,39,84,123,False,0,1
19090,23,21,19,40,False,0,1
19091,0,6,4,10,False,1,1
19092,1,5,9,14,False,1,1
19093,2,10,8,18,False,1,1
19094,3,9,8,17,False,1,1
19095,4,30,12,42,False,1,1
19096,5,108,38,146,False,1,1
19097,6,231,144,375,False,1,1
19098,7,405,180,585,False,1,1
19099,8,237,150,387,False,1,1
19100,9,239,172,411,False,1,1
19101,10,201,177,378,False,1,1
19102,11,221,187,408,False,1,1
19103,12,199,251,450,False,1,1
19104,13,205,269,474,False,1,1
19105,14,285,365,650,False,1,1
19106,15,217,310,527,False,1,1
19107,16,176,187,363,False,1,1
19108,17,200,139,339,False,1,1
19109,18,159,161,320,False,1,1
19110,19,118,164,282,False,1,1
19111,20,85,115,200,False,1,1
19112,21,63,113,176,False,1,1
19113,22,28,44,72,False,1,1
19114,23,10,25,35,False,1,1
19115,0,7,30,37,False,2,1
19116,1,9,21,30,False,2,1
19117,2,5,21,26,False,2,1
19118,3,15,15,30,False,2,1
19119,4,22,26,48,False,2,1
19120,5,104,41,145,False,2,1
19121,6,220,131,351,False,2,1
19122,7,431,199,630,False,2,1
19123,8,253,174,427,False,2,1
19124,9,218,156,374,False,2,1
19125,10,242,173,415,False,2,1
19126,11,222,184,406,False,2,1
19127,12,190,200,390,False,2,1
19128,13,225,244,469,False,2,1
19129,14,248,329,577,False,2,1
19130,15,226,327,553,False,2,1
19131,16,189,187,376,False,2,1
19132,17,194,169,363,False,2,1
19133,18,156,139,295,False,2,1
19134,19,109,123,232,False,2,1
19135,20,104,154,258,False,2,1
19136,21,63,90,153,False,2,1
19137,22,43,55,98,False,2,1
19138,23,14,30,44,False,2,1
19139,0,19,24,43,False,3,1
19140,1,8,22,30,False,3,1
19141,2,11,20,31,False,3,1
19142,3,8,15,23,False,3,1
19143,4,15,13,28,False,3,1
19144,5,89,45,134,False,3,1
19145,6,256,145,401,False,3,1
19146,7,407,196,603,False,3,1
19147,8,233,156,389,False,3,1
19148,9,228,170,398,False,3,1
19149,10,243,187,430,False,3,1
19150,11,221,209,430,False,3,1
19151,12,209,220,429,False,3,1
19152,13,216,249,465,False,3,1
19153,14,233,328,561,False,3,1
19154,15,272,278,550,False,3,1
19155,16,209,205,414,False,3,1
19156,17,152,153,305,False,3,1
19157,18,142,176,318,False,3,1
19158,19,127,134,261,False,3,1
19159,20,100,114,214,False,3,1
19160,21,63,86,149,False,3,1
19161,22,46,54,100,False,3,1
19162,23,25,29,54,False,3,1
19163,0,11,24,35,False,4,1
19164,1,10,19,29,False,4,1
19165,2,5,22,27,False,4,1
19166,3,8,19,27,False,4,1
19167,4,20,14,34,False,4,1
19168,5,106,47,153,False,4,1
19169,6,251,155,406,False,4,1
19170,7,375,186,561,False,4,1
19171,8,222,150,372,False,4,1
19172,9,240,183,423,False,4,1
19173,10,232,197,429,False,4,1
19174,11,206,184,390,False,4,1
19175,12,213,232,445,False,4,1
19176,13,246,288,534,False,4,1
19177,14,258,326,584,False,4,1
19178,15,196,284,480,False,4,1
19179,16,167,166,333,False,4,1
19180,17,153,145,298,False,4,1
19181,18,107,126,233,False,4,1
19182,19,89,91,180,False,4,1
19183,20,64,85,149,False,4,1
19184,21,48,59,107,False,4,1
19185,22,35,50,85,False,4,1
19186,23,44,51,95,False,4,1
19187,0,31,44,75,False,5,1
19188,1,23,35,58,False,5,1
19189,2,24,49,73,False,5,1
19190,3,17,31,48,False,5,1
19191,4,5,11,16,False,5,1
19192,5,15,20,35,False,5,1
19193,6,28,26,54,False,5,1
19194,7,34,29,63,False,5,1
19195,8,60,51,111,False,5,1
19196,9,93,76,169,False,5,1
19197,10,137,99,236,False,5,1
19198,11,140,126,266,False,5,1
19199,12,157,145,302,False,5,1
19200,13,142,192,334,False,5,1
19201,14,117,189,306,False,5,1
19202,15,137,149,286,False,5,1
19203,16,130,136,266,False,5,1
19204,17,119,150,269,False,5,1
19205,18,82,96,178,False,5,1
19206,19,98,80,178,False,5,1
19207,20,50,65,115,False,5,1
19208,21,39,56,95,False,5,1
19209,22,45,73,118,False,5,1
19210,23,28,49,77,False,5,1
19211,0,26,50,76,True,6,1
19212,1,29,42,71,True,6,1
19213,2,27,51,78,True,6,1
19214,3,15,37,52,True,6,1
19215,4,9,18,27,True,6,1
19216,5,12,16,28,True,6,1
19217,6,13,15,28,True,6,1
19218,7,32,19,51,True,6,1
19219,8,40,25,65,True,6,1
19220,9,82,53,135,True,6,1
19221,10,103,70,173,True,6,1
19222,11,131,127,258,True,6,1
19223,12,124,162,286,True,6,1
19224,13,180,188,368,True,6,1
19225,14,151,159,310,True,6,1
19226,15,119,195,314,True,6,1
19227,16,141,176,317,True,6,1
19228,17,132,156,288,True,6,1
19229,18,111,93,204,True,6,1
19230,19,90,105,195,True,6,1
19231,20,61,84,145,True,6,1
19232,21,49,46,95,True,6,1
19233,22,27,31,58,True,6,1
19234,23,19,23,42,True,6,1
19235,0,8,13,21,False,0,1
19236,1,13,16,29,False,0,1
19237,2,3,10,13,False,0,1
19238,3,9,9,18,False,0,1
19239,4,20,8,28,False,0,1
19240,5,101,49,150,False,0,1
19241,6,210,127,337,False,0,1
19242,7,285,167,452,False,0,1
19243,8,218,138,356,False,0,1
19244,9,189,132,321,False,0,1
19245,10,193,141,334,False,0,1
19246,11,212,166,378,False,0,1
19247,12,187,196,383,False,0,1
19248,13,197,207,404,False,0,1
19249,14,234,301,535,False,0,1
19250,15,187,288,475,False,0,1
19251,16,176,172,348,False,0,1
19252,17,139,139,278,False,0,1
19253,18,106,122,228,False,0,1
19254,19,88,99,187,False,0,1
19255,20,86,102,188,False,0,1
19256,21,56,62,118,False,0,1
19257,22,32,114,146,False,0,1
19258,23,15,39,54,False,0,1
19259,0,12,8,20,False,1,1
19260,1,6,9,15,False,1,1
19261,2,8,9,17,False,1,1
19262,3,11,11,22,False,1,1
19263,4,18,17,35,False,1,1
19264,5,104,54,158,False,1,1
19265,6,227,133,360,False,1,1
19266,7,301,146,447,False,1,1
19267,8,218,144,362,False,1,1
19268,9,230,163,393,False,1,1
19269,10,223,170,393,False,1,1
19270,11,194,188,382,False,1,1
19271,12,206,208,414,False,1,1
19272,13,215,212,427,False,1,1
19273,14,235,292,527,False,1,1
19274,15,198,261,459,False,1,1
19275,16,180,181,361,False,1,1
19276,17,169,133,302,False,1,1
19277,18,123,146,269,False,1,1
19278,19,103,111,214,False,1,1
19279,20,82,106,188,False,1,1
19280,21,70,88,158,False,1,1
19281,22,29,47,76,False,1,1
19282,23,14,22,36,False,1,1
19283,0,13,16,29,False,2,1
19284,1,10,14,24,False,2,1
19285,2,1,10,11,False,2,1
19286,3,10,10,20,False,2,1
19287,4,12,22,34,False,2,1
19288,5,104,45,149,False,2,1
19289,6,197,130,327,False,2,1
19290,7,295,153,448,False,2,1
19291,8,228,135,363,False,2,1
19292,9,210,160,370,False,2,1
19293,10,233,165,398,False,2,1
19294,11,195,191,386,False,2,1
19295,12,221,178,399,False,2,1
19296,13,197,219,416,False,2,1
19297,14,239,277,516,False,2,1
19298,15,201,265,466,False,2,1
19299,16,187,192,379,False,2,1
19300,17,161,147,308,False,2,1
19301,18,118,139,257,False,2,1
19302,19,103,112,215,False,2,1
19303,20,89,107,196,False,2,1
19304,21,56,104,160,False,2,1
19305,22,35,50,85,False,2,1
19306,23,15,36,51,False,2,1
19307,0,7,18,25,False,3,2
19308,1,7,17,24,False,3,2
19309,2,10,19,29,False,3,2
19310,3,8,10,18,False,3,2
19311,4,17,21,38,False,3,2
19312,5,101,41,142,False,3,2
19313,6,203,125,328,False,3,2
19314,7,285,143,428,False,3,2
19315,8,230,143,373,False,3,2
19316,9,178,147,325,False,3,2
19317,10,200,166,366,False,3,2
19318,11,226,193,419,False,3,2
19319,12,204,199,403,False,3,2
19320,13,191,238,429,False,3,2
19321,14,228,294,522,False,3,2
19322,15,227,263,490,False,3,2
19323,16,191,180,371,False,3,2
19324,17,147,160,307,False,3,2
19325,18,132,130,262,False,3,2
19326,19,99,109,208,False,3,2
19327,20,68,112,180,False,3,2
19328,21,54,79,133,False,3,2
19329,22,34,52,86,False,3,2
19330,23,19,30,49,False,3,2
19331,0,14,29,43,False,4,2
19332,1,11,36,47,False,4,2
19333,2,8,15,23,False,4,2
19334,3,8,15,23,False,4,2
19335,4,16,19,35,False,4,2
19336,5,98,54,152,False,4,2
19337,6,184,117,301,False,4,2
19338,7,250,145,395,False,4,2
19339,8,211,146,357,False,4,2
19340,9,182,160,342,False,4,2
19341,10,202,153,355,False,4,2
19342,11,211,165,376,False,4,2
19343,12,202,223,425,False,4,2
19344,13,229,232,461,False,4,2
19345,14,233,304,537,False,4,2
19346,15,180,219,399,False,4,2
19347,16,155,170,325,False,4,2
19348,17,125,124,249,False,4,2
19349,18,96,127,223,False,4,2
19350,19,72,85,157,False,4,2
19351,20,69,73,142,False,4,2
19352,21,71,65,136,False,4,2
19353,22,36,49,85,False,4,2
19354,23,29,26,55,False,4,2
19355,0,16,32,48,False,5,2
19356,1,21,45,66,False,5,2
19357,2,24,35,59,False,5,2
19358,3,8,33,41,False,5,2
19359,4,7,11,18,False,5,2
19360,5,17,23,40,False,5,2
19361,6,32,17,49,False,5,2
19362,7,27,26,53,False,5,2
19363,8,60,45,105,False,5,2
19364,9,88,60,148,False,5,2
19365,10,90,77,167,False,5,2
19366,11,108,111,219,False,5,2
19367,12,138,113,251,False,5,2
19368,13,140,132,272,False,5,2
19369,14,137,137,274,False,5,2
19370,15,107,136,243,False,5,2
19371,16,122,144,266,False,5,2
19372,17,110,115,225,False,5,2
19373,18,92,99,191,False,5,2
19374,19,76,103,179,False,5,2
19375,20,56,70,126,False,5,2
19376,21,50,55,105,False,5,2
19377,22,26,48,74,False,5,2
19378,23,31,51,82,False,5,2
19379,0,26,45,71,True,6,2
19380,1,21,50,71,True,6,2
19381,2,27,59,86,True,6,2
19382,3,18,36,54,True,6,2
19383,4,5,25,30,True,6,2
19384,5,16,12,28,True,6,2
19385,6,21,19,40,True,6,2
19386,7,20,12,32,True,6,2
19387,8,44,28,72,True,6,2
19388,9,82,45,127,True,6,2
19389,10,102,62,164,True,6,2
19390,11,115,115,230,True,6,2
19391,12,123,161,284,True,6,2
19392,13,195,166,361,True,6,2
19393,14,147,182,329,True,6,2
19394,15,142,179,321,True,6,2
19395,16,121,139,260,True,6,2
19396,17,123,127,250,True,6,2
19397,18,138,158,296,True,6,2
19398,19,103,122,225,True,6,2
19399,20,72,97,169,True,6,2
19400,21,55,72,127,True,6,2
19401,22,18,46,64,True,6,2
19402,23,22,24,46,True,6,2
19403,0,9,13,22,False,0,2
19404,1,10,12,22,False,0,2
19405,2,3,18,21,False,0,2
19406,3,9,15,24,False,0,2
19407,4,16,7,23,False,0,2
19408,5,123,52,175,False,0,2
19409,6,255,137,392,False,0,2
19410,7,369,213,582,False,0,2
19411,8,288,153,441,False,0,2
19412,9,188,147,335,False,0,2
19413,10,196,167,363,False,0,2
19414,11,188,202,390,False,0,2
19415,12,188,179,367,False,0,2
19416,13,202,221,423,False,0,2
19417,14,228,326,554,False,0,2
19418,15,224,328,552,False,0,2
19419,16,179,174,353,False,0,2
19420,17,198,155,353,False,0,2
19421,18,136,136,272,False,0,2
19422,19,95,113,208,False,0,2
19423,20,82,106,188,False,0,2
19424,21,68,67,135,False,0,2
19425,22,37,42,79,False,0,2
19426,23,22,28,50,False,0,2
19427,0,13,22,35,False,1,2
19428,1,9,14,23,False,1,2
19429,2,10,16,26,False,1,2
19430,3,9,7,16,False,1,2
19431,4,17,9,26,False,1,2
19432,5,118,52,170,False,1,2
19433,6,264,144,408,False,1,2
19434,7,386,199,585,False,1,2
19435,8,305,181,486,False,1,2
19436,9,210,167,377,False,1,2
19437,10,214,167,381,False,1,2
19438,11,192,183,375,False,1,2
19439,12,196,198,394,False,1,2
19440,13,253,254,507,False,1,2
19441,14,245,332,577,False,1,2
19442,15,207,301,508,False,1,2
19443,16,212,202,414,False,1,2
19444,17,206,163,369,False,1,2
19445,18,154,132,286,False,1,2
19446,19,112,143,255,False,1,2
19447,20,92,115,207,False,1,2
19448,21,81,110,191,False,1,2
19449,22,35,44,79,False,1,2
19450,23,13,21,34,False,1,2
19451,0,8,24,32,False,2,2
19452,1,5,17,22,False,2,2
19453,2,11,19,30,False,2,2
19454,3,7,9,16,False,2,2
19455,4,26,15,41,False,2,2
19456,5,112,54,166,False,2,2
19457,6,250,145,395,False,2,2
19458,7,403,195,598,False,2,2
19459,8,258,168,426,False,2,2
19460,9,198,151,349,False,2,2
19461,10,196,168,364,False,2,2
19462,11,212,191,403,False,2,2
19463,12,204,183,387,False,2,2
19464,13,209,223,432,False,2,2
19465,14,256,328,584,False,2,2
19466,15,199,304,503,False,2,2
19467,16,214,216,430,False,2,2
19468,17,166,186,352,False,2,2
19469,18,148,151,299,False,2,2
19470,19,128,126,254,False,2,2
19471,20,84,129,213,False,2,2
19472,21,73,86,159,False,2,2
19473,22,36,39,75,False,2,2
19474,23,21,22,43,False,2,2
19475,0,10,18,28,False,3,2
19476,1,11,20,31,False,3,2
19477,2,10,23,33,False,3,2
19478,3,11,9,20,False,3,2
19479,4,17,15,32,False,3,2
19480,5,113,43,156,False,3,2
19481,6,259,144,403,False,3,2
19482,7,423,213,636,False,3,2
19483,8,251,171,422,False,3,2
19484,9,218,173,391,False,3,2
19485,10,201,181,382,False,3,2
19486,11,226,208,434,False,3,2
19487,12,211,208,419,False,3,2
19488,13,227,250,477,False,3,2
19489,14,238,312,550,False,3,2
19490,15,261,329,590,False,3,2
19491,16,207,190,397,False,3,2
19492,17,180,163,343,False,3,2
19493,18,176,154,330,False,3,2
19494,19,109,131,240,False,3,2
19495,20,91,137,228,False,3,2
19496,21,74,86,160,False,3,2
19497,22,52,59,111,False,3,2
19498,23,24,27,51,False,3,2
19499,0,12,39,51,False,4,2
19500,1,11,52,63,False,4,2
19501,2,17,41,58,False,4,2
19502,3,10,36,46,False,4,2
19503,4,17,26,43,False,4,2
19504,5,108,54,162,False,4,2
19505,6,244,132,376,False,4,2
19506,7,402,209,611,False,4,2
19507,8,258,171,429,False,4,2
19508,9,214,149,363,False,4,2
19509,10,227,169,396,False,4,2
19510,11,234,190,424,False,4,2
19511,12,212,209,421,False,4,2
19512,13,228,269,497,False,4,2
19513,14,275,326,601,False,4,2
19514,15,209,277,486,False,4,2
19515,16,169,164,333,False,4,2
19516,17,173,166,339,False,4,2
19517,18,163,138,301,False,4,2
19518,19,100,125,225,False,4,2
19519,20,101,88,189,False,4,2
19520,21,70,63,133,False,4,2
19521,22,40,42,82,False,4,2
19522,23,35,51,86,False,4,2
19523,0,19,29,48,False,5,2
19524,1,20,28,48,False,5,2
19525,2,15,40,55,False,5,2
19526,3,12,22,34,False,5,2
19527,4,14,20,34,False,5,2
19528,5,17,21,38,False,5,2
19529,6,42,29,71,False,5,2
19530,7,61,48,109,False,5,2
19531,8,111,72,183,False,5,2
19532,9,169,85,254,False,5,2
19533,10,162,123,285,False,5,2
19534,11,187,137,324,False,5,2
19535,12,197,184,381,False,5,2
19536,13,187,168,355,False,5,2
19537,14,167,176,343,False,5,2
19538,15,176,176,352,False,5,2
19539,16,191,147,338,False,5,2
19540,17,146,151,297,False,5,2
19541,18,136,122,258,False,5,2
19542,19,105,88,193,False,5,2
19543,20,65,76,141,False,5,2
19544,21,56,70,126,False,5,2
19545,22,40,57,97,False,5,2
19546,23,43,68,111,False,5,2
19547,0,33,52,85,True,6,2
19548,1,20,42,62,True,6,2
19549,2,19,46,65,True,6,2
19550,3,9,43,52,True,6,2
19551,4,8,16,24,True,6,2
19552,5,21,12,33,True,6,2
19553,6,20,17,37,True,6,2
19554,7,32,11,43,True,6,2
19555,8,56,41,97,True,6,2
19556,9,102,54,156,True,6,2
19557,10,131,63,194,True,6,2
19558,11,135,129,264,True,6,2
19559,12,144,184,328,True,6,2
19560,13,167,204,371,True,6,2
19561,14,178,196,374,True,6,2
19562,15,168,229,397,True,6,2
19563,16,164,168,332,True,6,2
19564,17,180,148,328,True,6,2
19565,18,129,167,296,True,6,2
19566,19,106,160,266,True,6,2
19567,20,79,117,196,True,6,2
19568,21,47,62,109,True,6,2
19569,22,19,32,51,True,6,2
19570,23,14,15,29,True,6,2
19571,0,10,12,22,False,0,2
19572,1,12,17,29,False,0,2
19573,2,3,10,13,False,0,2
19574,3,8,8,16,False,0,2
19575,4,24,11,35,False,0,2
19576,5,115,52,167,False,0,2
19577,6,257,160,417,False,0,2
19578,7,389,201,590,False,0,2
19579,8,276,156,432,False,0,2
19580,9,207,136,343,False,0,2
19581,10,194,163,357,False,0,2
19582,11,216,217,433,False,0,2
19583,12,208,213,421,False,0,2
19584,13,208,257,465,False,0,2
19585,14,240,331,571,False,0,2
19586,15,226,340,566,False,0,2
19587,16,204,187,391,False,0,2
19588,17,176,151,327,False,0,2
19589,18,137,154,291,False,0,2
19590,19,102,117,219,False,0,2
19591,20,74,129,203,False,0,2
19592,21,67,109,176,False,0,2
19593,22,33,38,71,False,0,2
19594,23,14,32,46,False,0,2
19595,0,8,15,23,False,1,2
19596,1,5,13,18,False,1,2
19597,2,7,12,19,False,1,2
19598,3,11,11,22,False,1,2
19599,4,17,15,32,False,1,2
19600,5,115,48,163,False,1,2
19601,6,258,152,410,False,1,2
19602,7,439,188,627,False,1,2
19603,8,253,154,407,False,1,2
19604,9,216,181,397,False,1,2
19605,10,224,203,427,False,1,2
19606,11,233,209,442,False,1,2
19607,12,231,198,429,False,1,2
19608,13,240,265,505,False,1,2
19609,14,238,348,586,False,1,2
19610,15,245,360,605,False,1,2
19611,16,175,208,383,False,1,2
19612,17,208,160,368,False,1,2
19613,18,171,167,338,False,1,2
19614,19,129,154,283,False,1,2
19615,20,83,115,198,False,1,2
19616,21,72,105,177,False,1,2
19617,22,34,50,84,False,1,2
19618,23,17,26,43,False,1,2
19619,0,13,24,37,False,2,2
19620,1,7,14,21,False,2,2
19621,2,7,23,30,False,2,2
19622,3,9,13,22,False,2,2
19623,4,20,17,37,False,2,2
19624,5,123,55,178,False,2,2
19625,6,268,137,405,False,2,2
19626,7,414,216,630,False,2,2
19627,8,247,171,418,False,2,2
19628,9,247,156,403,False,2,2
19629,10,206,190,396,False,2,2
19630,11,222,215,437,False,2,2
19631,12,234,196,430,False,2,2
19632,13,240,252,492,False,2,2
19633,14,234,305,539,False,2,2
19634,15,210,272,482,False,2,2
19635,16,210,202,412,False,2,2
19636,17,178,169,347,False,2,2
19637,18,134,168,302,False,2,2
19638,19,108,140,248,False,2,2
19639,20,75,108,183,False,2,2
19640,21,71,85,156,False,2,2
19641,22,40,51,91,False,2,2
19642,23,26,19,45,False,2,2
19643,0,12,11,23,False,3,2
19644,1,4,12,16,False,3,2
19645,2,5,15,20,False,3,2
19646,3,8,17,25,False,3,2
19647,4,20,11,31,False,3,2
19648,5,112,67,179,False,3,2
19649,6,262,143,405,False,3,2
19650,7,403,228,631,False,3,2
19651,8,261,172,433,False,3,2
19652,9,221,177,398,False,3,2
19653,10,227,177,404,False,3,2
19654,11,196,201,397,False,3,2
19655,12,232,215,447,False,3,2
19656,13,188,241,429,False,3,2
19657,14,244,300,544,False,3,2
19658,15,218,291,509,False,3,2
19659,16,233,207,440,False,3,2
19660,17,193,192,385,False,3,2
19661,18,157,156,313,False,3,2
19662,19,123,136,259,False,3,2
19663,20,88,138,226,False,3,2
19664,21,53,85,138,False,3,2
19665,22,43,45,88,False,3,2
19666,23,13,28,41,False,3,2
19667,0,17,20,37,False,4,2
19668,1,11,37,48,False,4,2
19669,2,14,22,36,False,4,2
19670,3,11,17,28,False,4,2
19671,4,14,13,27,False,4,2
19672,5,101,52,153,False,4,2
19673,6,243,144,387,False,4,2
19674,7,384,251,635,False,4,2
19675,8,250,163,413,False,4,2
19676,9,244,237,481,False,4,2
19677,10,218,188,406,False,4,2
19678,11,215,209,424,False,4,2
19679,12,223,215,438,False,4,2
19680,13,241,292,533,False,4,2
19681,14,266,341,607,False,4,2
19682,15,241,258,499,False,4,2
19683,16,157,161,318,False,4,2
19684,17,142,159,301,False,4,2
19685,18,111,121,232,False,4,2
19686,19,105,119,224,False,4,2
19687,20,65,83,148,False,4,2
19688,21,55,68,123,False,4,2
19689,22,55,57,112,False,4,2
19690,23,34,49,83,False,4,2
19691,0,24,43,67,False,5,2
19692,1,20,39,59,False,5,2
19693,2,16,47,63,False,5,2
19694,3,13,32,45,False,5,2
19695,4,13,12,25,False,5,2
19696,5,23,15,38,False,5,2
19697,6,33,28,61,False,5,2
19698,7,48,41,89,False,5,2
19699,8,57,59,116,False,5,2
19700,9,92,94,186,False,5,2
19701,10,141,106,247,False,5,2
19702,11,151,118,269,False,5,2
19703,12,156,129,285,False,5,2
19704,13,167,182,349,False,5,2
19705,14,179,197,376,False,5,2
19706,15,144,194,338,False,5,2
19707,16,136,175,311,False,5,2
19708,17,126,128,254,False,5,2
19709,18,113,122,235,False,5,2
19710,19,98,91,189,False,5,2
19711,20,53,90,143,False,5,2
19712,21,51,73,124,False,5,2
19713,22,44,54,98,False,5,2
19714,23,46,71,117,False,5,2
19715,0,37,50,87,True,6,2
19716,1,30,56,86,True,6,2
19717,2,32,61,93,True,6,2
19718,3,12,39,51,True,6,2
19719,4,12,15,27,True,6,2
19720,5,19,16,35,True,6,2
19721,6,24,25,49,True,6,2
19722,7,46,19,65,True,6,2
19723,8,51,51,102,True,6,2
19724,9,111,65,176,True,6,2
19725,10,107,80,187,True,6,2
19726,11,180,150,330,True,6,2
19727,12,145,173,318,True,6,2
19728,13,185,199,384,True,6,2
19729,14,167,205,372,True,6,2
19730,15,141,210,351,True,6,2
19731,16,125,205,330,True,6,2
19732,17,173,156,329,True,6,2
19733,18,125,128,253,True,6,2
19734,19,173,143,316,True,6,2
19735,20,83,114,197,True,6,2
19736,21,38,64,102,True,6,2
19737,22,36,34,70,True,6,2
19738,23,18,20,38,True,6,2
19739,0,10,10,20,False,0,2
19740,1,3,16,19,False,0,2
19741,2,13,14,27,False,0,2
19742,3,7,13,20,False,0,2
19743,4,20,12,32,False,0,2
19744,5,133,70,203,False,0,2
19745,6,236,143,379,False,0,2
19746,7,382,179,561,False,0,2
19747,8,290,166,456,False,0,2
19748,9,232,181,413,False,0,2
19749,10,224,158,382,False,0,2
19750,11,229,175,404,False,0,2
19751,12,231,204,435,False,0,2
19752,13,224,248,472,False,0,2
19753,14,251,339,590,False,0,2
19754,15,246,310,556,False,0,2
19755,16,216,197,413,False,0,2
19756,17,176,157,333,False,0,2
19757,18,147,144,291,False,0,2
19758,19,98,116,214,False,0,2
19759,20,94,132,226,False,0,2
19760,21,51,70,121,False,0,2
19761,22,25,44,69,False,0,2
19762,23,10,21,31,False,0,2
19763,0,11,18,29,False,1,2
19764,1,9,7,16,False,1,2
19765,2,3,6,9,False,1,2
19766,3,5,12,17,False,1,2
19767,4,23,14,37,False,1,2
19768,5,121,51,172,False,1,2
19769,6,265,155,420,False,1,2
19770,7,400,186,586,False,1,2
19771,8,248,166,414,False,1,2
19772,9,208,176,384,False,1,2
19773,10,217,164,381,False,1,2
19774,11,204,214,418,False,1,2
19775,12,216,195,411,False,1,2
19776,13,227,251,478,False,1,2
19777,14,263,334,597,False,1,2
19778,15,232,299,531,False,1,2
19779,16,199,186,385,False,1,2
19780,17,174,161,335,False,1,2
19781,18,165,175,340,False,1,2
19782,19,126,127,253,False,1,2
19783,20,79,128,207,False,1,2
19784,21,66,95,161,False,1,2
19785,22,24,33,57,False,1,2
19786,23,22,22,44,False,1,2
19787,0,9,25,34,False,2,2
19788,1,13,18,31,False,2,2
19789,2,7,13,20,False,2,2
19790,3,8,14,22,False,2,2
19791,4,17,16,33,False,2,2
19792,5,122,53,175,False,2,2
19793,6,234,147,381,False,2,2
19794,7,395,216,611,False,2,2
19795,8,247,169,416,False,2,2
19796,9,231,177,408,False,2,2
19797,10,204,194,398,False,2,2
19798,11,242,219,461,False,2,2
19799,12,218,210,428,False,2,2
19800,13,220,247,467,False,2,2
19801,14,273,345,618,False,2,2
19802,15,261,299,560,False,2,2
19803,16,216,213,429,False,2,2
19804,17,197,174,371,False,2,2
19805,18,132,147,279,False,2,2
19806,19,128,154,282,False,2,2
19807,20,92,123,215,False,2,2
19808,21,62,92,154,False,2,2
19809,22,34,122,156,False,2,2
19810,23,13,83,96,False,2,2
19811,0,14,29,43,False,3,2
19812,1,13,17,30,False,3,2
19813,2,11,24,35,False,3,2
19814,3,7,11,18,False,3,2
19815,4,22,14,36,False,3,2
19816,5,130,58,188,False,3,2
19817,6,250,164,414,False,3,2
19818,7,438,205,643,False,3,2
19819,8,241,180,421,False,3,2
19820,9,234,189,423,False,3,2
19821,10,257,194,451,False,3,2
19822,11,218,222,440,False,3,2
19823,12,258,227,485,False,3,2
19824,13,194,259,453,False,3,2
19825,14,271,396,667,False,3,2
19826,15,287,379,666,False,3,2
19827,16,213,197,410,False,3,2
19828,17,177,173,350,False,3,2
19829,18,157,147,304,False,3,2
19830,19,107,146,253,False,3,2
19831,20,111,133,244,False,3,2
19832,21,74,111,185,False,3,2
19833,22,29,53,82,False,3,2
19834,23,23,23,46,False,3,2
19835,0,20,20,40,False,4,2
19836,1,10,30,40,False,4,2
19837,2,13,25,38,False,4,2
19838,3,11,14,25,False,4,2
19839,4,20,17,37,False,4,2
19840,5,120,52,172,False,4,2
19841,6,254,176,430,False,4,2
19842,7,395,194,589,False,4,2
19843,8,272,175,447,False,4,2
19844,9,261,203,464,False,4,2
19845,10,259,206,465,False,4,2
19846,11,239,230,469,False,4,2
19847,12,235,244,479,False,4,2
19848,13,242,296,538,False,4,2
19849,14,250,327,577,False,4,2
19850,15,227,305,532,False,4,2
19851,16,163,179,342,False,4,2
19852,17,152,160,312,False,4,2
19853,18,116,122,238,False,4,2
19854,19,108,107,215,False,4,2
19855,20,71,83,154,False,4,2
19856,21,64,85,149,False,4,2
19857,22,42,79,121,False,4,2
19858,23,28,53,81,False,4,2
19859,0,29,36,65,False,5,2
19860,1,11,43,54,False,5,2
19861,2,15,44,59,False,5,2
19862,3,11,23,34,False,5,2
19863,4,11,13,24,False,5,2
19864,5,24,18,42,False,5,2
19865,6,26,29,55,False,5,2
19866,7,35,22,57,False,5,2
19867,8,57,45,102,False,5,2
19868,9,98,75,173,False,5,2
19869,10,125,100,225,False,5,2
19870,11,151,136,287,False,5,2
19871,12,149,135,284,False,5,2
19872,13,150,160,310,False,5,2
19873,14,138,153,291,False,5,2
19874,15,121,140,261,False,5,2
19875,16,98,129,227,False,5,2
19876,17,129,106,235,False,5,2
19877,18,88,121,209,False,5,2
19878,19,86,80,166,False,5,2
19879,20,57,80,137,False,5,2
19880,21,43,54,97,False,5,2
19881,22,41,46,87,False,5,2
19882,23,39,51,90,False,5,2
19883,0,35,44,79,True,6,2
19884,1,35,54,89,True,6,2
19885,2,21,52,73,True,6,2
19886,3,13,26,39,True,6,2
19887,4,15,17,32,True,6,2
19888,5,19,21,40,True,6,2
19889,6,24,12,36,True,6,2
19890,7,44,34,78,True,6,2
19891,8,59,40,99,True,6,2
19892,9,77,63,140,True,6,2
19893,10,117,127,244,True,6,2
19894,11,118,114,232,True,6,2
19895,12,159,138,297,True,6,2
19896,13,139,159,298,True,6,2
19897,14,137,178,315,True,6,2
19898,15,141,142,283,True,6,2
19899,16,143,115,258,True,6,2
19900,17,126,131,257,True,6,2
19901,18,124,152,276,True,6,2
19902,19,59,96,155,True,6,2
19903,20,46,73,119,True,6,2
19904,21,42,53,95,True,6,2
19905,22,17,22,39,True,6,2
19906,23,17,23,40,True,6,2
19907,0,5,13,18,False,0,2
19908,1,10,16,26,False,0,2
19909,2,7,12,19,False,0,2
19910,3,22,14,36,False,0,2
19911,4,66,39,105,False,0,2
19912,5,125,94,219,False,0,2
19913,6,190,104,294,False,0,2
19914,7,197,115,312,False,0,2
19915,8,174,115,289,False,0,2
19916,9,179,131,310,False,0,2
19917,10,172,144,316,False,0,2
19918,11,166,198,364,False,0,2
19919,12,185,218,403,False,0,2
19920,13,192,204,396,False,0,2
19921,14,149,196,345,False,0,2
19922,15,149,151,300,False,0,2
19923,16,130,128,258,False,0,2
19924,17,123,125,248,False,0,2
19925,18,96,107,203,False,0,2
19926,19,65,78,143,False,0,2
19927,20,38,149,187,False,0,2
19928,21,33,124,157,False,0,2
19929,22,22,77,99,False,0,2
19930,23,18,41,59,False,0,2
19931,0,12,20,32,False,1,2
19932,1,17,15,32,False,1,2
19933,2,11,10,21,False,1,2
19934,3,20,13,33,False,1,2
19935,4,68,33,101,False,1,2
19936,5,125,90,215,False,1,2
19937,6,164,107,271,False,1,2
19938,7,170,90,260,False,1,2
19939,8,165,100,265,False,1,2
19940,9,162,120,282,False,1,2
19941,10,174,128,302,False,1,2
19942,11,178,170,348,False,1,2
19943,12,191,207,398,False,1,2
19944,13,173,213,386,False,1,2
19945,14,142,213,355,False,1,2
19946,15,139,143,282,False,1,2
19947,16,141,132,273,False,1,2
19948,17,122,127,249,False,1,2
19949,18,76,105,181,False,1,2
19950,19,57,68,125,False,1,2
19951,20,55,78,133,False,1,2
19952,21,25,58,83,False,1,2
19953,22,21,20,41,False,1,2
19954,23,15,27,42,False,1,2
19955,0,14,22,36,False,2,2
19956,1,8,19,27,False,2,2
19957,2,12,16,28,False,2,2
19958,3,8,12,20,False,2,2
19959,4,53,34,87,False,2,2
19960,5,106,63,169,False,2,2
19961,6,135,66,201,False,2,2
19962,7,119,82,201,False,2,2
19963,8,134,113,247,False,2,2
19964,9,160,165,325,False,2,2
19965,10,232,189,421,False,2,2
19966,11,159,169,328,False,2,2
19967,12,152,157,309,False,2,2
19968,13,127,145,272,False,2,2
19969,14,119,131,250,False,2,2
19970,15,102,109,211,False,2,2
19971,16,112,124,236,False,2,2
19972,17,91,87,178,False,2,2
19973,18,65,96,161,False,2,2
19974,19,60,78,138,False,2,2
19975,20,55,59,114,False,2,2
19976,21,25,50,75,False,2,2
19977,22,22,25,47,False,2,2
19978,23,14,32,46,False,2,2
19979,0,15,30,45,True,3,2
19980,1,8,26,34,True,3,2
19981,2,4,17,21,True,3,2
19982,3,4,7,11,True,3,2
19983,4,19,5,24,True,3,2
19984,5,13,16,29,True,3,2
19985,6,21,23,44,True,3,2
19986,7,38,32,70,True,3,2
19987,8,47,41,88,True,3,2
19988,9,74,46,120,True,3,2
19989,10,90,88,178,True,3,2
19990,11,88,95,183,True,3,2
19991,12,98,130,228,True,3,2
19992,13,106,98,204,True,3,2
19993,14,109,113,222,True,3,2
19994,15,111,122,233,True,3,2
19995,16,92,108,200,True,3,2
19996,17,79,116,195,True,3,2
19997,18,80,73,153,True,3,2
19998,19,50,64,114,True,3,2
19999,20,33,56,89,True,3,2
20000,21,21,39,60,True,3,2
20001,22,20,38,58,True,3,2
20002,23,18,31,49,True,3,2
20003,0,15,37,52,True,4,2
20004,1,11,26,37,True,4,2
20005,2,6,11,17,True,4,2
20006,3,3,4,7,True,4,2
20007,4,13,8,21,True,4,2
20008,5,12,20,32,True,4,2
20009,6,17,7,24,True,4,2
20010,7,29,20,49,True,4,2
20011,8,44,42,86,True,4,2
20012,9,75,46,121,True,4,2
20013,10,96,80,176,True,4,2
20014,11,101,102,203,True,4,2
20015,12,122,127,249,True,4,2
20016,13,125,144,269,True,4,2
20017,14,94,127,221,True,4,2
20018,15,89,116,205,True,4,2
20019,16,104,98,202,True,4,2
20020,17,70,76,146,True,4,2
20021,18,78,76,154,True,4,2
20022,19,62,66,128,True,4,2
20023,20,48,54,102,True,4,2
20024,21,28,50,78,True,4,2
20025,22,15,49,64,True,4,2
20026,23,13,28,41,True,4,2
20027,0,20,21,41,False,5,2
20028,1,12,31,43,False,5,2
20029,2,10,14,24,False,5,2
20030,3,6,11,17,False,5,2
20031,4,14,13,27,False,5,2
20032,5,13,19,32,False,5,2
20033,6,26,22,48,False,5,2
20034,7,52,45,97,False,5,2
20035,8,91,68,159,False,5,2
20036,9,121,133,254,False,5,2
20037,10,98,146,244,False,5,2
20038,11,111,131,242,False,5,2
20039,12,107,106,213,False,5,2
20040,13,91,130,221,False,5,2
20041,14,134,129,263,False,5,2
20042,15,96,108,204,False,5,2
20043,16,103,88,191,False,5,2
20044,17,80,80,160,False,5,2
20045,18,74,93,167,False,5,2
20046,19,68,76,144,False,5,2
20047,20,46,65,111,False,5,2
20048,21,36,58,94,False,5,2
20049,22,34,55,89,False,5,2
20050,23,23,28,51,False,5,2
20051,0,23,40,63,True,6,3
20052,1,18,50,68,True,6,3
20053,2,12,19,31,True,6,3
20054,3,6,21,27,True,6,3
20055,4,15,9,24,True,6,3
20056,5,11,10,21,True,6,3
20057,6,17,24,41,True,6,3
20058,7,55,23,78,True,6,3
20059,8,60,82,142,True,6,3
20060,9,56,53,109,True,6,3
20061,10,95,98,193,True,6,3
20062,11,98,111,209,True,6,3
20063,12,128,144,272,True,6,3
20064,13,106,124,230,True,6,3
20065,14,89,147,236,True,6,3
20066,15,101,104,205,True,6,3
20067,16,118,107,225,True,6,3
20068,17,98,120,218,True,6,3
20069,18,114,114,228,True,6,3
20070,19,93,97,190,True,6,3
20071,20,60,58,118,True,6,3
20072,21,45,52,97,True,6,3
20073,22,24,35,59,True,6,3
20074,23,14,18,32,True,6,3
20075,0,11,11,22,True,0,3
20076,1,14,28,42,True,0,3
20077,2,6,10,16,True,0,3
20078,3,4,6,10,True,0,3
20079,4,20,14,34,True,0,3
20080,5,12,8,20,True,0,3
20081,6,24,20,44,True,0,3
20082,7,36,31,67,True,0,3
20083,8,47,36,83,True,0,3
20084,9,99,66,165,True,0,3
20085,10,109,98,207,True,0,3
20086,11,109,123,232,True,0,3
20087,12,188,161,349,True,0,3
20088,13,148,194,342,True,0,3
20089,14,168,169,337,True,0,3
20090,15,131,145,276,True,0,3
20091,16,155,170,325,True,0,3
20092,17,148,141,289,True,0,3
20093,18,142,156,298,True,0,3
20094,19,79,103,182,True,0,3
20095,20,59,76,135,True,0,3
20096,21,31,41,72,True,0,3
20097,22,16,22,38,True,0,3
20098,23,11,11,22,True,0,3
20099,0,0,14,14,False,1,3
20100,1,2,13,15,False,1,3
20101,2,1,2,3,False,1,3
20102,3,24,8,32,False,1,3
20103,4,108,47,155,False,1,3
20104,5,226,127,353,False,1,3
20105,6,403,189,592,False,1,3
20106,7,269,150,419,False,1,3
20107,8,216,159,375,False,1,3
20108,9,188,163,351,False,1,3
20109,10,189,192,381,False,1,3
20110,11,199,188,387,False,1,3
20111,12,220,241,461,False,1,3
20112,13,226,325,551,False,1,3
20113,14,199,291,490,False,1,3
20114,15,177,191,368,False,1,3
20115,16,176,152,328,False,1,3
20116,17,142,150,292,False,1,3
20117,18,135,125,260,False,1,3
20118,19,95,117,212,False,1,3
20119,20,60,83,143,False,1,3
20120,21,30,27,57,False,1,3
20121,22,15,19,34,False,1,3
20122,23,19,11,30,False,1,3
20123,0,10,18,28,False,2,3
20124,1,5,15,20,False,2,3
20125,2,7,11,18,False,2,3
20126,3,23,14,37,False,2,3
20127,4,103,43,146,False,2,3
20128,5,238,127,365,False,2,3
20129,6,383,207,590,False,2,3
20130,7,262,174,436,False,2,3
20131,8,231,173,404,False,2,3
20132,9,212,144,356,False,2,3
20133,10,207,185,392,False,2,3
20134,11,216,200,416,False,2,3
20135,12,197,245,442,False,2,3
20136,13,251,329,580,False,2,3
20137,14,205,279,484,False,2,3
20138,15,196,180,376,False,2,3
20139,16,150,163,313,False,2,3
20140,17,129,152,281,False,2,3
20141,18,120,146,266,False,2,3
20142,19,95,99,194,False,2,3
20143,20,58,96,154,False,2,3
20144,21,53,56,109,False,2,3
20145,22,29,33,62,False,2,3
20146,23,16,14,30,False,2,3
20147,0,12,18,30,False,3,3
20148,1,10,25,35,False,3,3
20149,2,7,9,16,False,3,3
20150,3,13,12,25,False,3,3
20151,4,91,50,141,False,3,3
20152,5,230,139,369,False,3,3
20153,6,412,200,612,False,3,3
20154,7,274,175,449,False,3,3
20155,8,215,168,383,False,3,3
20156,9,228,159,387,False,3,3
20157,10,215,205,420,False,3,3
20158,11,211,208,419,False,3,3
20159,12,202,243,445,False,3,3
20160,13,249,313,562,False,3,3
20161,14,240,309,549,False,3,3
20162,15,220,226,446,False,3,3
20163,16,186,153,339,False,3,3
20164,17,139,177,316,False,3,3
20165,18,101,142,243,False,3,3
20166,19,110,124,234,False,3,3
20167,20,66,386,452,False,3,3
20168,21,35,262,297,False,3,3
20169,22,21,105,126,False,3,3
20170,23,14,57,71,False,3,3
20171,0,10,61,71,False,4,3
20172,1,9,50,59,False,4,3
20173,2,7,41,48,False,4,3
20174,3,19,20,39,False,4,3
20175,4,112,49,161,False,4,3
20176,5,252,149,401,False,4,3
20177,6,377,196,573,False,4,3
20178,7,259,162,421,False,4,3
20179,8,210,165,375,False,4,3
20180,9,240,177,417,False,4,3
20181,10,218,220,438,False,4,3
20182,11,199,236,435,False,4,3
20183,12,234,263,497,False,4,3
20184,13,265,327,592,False,4,3
20185,14,240,295,535,False,4,3
20186,15,179,195,374,False,4,3
20187,16,161,142,303,False,4,3
20188,17,110,115,225,False,4,3
20189,18,98,120,218,False,4,3
20190,19,77,86,163,False,4,3
20191,20,52,89,141,False,4,3
20192,21,45,60,105,False,4,3
20193,22,38,57,95,False,4,3
20194,23,29,31,60,False,4,3
20195,0,16,40,56,False,5,3
20196,1,12,48,60,False,5,3
20197,2,9,18,27,False,5,3
20198,3,8,22,30,False,5,3
20199,4,17,15,32,False,5,3
20200,5,24,26,50,False,5,3
20201,6,44,48,92,False,5,3
20202,7,81,45,126,False,5,3
20203,8,121,74,195,False,5,3
20204,9,168,111,279,False,5,3
20205,10,176,172,348,False,5,3
20206,11,164,161,325,False,5,3
20207,12,166,179,345,False,5,3
20208,13,147,182,329,False,5,3
20209,14,127,191,318,False,5,3
20210,15,145,154,299,False,5,3
20211,16,134,154,288,False,5,3
20212,17,104,109,213,False,5,3
20213,18,82,103,185,False,5,3
20214,19,78,108,186,False,5,3
20215,20,73,78,151,False,5,3
20216,21,53,69,122,False,5,3
20217,22,35,53,88,False,5,3
20218,23,35,43,78,False,5,3
20219,0,26,54,80,True,6,3
20220,1,24,64,88,True,6,3
20221,2,29,50,79,True,6,3
20222,3,13,23,36,True,6,3
20223,4,12,8,20,True,6,3
20224,5,14,20,34,True,6,3
20225,6,34,8,42,True,6,3
20226,7,45,46,91,True,6,3
20227,8,100,51,151,True,6,3
20228,9,94,90,184,True,6,3
20229,10,135,119,254,True,6,3
20230,11,164,179,343,True,6,3
20231,12,174,192,366,True,6,3
20232,13,167,193,360,True,6,3
20233,14,129,199,328,True,6,3
20234,15,166,182,348,True,6,3
20235,16,143,150,293,True,6,3
20236,17,123,146,269,True,6,3
20237,18,180,167,347,True,6,3
20238,19,81,94,175,True,6,3
20239,20,55,79,134,True,6,3
20240,21,20,41,61,True,6,3
20241,22,10,14,24,True,6,3
20242,23,10,19,29,True,6,3
20243,0,7,14,21,False,0,3
20244,1,5,13,18,False,0,3
20245,2,15,8,23,False,0,3
20246,3,20,15,35,False,0,3
20247,4,119,53,172,False,0,3
20248,5,257,143,400,False,0,3
20249,6,444,227,671,False,0,3
20250,7,281,173,454,False,0,3
20251,8,231,172,403,False,0,3
20252,9,229,193,422,False,0,3
20253,10,192,179,371,False,0,3
20254,11,222,188,410,False,0,3
20255,12,212,259,471,False,0,3
20256,13,237,346,583,False,0,3
20257,14,232,314,546,False,0,3
20258,15,197,192,389,False,0,3
20259,16,190,170,360,False,0,3
20260,17,138,175,313,False,0,3
20261,18,109,138,247,False,0,3
20262,19,95,116,211,False,0,3
20263,20,80,110,190,False,0,3
20264,21,26,42,68,False,0,3
20265,22,19,34,53,False,0,3
20266,23,9,12,21,False,0,3
20267,0,4,11,15,False,1,3
20268,1,5,12,17,False,1,3
20269,2,9,10,19,False,1,3
20270,3,20,18,38,False,1,3
20271,4,108,54,162,False,1,3
20272,5,267,148,415,False,1,3
20273,6,416,189,605,False,1,3
20274,7,265,180,445,False,1,3
20275,8,264,194,458,False,1,3
20276,9,229,191,420,False,1,3
20277,10,199,206,405,False,1,3
20278,11,227,241,468,False,1,3
20279,12,210,275,485,False,1,3
20280,13,278,345,623,False,1,3
20281,14,235,335,570,False,1,3
20282,15,203,206,409,False,1,3
20283,16,202,163,365,False,1,3
20284,17,160,176,336,False,1,3
20285,18,134,140,274,False,1,3
20286,19,86,128,214,False,1,3
20287,20,54,142,196,False,1,3
20288,21,26,55,81,False,1,3
20289,22,25,23,48,False,1,3
20290,23,18,12,30,False,1,3
20291,0,4,24,28,False,2,3
20292,1,8,16,24,False,2,3
20293,2,10,11,21,False,2,3
20294,3,21,14,35,False,2,3
20295,4,111,54,165,False,2,3
20296,5,242,149,391,False,2,3
20297,6,410,204,614,False,2,3
20298,7,250,138,388,False,2,3
20299,8,233,190,423,False,2,3
20300,9,208,217,425,False,2,3
20301,10,204,200,404,False,2,3
20302,11,220,215,435,False,2,3
20303,12,216,223,439,False,2,3
20304,13,264,351,615,False,2,3
20305,14,254,319,573,False,2,3
20306,15,206,206,412,False,2,3
20307,16,178,162,340,False,2,3
20308,17,140,196,336,False,2,3
20309,18,107,155,262,False,2,3
20310,19,100,128,228,False,2,3
20311,20,73,111,184,False,2,3
20312,21,31,55,86,False,2,3
20313,22,20,27,47,False,2,3
20314,23,12,25,37,False,2,3
20315,0,9,17,26,False,3,3
20316,1,7,19,26,False,3,3
20317,2,7,18,25,False,3,3
20318,3,12,18,30,False,3,3
20319,4,113,49,162,False,3,3
20320,5,234,176,410,False,3,3
20321,6,412,190,602,False,3,3
20322,7,282,165,447,False,3,3
20323,8,204,164,368,False,3,3
20324,9,235,204,439,False,3,3
20325,10,205,230,435,False,3,3
20326,11,235,215,450,False,3,3
20327,12,220,272,492,False,3,3
20328,13,248,351,599,False,3,3
20329,14,256,288,544,False,3,3
20330,15,209,207,416,False,3,3
20331,16,208,202,410,False,3,3
20332,17,161,199,360,False,3,3
20333,18,132,171,303,False,3,3
20334,19,86,130,216,False,3,3
20335,20,76,102,178,False,3,3
20336,21,35,44,79,False,3,3
20337,22,14,29,43,False,3,3
20338,23,15,29,44,False,3,3
20339,0,14,32,46,False,4,3
20340,1,10,24,34,False,4,3
20341,2,14,13,27,False,4,3
20342,3,20,13,33,False,4,3
20343,4,106,49,155,False,4,3
20344,5,244,157,401,False,4,3
20345,6,404,195,599,False,4,3
20346,7,227,173,400,False,4,3
20347,8,259,171,430,False,4,3
20348,9,218,174,392,False,4,3
20349,10,251,208,459,False,4,3
20350,11,232,255,487,False,4,3
20351,12,245,320,565,False,4,3
20352,13,300,367,667,False,4,3
20353,14,246,303,549,False,4,3
20354,15,168,186,354,False,4,3
20355,16,162,163,325,False,4,3
20356,17,113,129,242,False,4,3
20357,18,99,85,184,False,4,3
20358,19,83,99,182,False,4,3
20359,20,64,88,152,False,4,3
20360,21,51,62,113,False,4,3
20361,22,32,52,84,False,4,3
20362,23,20,38,58,False,4,3
20363,0,25,43,68,False,5,3
20364,1,17,37,54,False,5,3
20365,2,15,28,43,False,5,3
20366,3,10,15,25,False,5,3
20367,4,22,24,46,False,5,3
20368,5,39,25,64,False,5,3
20369,6,49,44,93,False,5,3
20370,7,87,54,141,False,5,3
20371,8,105,92,197,False,5,3
20372,9,158,126,284,False,5,3
20373,10,172,138,310,False,5,3
20374,11,154,165,319,False,5,3
20375,12,164,181,345,False,5,3
20376,13,132,208,340,False,5,3
20377,14,143,168,311,False,5,3
20378,15,139,165,304,False,5,3
20379,16,141,160,301,False,5,3
20380,17,101,130,231,False,5,3
20381,18,93,80,173,False,5,3
20382,19,59,81,140,False,5,3
20383,20,60,79,139,False,5,3
20384,21,46,58,104,False,5,3
20385,22,40,44,84,False,5,3
20386,23,26,47,73,False,5,3
20387,0,29,43,72,True,6,3
20388,1,17,47,64,True,6,3
20389,2,9,34,43,True,6,3
20390,3,15,19,34,True,6,3
20391,4,18,16,34,True,6,3
20392,5,8,19,27,True,6,3
20393,6,33,20,53,True,6,3
20394,7,55,33,88,True,6,3
20395,8,118,74,192,True,6,3
20396,9,157,101,258,True,6,3
20397,10,175,161,336,True,6,3
20398,11,159,202,361,True,6,3
20399,12,185,171,356,True,6,3
20400,13,163,214,377,True,6,3
20401,14,167,232,399,True,6,3
20402,15,166,200,366,True,6,3
20403,16,204,168,372,True,6,3
20404,17,142,185,327,True,6,3
20405,18,120,173,293,True,6,3
20406,19,90,136,226,True,6,3
20407,20,59,90,149,True,6,3
20408,21,28,50,78,True,6,3
20409,22,14,20,34,True,6,3
20410,23,7,9,16,True,6,3
20411,0,6,10,16,False,0,3
20412,1,5,14,19,False,0,3
20413,2,6,11,17,False,0,3
20414,3,20,15,35,False,0,3
20415,4,112,61,173,False,0,3
20416,5,237,157,394,False,0,3
20417,6,380,230,610,False,0,3
20418,7,276,180,456,False,0,3
20419,8,239,186,425,False,0,3
20420,9,203,163,366,False,0,3
20421,10,238,200,438,False,0,3
20422,11,235,204,439,False,0,3
20423,12,205,239,444,False,0,3
20424,13,274,359,633,False,0,3
20425,14,219,330,549,False,0,3
20426,15,199,215,414,False,0,3
20427,16,176,179,355,False,0,3
20428,17,142,143,285,False,0,3
20429,18,117,126,243,False,0,3
20430,19,103,142,245,False,0,3
20431,20,57,87,144,False,0,3
20432,21,41,49,90,False,0,3
20433,22,13,31,44,False,0,3
20434,23,9,11,20,False,0,3
20435,0,4,15,19,False,1,3
20436,1,4,11,15,False,1,3
20437,2,7,9,16,False,1,3
20438,3,27,28,55,False,1,3
20439,4,105,55,160,False,1,3
20440,5,253,162,415,False,1,3
20441,6,417,211,628,False,1,3
20442,7,281,183,464,False,1,3
20443,8,262,194,456,False,1,3
20444,9,220,186,406,False,1,3
20445,10,223,193,416,False,1,3
20446,11,190,205,395,False,1,3
20447,12,237,254,491,False,1,3
20448,13,245,354,599,False,1,3
20449,14,249,319,568,False,1,3
20450,15,200,187,387,False,1,3
20451,16,191,165,356,False,1,3
20452,17,148,158,306,False,1,3
20453,18,123,166,289,False,1,3
20454,19,80,115,195,False,1,3
20455,20,61,100,161,False,1,3
20456,21,38,49,87,False,1,3
20457,22,14,24,38,False,1,3
20458,23,8,18,26,False,1,3
20459,0,5,10,15,False,2,3
20460,1,6,10,16,False,2,3
20461,2,9,9,18,False,2,3
20462,3,17,16,33,False,2,3
20463,4,109,57,166,False,2,3
20464,5,259,141,400,False,2,3
20465,6,407,213,620,False,2,3
20466,7,284,161,445,False,2,3
20467,8,231,202,433,False,2,3
20468,9,227,190,417,False,2,3
20469,10,197,205,402,False,2,3
20470,11,217,222,439,False,2,3
20471,12,194,236,430,False,2,3
20472,13,253,359,612,False,2,3
20473,14,238,324,562,False,2,3
20474,15,216,189,405,False,2,3
20475,16,193,162,355,False,2,3
20476,17,137,166,303,False,2,3
20477,18,142,139,281,False,2,3
20478,19,92,126,218,False,2,3
20479,20,64,105,169,False,2,3
20480,21,34,178,212,False,2,3
20481,22,12,103,115,False,2,3
20482,23,16,23,39,False,2,3
20483,0,10,22,32,False,3,3
20484,1,6,15,21,False,3,3
20485,2,9,12,21,False,3,3
20486,3,20,15,35,False,3,3
20487,4,117,63,180,False,3,3
20488,5,267,162,429,False,3,3
20489,6,392,185,577,False,3,3
20490,7,234,152,386,False,3,3
20491,8,267,200,467,False,3,3
20492,9,216,201,417,False,3,3
20493,10,204,213,417,False,3,3
20494,11,229,218,447,False,3,3
20495,12,235,284,519,False,3,3
20496,13,271,405,676,False,3,3
20497,14,239,339,578,False,3,3
20498,15,227,200,427,False,3,3
20499,16,176,203,379,False,3,3
20500,17,176,194,370,False,3,3
20501,18,124,139,263,False,3,3
20502,19,85,131,216,False,3,3
20503,20,52,89,141,False,3,3
20504,21,28,74,102,False,3,3
20505,22,19,28,47,False,3,3
20506,23,11,24,35,False,3,3
20507,0,6,22,28,False,4,3
20508,1,2,20,22,False,4,3
20509,2,13,18,31,False,4,3
20510,3,19,10,29,False,4,3
20511,4,118,57,175,False,4,3
20512,5,258,153,411,False,4,3
20513,6,385,221,606,False,4,3
20514,7,233,177,410,False,4,3
20515,8,223,158,381,False,4,3
20516,9,254,169,423,False,4,3
20517,10,215,212,427,False,4,3
20518,11,233,254,487,False,4,3
20519,12,245,262,507,False,4,3
20520,13,241,304,545,False,4,3
20521,14,204,285,489,False,4,3
20522,15,148,169,317,False,4,3
20523,16,158,162,320,False,4,3
20524,17,134,126,260,False,4,3
20525,18,95,121,216,False,4,3
20526,19,83,85,168,False,4,3
20527,20,60,108,168,False,4,3
20528,21,58,65,123,False,4,3
20529,22,34,44,78,False,4,3
20530,23,28,39,67,False,4,3
20531,0,19,40,59,False,5,3
20532,1,9,41,50,False,5,3
20533,2,11,22,33,False,5,3
20534,3,17,11,28,False,5,3
20535,4,28,28,56,False,5,3
20536,5,27,26,53,False,5,3
20537,6,45,39,84,False,5,3
20538,7,75,48,123,False,5,3
20539,8,131,96,227,False,5,3
20540,9,134,119,253,False,5,3
20541,10,144,130,274,False,5,3
20542,11,184,156,340,False,5,3
20543,12,159,165,324,False,5,3
20544,13,171,202,373,False,5,3
20545,14,151,209,360,False,5,3
20546,15,167,204,371,False,5,3
20547,16,141,160,301,False,5,3
20548,17,115,136,251,False,5,3
20549,18,132,106,238,False,5,3
20550,19,65,78,143,False,5,3
20551,20,42,79,121,False,5,3
20552,21,61,70,131,False,5,3
20553,22,32,61,93,False,5,3
20554,23,30,57,87,False,5,3
20555,0,23,61,84,True,6,3
20556,1,21,58,79,True,6,3
20557,2,15,41,56,True,6,3
20558,3,15,13,28,True,6,3
20559,4,18,16,34,True,6,3
20560,5,12,14,26,True,6,3
20561,6,37,15,52,True,6,3
20562,7,56,58,114,True,6,3
20563,8,97,75,172,True,6,3
20564,9,129,117,246,True,6,3
20565,10,160,148,308,True,6,3
20566,11,152,192,344,True,6,3
20567,12,182,185,367,True,6,3
20568,13,164,176,340,True,6,3
20569,14,168,216,384,True,6,3
20570,15,149,157,306,True,6,3
20571,16,146,157,303,True,6,3
20572,17,148,148,296,True,6,3
20573,18,139,166,305,True,6,3
20574,19,86,108,194,True,6,3
20575,20,66,80,146,True,6,3
20576,21,38,39,77,True,6,3
20577,22,19,21,40,True,6,3
20578,23,13,23,36,True,6,3
20579,0,2,20,22,False,0,3
20580,1,7,16,23,False,0,3
20581,2,8,10,18,False,0,3
20582,3,19,10,29,False,0,3
20583,4,133,62,195,False,0,3
20584,5,253,177,430,False,0,3
20585,6,414,196,610,False,0,3
20586,7,267,151,418,False,0,3
20587,8,248,167,415,False,0,3
20588,9,225,179,404,False,0,3
20589,10,206,338,544,False,0,3
20590,11,197,357,554,False,0,3
20591,12,214,453,667,False,0,3
20592,13,258,262,520,False,0,3
20593,14,241,344,585,False,0,3
20594,15,198,354,552,False,0,3
20595,16,181,189,370,False,0,3
20596,17,131,166,297,False,0,3
20597,18,138,142,280,False,0,3
20598,19,92,116,208,False,0,3
20599,20,59,88,147,False,0,3
20600,21,40,41,81,False,0,3
20601,22,16,18,34,False,0,3
20602,23,14,16,30,False,0,3
20603,0,5,12,17,False,1,3
20604,1,4,9,13,False,1,3
20605,2,7,9,16,False,1,3
20606,3,31,14,45,False,1,3
20607,4,130,69,199,False,1,3
20608,5,263,155,418,False,1,3
20609,6,409,229,638,False,1,3
20610,7,296,169,465,False,1,3
20611,8,228,185,413,False,1,3
20612,9,232,215,447,False,1,3
20613,10,203,168,371,False,1,3
20614,11,230,241,471,False,1,3
20615,12,218,244,462,False,1,3
20616,13,250,339,589,False,1,3
20617,14,244,302,546,False,1,3
20618,15,207,222,429,False,1,3
20619,16,219,217,436,False,1,3
20620,17,156,177,333,False,1,3
20621,18,126,141,267,False,1,3
20622,19,67,95,162,False,1,3
20623,20,75,101,176,False,1,3
20624,21,50,63,113,False,1,3
20625,22,24,24,48,False,1,3
20626,23,17,18,35,False,1,3
20627,0,7,15,22,False,2,3
20628,1,4,13,17,False,2,3
20629,2,11,6,17,False,2,3
20630,3,25,16,41,False,2,3
20631,4,111,63,174,False,2,3
20632,5,242,141,383,False,2,3
20633,6,434,199,633,False,2,3
20634,7,276,173,449,False,2,3
20635,8,222,178,400,False,2,3
20636,9,247,164,411,False,2,3
20637,10,217,219,436,False,2,3
20638,11,216,233,449,False,2,3
20639,12,217,231,448,False,2,3
20640,13,251,333,584,False,2,3
20641,14,251,323,574,False,2,3
20642,15,184,211,395,False,2,3
20643,16,189,176,365,False,2,3
20644,17,139,154,293,False,2,3
20645,18,120,127,247,False,2,3
20646,19,97,126,223,False,2,3
20647,20,66,100,166,False,2,3
20648,21,41,60,101,False,2,3
20649,22,20,43,63,False,2,3
20650,23,10,19,29,False,2,3
20651,0,8,18,26,False,3,3
20652,1,7,16,23,False,3,3
20653,2,11,13,24,False,3,3
20654,3,23,17,40,False,3,3
20655,4,120,51,171,False,3,3
20656,5,240,169,409,False,3,3
20657,6,405,215,620,False,3,3
20658,7,251,157,408,False,3,3
20659,8,253,164,417,False,3,3
20660,9,223,165,388,False,3,3
20661,10,247,224,471,False,3,3
20662,11,216,220,436,False,3,3
20663,12,248,276,524,False,3,3
20664,13,286,375,661,False,3,3
20665,14,273,343,616,False,3,3
20666,15,227,215,442,False,3,3
20667,16,183,152,335,False,3,3
20668,17,147,179,326,False,3,3
20669,18,114,152,266,False,3,3
20670,19,103,128,231,False,3,3
20671,20,77,107,184,False,3,3
20672,21,47,88,135,False,3,3
20673,22,35,36,71,False,3,3
20674,23,12,29,41,False,3,3
20675,0,10,26,36,False,4,3
20676,1,7,31,38,False,4,3
20677,2,10,19,29,False,4,3
20678,3,26,16,42,False,4,3
20679,4,124,54,178,False,4,3
20680,5,261,156,417,False,4,3
20681,6,411,220,631,False,4,3
20682,7,259,163,422,False,4,3
20683,8,235,184,419,False,4,3
20684,9,253,195,448,False,4,3
20685,10,200,213,413,False,4,3
20686,11,260,241,501,False,4,3
20687,12,274,319,593,False,4,3
20688,13,267,346,613,False,4,3
20689,14,235,360,595,False,4,3
20690,15,185,213,398,False,4,3
20691,16,173,176,349,False,4,3
20692,17,135,169,304,False,4,3
20693,18,118,113,231,False,4,3
20694,19,96,96,192,False,4,3
20695,20,69,98,167,False,4,3
20696,21,44,70,114,False,4,3
20697,22,41,70,111,False,4,3
20698,23,30,34,64,False,4,3
20699,0,22,26,48,False,5,3
20700,1,17,37,54,False,5,3
20701,2,8,33,41,False,5,3
20702,3,12,14,26,False,5,3
20703,4,25,18,43,False,5,3
20704,5,35,33,68,False,5,3
20705,6,63,32,95,False,5,3
20706,7,115,54,169,False,5,3
20707,8,138,65,203,False,5,3
20708,9,169,94,263,False,5,3
20709,10,158,117,275,False,5,3
20710,11,151,131,282,False,5,3
20711,12,177,172,349,False,5,3
20712,13,136,133,269,False,5,3
20713,14,174,169,343,False,5,3
20714,15,142,161,303,False,5,3
20715,16,135,156,291,False,5,3
20716,17,115,130,245,False,5,3
20717,18,113,139,252,False,5,3
20718,19,85,117,202,False,5,3
20719,20,63,82,145,False,5,3
20720,21,60,81,141,False,5,3
20721,22,31,46,77,False,5,3
20722,23,43,48,91,False,5,3
20723,0,27,49,76,True,6,3
20724,1,34,50,84,True,6,3
20725,2,26,37,63,True,6,3
20726,3,17,9,26,True,6,3
20727,4,16,13,29,True,6,3
20728,5,18,16,34,True,6,3
20729,6,34,19,53,True,6,3
20730,7,69,50,119,True,6,3
20731,8,120,78,198,True,6,3
20732,9,136,109,245,True,6,3
20733,10,158,171,329,True,6,3
20734,11,171,167,338,True,6,3
20735,12,173,209,382,True,6,3
20736,13,137,237,374,True,6,3
20737,14,171,237,408,True,6,3
20738,15,152,197,349,True,6,3
20739,16,137,130,267,True,6,3
20740,17,144,178,322,True,6,3
20741,18,138,170,308,True,6,3
20742,19,87,132,219,True,6,3
20743,20,87,82,169,True,6,3
20744,21,49,49,98,True,6,3
20745,22,22,26,48,True,6,3
20746,23,11,17,28,True,6,3
20747,0,12,13,25,False,0,3
20748,1,10,12,22,False,0,3
20749,2,12,8,20,False,0,3
20750,3,23,9,32,False,0,3
20751,4,102,49,151,False,0,3
20752,5,223,126,349,False,0,3
20753,6,317,177,494,False,0,3
20754,7,248,168,416,False,0,3
20755,8,196,165,361,False,0,3
20756,9,228,179,407,False,0,3
20757,10,201,223,424,False,0,3
20758,11,226,239,465,False,0,3
20759,12,236,251,487,False,0,3
20760,13,249,452,701,False,0,3
20761,14,199,335,534,False,0,3
20762,15,197,191,388,False,0,3
20763,16,175,189,364,False,0,3
20764,17,148,145,293,False,0,3
20765,18,131,135,266,False,0,3
20766,19,92,119,211,False,0,3
20767,20,73,95,168,False,0,3
20768,21,38,68,106,False,0,3
20769,22,26,48,74,False,0,3
20770,23,28,37,65,False,0,3
20771,0,29,46,75,True,1,4
20772,1,17,38,55,True,1,4
20773,2,15,29,44,True,1,4
20774,3,11,14,25,True,1,4
20775,4,16,11,27,True,1,4
20776,5,28,24,52,True,1,4
20777,6,40,33,73,True,1,4
20778,7,68,35,103,True,1,4
20779,8,84,55,139,True,1,4
20780,9,103,92,195,True,1,4
20781,10,134,116,250,True,1,4
20782,11,130,151,281,True,1,4
20783,12,151,165,316,True,1,4
20784,13,137,151,288,True,1,4
20785,14,137,165,302,True,1,4
20786,15,131,156,287,True,1,4
20787,16,130,166,296,True,1,4
20788,17,122,152,274,True,1,4
20789,18,114,146,260,True,1,4
20790,19,73,85,158,True,1,4
20791,20,44,71,115,True,1,4
20792,21,25,41,66,True,1,4
20793,22,20,20,40,True,1,4
20794,23,9,20,29,True,1,4
20795,0,8,9,17,False,2,4
20796,1,6,17,23,False,2,4
20797,2,8,6,14,False,2,4
20798,3,19,17,36,False,2,4
20799,4,107,48,155,False,2,4
20800,5,246,145,391,False,2,4
20801,6,451,243,694,False,2,4
20802,7,280,177,457,False,2,4
20803,8,229,177,406,False,2,4
20804,9,214,198,412,False,2,4
20805,10,201,204,405,False,2,4
20806,11,241,241,482,False,2,4
20807,12,231,244,475,False,2,4
20808,13,246,359,605,False,2,4
20809,14,234,309,543,False,2,4
20810,15,202,217,419,False,2,4
20811,16,145,156,301,False,2,4
20812,17,148,174,322,False,2,4
20813,18,129,159,288,False,2,4
20814,19,85,124,209,False,2,4
20815,20,71,101,172,False,2,4
20816,21,38,51,89,False,2,4
20817,22,18,23,41,False,2,4
20818,23,18,16,34,False,2,4
20819,0,7,13,20,False,3,4
20820,1,11,20,31,False,3,4
20821,2,10,8,18,False,3,4
20822,3,17,14,31,False,3,4
20823,4,107,63,170,False,3,4
20824,5,255,163,418,False,3,4
20825,6,412,240,652,False,3,4
20826,7,259,162,421,False,3,4
20827,8,235,172,407,False,3,4
20828,9,230,184,414,False,3,4
20829,10,235,223,458,False,3,4
20830,11,240,213,453,False,3,4
20831,12,224,244,468,False,3,4
20832,13,230,356,586,False,3,4
20833,14,212,281,493,False,3,4
20834,15,227,226,453,False,3,4
20835,16,182,213,395,False,3,4
20836,17,155,182,337,False,3,4
20837,18,107,132,239,False,3,4
20838,19,101,111,212,False,3,4
20839,20,75,82,157,False,3,4
20840,21,45,63,108,False,3,4
20841,22,23,73,96,False,3,4
20842,23,12,31,43,False,3,4
20843,0,5,17,22,False,4,4
20844,1,11,21,32,False,4,4
20845,2,7,7,14,False,4,4
20846,3,24,14,38,False,4,4
20847,4,118,54,172,False,4,4
20848,5,268,188,456,False,4,4
20849,6,400,219,619,False,4,4
20850,7,252,164,416,False,4,4
20851,8,233,164,397,False,4,4
20852,9,246,189,435,False,4,4
20853,10,249,223,472,False,4,4
20854,11,230,240,470,False,4,4
20855,12,253,293,546,False,4,4
20856,13,240,363,603,False,4,4
20857,14,201,358,559,False,4,4
20858,15,175,184,359,False,4,4
20859,16,144,166,310,False,4,4
20860,17,121,140,261,False,4,4
20861,18,96,118,214,False,4,4
20862,19,81,117,198,False,4,4
20863,20,52,63,115,False,4,4
20864,21,49,52,101,False,4,4
20865,22,32,43,75,False,4,4
20866,23,24,26,50,False,4,4
20867,0,17,23,40,False,5,4
20868,1,19,31,50,False,5,4
20869,2,8,17,25,False,5,4
20870,3,8,13,21,False,5,4
20871,4,19,8,27,False,5,4
20872,5,30,28,58,False,5,4
20873,6,49,51,100,False,5,4
20874,7,71,50,121,False,5,4
20875,8,105,88,193,False,5,4
20876,9,159,109,268,False,5,4
20877,10,158,162,320,False,5,4
20878,11,141,144,285,False,5,4
20879,12,121,193,314,False,5,4
20880,13,144,145,289,False,5,4
20881,14,140,198,338,False,5,4
20882,15,149,143,292,False,5,4
20883,16,137,149,286,False,5,4
20884,17,106,140,246,False,5,4
20885,18,111,134,245,False,5,4
20886,19,70,102,172,False,5,4
20887,20,65,72,137,False,5,4
20888,21,42,71,113,False,5,4
20889,22,43,53,96,False,5,4
20890,23,33,44,77,False,5,4
20891,0,31,43,74,True,6,4
20892,1,31,68,99,True,6,4
20893,2,14,38,52,True,6,4
20894,3,12,13,25,True,6,4
20895,4,18,15,33,True,6,4
20896,5,16,23,39,True,6,4
20897,6,32,23,55,True,6,4
20898,7,54,47,101,True,6,4
20899,8,107,74,181,True,6,4
20900,9,125,65,190,True,6,4
20901,10,160,141,301,True,6,4
20902,11,171,186,357,True,6,4
20903,12,215,187,402,True,6,4
20904,13,164,194,358,True,6,4
20905,14,154,243,397,True,6,4
20906,15,162,209,371,True,6,4
20907,16,145,182,327,True,6,4
20908,17,157,187,344,True,6,4
20909,18,132,170,302,True,6,4
20910,19,88,130,218,True,6,4
20911,20,118,89,207,True,6,4
20912,21,41,62,103,True,6,4
20913,22,13,35,48,True,6,4
20914,23,7,15,22,True,6,4
20915,0,7,9,16,False,0,4
20916,1,4,5,9,False,0,4
20917,2,9,7,16,False,0,4
20918,3,23,14,37,False,0,4
20919,4,134,68,202,False,0,4
20920,5,261,157,418,False,0,4
20921,6,404,209,613,False,0,4
20922,7,264,162,426,False,0,4
20923,8,217,164,381,False,0,4
20924,9,209,189,398,False,0,4
20925,10,225,229,454,False,0,4
20926,11,225,226,451,False,0,4
20927,12,226,267,493,False,0,4
20928,13,245,343,588,False,0,4
20929,14,215,330,545,False,0,4
20930,15,200,222,422,False,0,4
20931,16,188,153,341,False,0,4
20932,17,147,141,288,False,0,4
20933,18,121,121,242,False,0,4
20934,19,96,149,245,False,0,4
20935,20,65,88,153,False,0,4
20936,21,30,66,96,False,0,4
20937,22,21,30,51,False,0,4
20938,23,11,21,32,False,0,4
20939,0,10,11,21,False,1,4
20940,1,4,17,21,False,1,4
20941,2,7,12,19,False,1,4
20942,3,17,11,28,False,1,4
20943,4,104,57,161,False,1,4
20944,5,258,176,434,False,1,4
20945,6,430,188,618,False,1,4
20946,7,271,197,468,False,1,4
20947,8,245,167,412,False,1,4
20948,9,237,177,414,False,1,4
20949,10,240,248,488,False,1,4
20950,11,199,203,402,False,1,4
20951,12,222,299,521,False,1,4
20952,13,228,363,591,False,1,4
20953,14,250,301,551,False,1,4
20954,15,184,186,370,False,1,4
20955,16,170,162,332,False,1,4
20956,17,144,168,312,False,1,4
20957,18,128,137,265,False,1,4
20958,19,101,124,225,False,1,4
20959,20,59,111,170,False,1,4
20960,21,43,80,123,False,1,4
20961,22,19,30,49,False,1,4
20962,23,13,22,35,False,1,4
20963,0,10,17,27,False,2,4
20964,1,6,14,20,False,2,4
20965,2,9,9,18,False,2,4
20966,3,23,14,37,False,2,4
20967,4,113,53,166,False,2,4
20968,5,220,173,393,False,2,4
20969,6,413,215,628,False,2,4
20970,7,250,179,429,False,2,4
20971,8,243,168,411,False,2,4
20972,9,254,206,460,False,2,4
20973,10,211,210,421,False,2,4
20974,11,232,243,475,False,2,4
20975,12,237,259,496,False,2,4
20976,13,289,355,644,False,2,4
20977,14,216,305,521,False,2,4
20978,15,179,202,381,False,2,4
20979,16,159,164,323,False,2,4
20980,17,134,151,285,False,2,4
20981,18,112,145,257,False,2,4
20982,19,95,121,216,False,2,4
20983,20,78,106,184,False,2,4
20984,21,51,65,116,False,2,4
20985,22,43,47,90,False,2,4
20986,23,18,35,53,False,2,4
20987,0,17,34,51,True,3,4
20988,1,16,32,48,True,3,4
20989,2,11,21,32,True,3,4
20990,3,8,10,18,True,3,4
20991,4,15,13,28,True,3,4
20992,5,28,21,49,True,3,4
20993,6,51,37,88,True,3,4
20994,7,56,36,92,True,3,4
20995,8,132,88,220,True,3,4
20996,9,121,97,218,True,3,4
20997,10,175,119,294,True,3,4
20998,11,142,166,308,True,3,4
20999,12,176,186,362,True,3,4
21000,13,170,243,413,True,3,4
21001,14,172,225,397,True,3,4
21002,15,142,216,358,True,3,4
21003,16,134,140,274,True,3,4
21004,17,136,149,285,True,3,4
21005,18,100,155,255,True,3,4
21006,19,99,110,209,True,3,4
21007,20,44,77,121,True,3,4
21008,21,37,58,95,True,3,4
21009,22,29,38,67,True,3,4
21010,23,11,17,28,True,3,4
21011,0,5,17,22,False,4,4
21012,1,6,17,23,False,4,4
21013,2,9,12,21,False,4,4
21014,3,19,13,32,False,4,4
21015,4,81,45,126,False,4,4
21016,5,205,103,308,False,4,4
21017,6,289,149,438,False,4,4
21018,7,224,155,379,False,4,4
21019,8,231,171,402,False,4,4
21020,9,214,200,414,False,4,4
21021,10,222,233,455,False,4,4
21022,11,221,222,443,False,4,4
21023,12,211,260,471,False,4,4
21024,13,230,262,492,False,4,4
21025,14,181,244,425,False,4,4
21026,15,157,191,348,False,4,4
21027,16,123,151,274,False,4,4
21028,17,99,144,243,False,4,4
21029,18,93,133,226,False,4,4
21030,19,86,99,185,False,4,4
21031,20,63,90,153,False,4,4
21032,21,44,56,100,False,4,4
21033,22,32,42,74,False,4,4
21034,23,22,44,66,False,4,4
21035,0,17,24,41,False,5,4
21036,1,16,36,52,False,5,4
21037,2,12,18,30,False,5,4
21038,3,13,13,26,False,5,4
21039,4,23,16,39,False,5,4
21040,5,31,26,57,False,5,4
21041,6,42,39,81,False,5,4
21042,7,75,70,145,False,5,4
21043,8,115,83,198,False,5,4
21044,9,145,112,257,False,5,4
21045,10,146,164,310,False,5,4
21046,11,155,138,293,False,5,4
21047,12,131,145,276,False,5,4
21048,13,136,173,309,False,5,4
21049,14,138,159,297,False,5,4
21050,15,124,166,290,False,5,4
21051,16,98,139,237,False,5,4
21052,17,106,113,219,False,5,4
21053,18,99,96,195,False,5,4
21054,19,50,88,138,False,5,4
21055,20,52,65,117,False,5,4
21056,21,50,62,112,False,5,4
21057,22,43,57,100,False,5,4
21058,23,37,49,86,False,5,4
21059,0,25,38,63,True,6,4
21060,1,24,49,73,True,6,4
21061,2,22,37,59,True,6,4
21062,3,12,14,26,True,6,4
21063,4,15,11,26,True,6,4
21064,5,11,16,27,True,6,4
21065,6,30,25,55,True,6,4
21066,7,52,50,102,True,6,4
21067,8,85,71,156,True,6,4
21068,9,118,97,215,True,6,4
21069,10,154,131,285,True,6,4
21070,11,148,171,319,True,6,4
21071,12,160,202,362,True,6,4
21072,13,147,171,318,True,6,4
21073,14,153,193,346,True,6,4
21074,15,174,178,352,True,6,4
21075,16,176,187,363,True,6,4
21076,17,134,172,306,True,6,4
21077,18,119,167,286,True,6,4
21078,19,130,156,286,True,6,4
21079,20,64,97,161,True,6,4
21080,21,42,59,101,True,6,4
21081,22,21,42,63,True,6,4
21082,23,14,20,34,True,6,4
21083,0,6,12,18,False,0,4
21084,1,5,18,23,False,0,4
21085,2,14,4,18,False,0,4
21086,3,25,20,45,False,0,4
21087,4,112,59,171,False,0,4
21088,5,238,169,407,False,0,4
21089,6,394,231,625,False,0,4
21090,7,281,172,453,False,0,4
21091,8,234,191,425,False,0,4
21092,9,243,177,420,False,0,4
21093,10,211,237,448,False,0,4
21094,11,245,222,467,False,0,4
21095,12,245,288,533,False,0,4
21096,13,249,366,615,False,0,4
21097,14,244,300,544,False,0,4
21098,15,205,214,419,False,0,4
21099,16,183,179,362,False,0,4
21100,17,143,182,325,False,0,4
21101,18,120,143,263,False,0,4
21102,19,90,151,241,False,0,4
21103,20,74,115,189,False,0,4
21104,21,34,60,94,False,0,4
21105,22,16,28,44,False,0,4
21106,23,7,16,23,False,0,4
21107,0,13,12,25,False,1,4
21108,1,6,10,16,False,1,4
21109,2,6,12,18,False,1,4
21110,3,22,15,37,False,1,4
21111,4,113,53,166,False,1,4
21112,5,229,169,398,False,1,4
21113,6,428,222,650,False,1,4
21114,7,299,189,488,False,1,4
21115,8,250,196,446,False,1,4
21116,9,232,199,431,False,1,4
21117,10,252,224,476,False,1,4
21118,11,243,260,503,False,1,4
21119,12,247,293,540,False,1,4
21120,13,286,363,649,False,1,4
21121,14,248,308,556,False,1,4
21122,15,181,192,373,False,1,4
21123,16,194,170,364,False,1,4
21124,17,167,178,345,False,1,4
21125,18,165,180,345,False,1,4
21126,19,108,141,249,False,1,4
21127,20,75,121,196,False,1,4
21128,21,56,64,120,False,1,4
21129,22,25,31,56,False,1,4
21130,23,8,23,31,False,1,4
21131,0,11,23,34,False,2,4
21132,1,4,16,20,False,2,4
21133,2,6,12,18,False,2,4
21134,3,15,15,30,False,2,4
21135,4,114,57,171,False,2,4
21136,5,269,166,435,False,2,4
21137,6,395,210,605,False,2,4
21138,7,297,195,492,False,2,4
21139,8,269,208,477,False,2,4
21140,9,223,223,446,False,2,4
21141,10,273,246,519,False,2,4
21142,11,244,256,500,False,2,4
21143,12,263,292,555,False,2,4
21144,13,299,433,732,False,2,4
21145,14,256,503,759,False,2,4
21146,15,194,320,514,False,2,4
21147,16,177,165,342,False,2,4
21148,17,174,178,352,False,2,4
21149,18,253,206,459,False,2,4
21150,19,126,170,296,False,2,4
21151,20,93,119,212,False,2,4
21152,21,67,80,147,False,2,4
21153,22,37,53,90,False,2,4
21154,23,17,34,51,False,2,4
21155,0,14,35,49,True,3,4
21156,1,18,38,56,True,3,4
21157,2,10,19,29,True,3,4
21158,3,20,15,35,True,3,4
21159,4,49,42,91,True,3,4
21160,5,82,54,136,True,3,4
21161,6,144,105,249,True,3,4
21162,7,274,194,468,True,3,4
21163,8,439,174,613,True,3,4
21164,9,242,238,480,True,3,4
21165,10,130,360,490,True,3,4
21166,11,143,366,509,True,3,4
21167,12,110,250,360,True,3,4
21168,13,118,188,306,True,3,4
21169,14,101,139,240,True,3,4
21170,15,96,146,242,True,3,4
21171,16,111,117,228,True,3,4
21172,17,110,109,219,True,3,4
21173,18,81,130,211,True,3,4
21174,19,88,109,197,True,3,4
21175,20,109,80,189,True,3,4
21176,21,58,133,191,True,3,4
21177,22,41,65,106,True,3,4
21178,23,25,60,85,True,3,4
21179,0,21,47,68,False,4,4
21180,1,24,56,80,False,4,4
21181,2,17,42,59,False,4,4
21182,3,22,21,43,False,4,4
21183,4,67,45,112,False,4,4
21184,5,111,95,206,False,4,4
21185,6,148,98,246,False,4,4
21186,7,170,125,295,False,4,4
21187,8,170,139,309,False,4,4
21188,9,187,171,358,False,4,4
21189,10,223,222,445,False,4,4
21190,11,200,185,385,False,4,4
21191,12,177,222,399,False,4,4
21192,13,180,271,451,False,4,4
21193,14,151,222,373,False,4,4
21194,15,155,146,301,False,4,4
21195,16,104,126,230,False,4,4
21196,17,116,129,245,False,4,4
21197,18,92,96,188,False,4,4
21198,19,80,106,186,False,4,4
21199,20,64,80,144,False,4,4
21200,21,46,44,90,False,4,4
21201,22,37,34,71,False,4,4
21202,23,17,28,45,False,4,4
21203,0,12,26,38,False,5,4
21204,1,10,23,33,False,5,4
21205,2,9,13,22,False,5,4
21206,3,15,7,22,False,5,4
21207,4,14,18,32,False,5,4
21208,5,28,29,57,False,5,4
21209,6,35,45,80,False,5,4
21210,7,55,53,108,False,5,4
21211,8,87,74,161,False,5,4
21212,9,113,111,224,False,5,4
21213,10,122,114,236,False,5,4
21214,11,118,135,253,False,5,4
21215,12,125,138,263,False,5,4
21216,13,110,140,250,False,5,4
21217,14,136,147,283,False,5,4
21218,15,120,149,269,False,5,4
21219,16,130,156,286,False,5,4
21220,17,87,134,221,False,5,4
21221,18,109,120,229,False,5,4
21222,19,89,93,182,False,5,4
21223,20,48,73,121,False,5,4
21224,21,54,56,110,False,5,4
21225,22,49,57,106,False,5,4
21226,23,19,38,57,False,5,4
21227,0,21,37,58,True,6,4
21228,1,18,47,65,True,6,4
21229,2,13,23,36,True,6,4
21230,3,11,15,26,True,6,4
21231,4,11,11,22,True,6,4
21232,5,20,24,44,True,6,4
21233,6,27,24,51,True,6,4
21234,7,39,35,74,True,6,4
21235,8,87,62,149,True,6,4
21236,9,84,59,143,True,6,4
21237,10,122,137,259,True,6,4
21238,11,125,113,238,True,6,4
21239,12,130,153,283,True,6,4
21240,13,115,181,296,True,6,4
21241,14,147,168,315,True,6,4
21242,15,124,124,248,True,6,4
21243,16,118,143,261,True,6,4
21244,17,133,161,294,True,6,4
21245,18,114,158,272,True,6,4
21246,19,81,122,203,True,6,4
21247,20,59,82,141,True,6,4
21248,21,48,66,114,True,6,4
21249,22,24,26,50,True,6,4
21250,23,18,28,46,True,6,4
21251,0,12,29,41,True,0,4
21252,1,13,23,36,True,0,4
21253,2,8,11,19,True,0,4
21254,3,12,6,18,True,0,4
21255,4,10,12,22,True,0,4
21256,5,28,27,55,True,0,4
21257,6,32,28,60,True,0,4
21258,7,46,46,92,True,0,4
21259,8,86,58,144,True,0,4
21260,9,106,107,213,True,0,4
21261,10,142,128,270,True,0,4
21262,11,115,143,258,True,0,4
21263,12,142,145,287,True,0,4
21264,13,147,174,321,True,0,4
21265,14,155,188,343,True,0,4
21266,15,129,178,307,True,0,4
21267,16,139,153,292,True,0,4
21268,17,167,173,340,True,0,4
21269,18,114,154,268,True,0,4
21270,19,111,133,244,True,0,4
21271,20,70,92,162,True,0,4
21272,21,35,66,101,True,0,4
21273,22,21,32,53,True,0,4
21274,23,16,19,35,True,0,4
21275,0,4,15,19,False,1,4
21276,1,8,10,18,False,1,4
21277,2,9,15,24,False,1,4
21278,3,22,17,39,False,1,4
21279,4,113,54,167,False,1,4
21280,5,216,156,372,False,1,4
21281,6,381,219,600,False,1,4
21282,7,291,184,475,False,1,4
21283,8,232,170,402,False,1,4
21284,9,198,186,384,False,1,4
21285,10,213,212,425,False,1,4
21286,11,231,229,460,False,1,4
21287,12,244,289,533,False,1,4
21288,13,257,373,630,False,1,4
21289,14,209,325,534,False,1,4
21290,15,181,200,381,False,1,4
21291,16,190,186,376,False,1,4
21292,17,135,147,282,False,1,4
21293,18,124,169,293,False,1,4
21294,19,98,121,219,False,1,4
21295,20,70,91,161,False,1,4
21296,21,31,50,81,False,1,4
21297,22,26,20,46,False,1,4
21298,23,15,16,31,False,1,4
21299,0,8,13,21,False,2,4
21300,1,7,9,16,False,2,4
21301,2,10,5,15,False,2,4
21302,3,18,12,30,False,2,4
21303,4,107,58,165,False,2,4
21304,5,230,166,396,False,2,4
21305,6,382,207,589,False,2,4
21306,7,261,159,420,False,2,4
21307,8,223,203,426,False,2,4
21308,9,224,185,409,False,2,4
21309,10,234,188,422,False,2,4
21310,11,230,219,449,False,2,4
21311,12,215,261,476,False,2,4
21312,13,243,344,587,False,2,4
21313,14,226,324,550,False,2,4
21314,15,187,193,380,False,2,4
21315,16,178,178,356,False,2,4
21316,17,146,168,314,False,2,4
21317,18,142,181,323,False,2,4
21318,19,106,137,243,False,2,4
21319,20,94,101,195,False,2,4
21320,21,50,61,111,False,2,4
21321,22,26,60,86,False,2,4
21322,23,13,24,37,False,2,4
21323,0,8,15,23,False,3,4
21324,1,9,13,22,False,3,4
21325,2,10,9,19,False,3,4
21326,3,11,10,21,False,3,4
21327,4,105,53,158,False,3,4
21328,5,228,165,393,False,3,4
21329,6,369,235,604,False,3,4
21330,7,278,165,443,False,3,4
21331,8,240,182,422,False,3,4
21332,9,227,200,427,False,3,4
21333,10,219,205,424,False,3,4
21334,11,249,246,495,False,3,4
21335,12,194,242,436,False,3,4
21336,13,262,346,608,False,3,4
21337,14,223,297,520,False,3,4
21338,15,200,206,406,False,3,4
21339,16,174,180,354,False,3,4
21340,17,144,188,332,False,3,4
21341,18,124,129,253,False,3,4
21342,19,96,136,232,False,3,4
21343,20,79,89,168,False,3,4
21344,21,51,58,109,False,3,4
21345,22,27,31,58,False,3,4
21346,23,14,20,34,False,3,4
21347,0,7,18,25,False,4,4
21348,1,8,25,33,False,4,4
21349,2,5,8,13,False,4,4
21350,3,24,14,38,False,4,4
21351,4,113,64,177,False,4,4
21352,5,228,153,381,False,4,4
21353,6,401,223,624,False,4,4
21354,7,266,181,447,False,4,4
21355,8,228,175,403,False,4,4
21356,9,253,204,457,False,4,4
21357,10,218,253,471,False,4,4
21358,11,238,264,502,False,4,4
21359,12,239,292,531,False,4,4
21360,13,278,430,708,False,4,4
21361,14,158,309,467,False,4,4
21362,15,168,173,341,False,4,4
21363,16,142,149,291,False,4,4
21364,17,130,143,273,False,4,4
21365,18,92,118,210,False,4,4
21366,19,82,104,186,False,4,4
21367,20,72,108,180,False,4,4
21368,21,56,72,128,False,4,4
21369,22,34,59,93,False,4,4
21370,23,26,40,66,False,4,4
21371,0,17,27,44,False,5,4
21372,1,18,39,57,False,5,4
21373,2,5,21,26,False,5,4
21374,3,8,11,19,False,5,4
21375,4,24,16,40,False,5,4
21376,5,27,20,47,False,5,4
21377,6,40,52,92,False,5,4
21378,7,69,64,133,False,5,4
21379,8,125,94,219,False,5,4
21380,9,147,117,264,False,5,4
21381,10,188,128,316,False,5,4
21382,11,167,164,331,False,5,4
21383,12,140,156,296,False,5,4
21384,13,118,164,282,False,5,4
21385,14,126,170,296,False,5,4
21386,15,144,144,288,False,5,4
21387,16,135,165,300,False,5,4
21388,17,130,152,282,False,5,4
21389,18,93,116,209,False,5,4
21390,19,56,78,134,False,5,4
21391,20,59,82,141,False,5,4
21392,21,72,105,177,False,5,4
21393,22,51,74,125,False,5,4
21394,23,32,51,83,False,5,4
21395,0,23,35,58,True,6,4
21396,1,22,51,73,True,6,4
21397,2,23,31,54,True,6,4
21398,3,21,17,38,True,6,4
21399,4,30,15,45,True,6,4
21400,5,20,13,33,True,6,4
21401,6,47,27,74,True,6,4
21402,7,60,60,120,True,6,4
21403,8,87,69,156,True,6,4
21404,9,104,102,206,True,6,4
21405,10,126,144,270,True,6,4
21406,11,134,155,289,True,6,4
21407,12,148,159,307,True,6,4
21408,13,148,161,309,True,6,4
21409,14,135,173,308,True,6,4
21410,15,144,161,305,True,6,4
21411,16,176,154,330,True,6,4
21412,17,170,166,336,True,6,4
21413,18,121,153,274,True,6,4
21414,19,99,143,242,True,6,4
21415,20,87,105,192,True,6,4
21416,21,58,76,134,True,6,4
21417,22,22,31,53,True,6,4
21418,23,9,23,32,True,6,4
21419,0,6,16,22,False,0,4
21420,1,6,9,15,False,0,4
21421,2,13,10,23,False,0,4
21422,3,24,12,36,False,0,4
21423,4,108,49,157,False,0,4
21424,5,231,154,385,False,0,4
21425,6,363,218,581,False,0,4
21426,7,286,176,462,False,0,4
21427,8,221,197,418,False,0,4
21428,9,250,181,431,False,0,4
21429,10,219,230,449,False,0,4
21430,11,229,245,474,False,0,4
21431,12,244,259,503,False,0,4
21432,13,266,348,614,False,0,4
21433,14,222,303,525,False,0,4
21434,15,180,197,377,False,0,4
21435,16,174,174,348,False,0,4
21436,17,139,160,299,False,0,4
21437,18,121,173,294,False,0,4
21438,19,103,152,255,False,0,4
21439,20,76,114,190,False,0,4
21440,21,47,61,108,False,0,4
21441,22,22,41,63,False,0,4
21442,23,9,17,26,False,0,4
21443,0,11,13,24,False,1,4
21444,1,9,9,18,False,1,4
21445,2,9,6,15,False,1,4
21446,3,20,14,34,False,1,4
21447,4,113,53,166,False,1,4
21448,5,237,175,412,False,1,4
21449,6,371,208,579,False,1,4
21450,7,252,172,424,False,1,4
21451,8,239,194,433,False,1,4
21452,9,221,169,390,False,1,4
21453,10,363,221,584,False,1,4
21454,11,245,214,459,False,1,4
21455,12,237,266,503,False,1,4
21456,13,272,333,605,False,1,4
21457,14,203,277,480,False,1,4
21458,15,193,201,394,False,1,4
21459,16,145,173,318,False,1,4
21460,17,148,164,312,False,1,4
21461,18,127,135,262,False,1,4
21462,19,110,155,265,False,1,4
21463,20,82,145,227,False,1,4
21464,21,36,80,116,False,1,4
21465,22,35,47,82,False,1,4
21466,23,14,21,35,False,1,4
21467,0,12,40,52,False,2,4
21468,1,10,18,28,False,2,4
21469,2,7,10,17,False,2,4
21470,3,18,17,35,False,2,4
21471,4,106,60,166,False,2,4
21472,5,211,157,368,False,2,4
21473,6,388,212,600,False,2,4
21474,7,256,185,441,False,2,4
21475,8,238,206,444,False,2,4
21476,9,194,204,398,False,2,4
21477,10,210,208,418,False,2,4
21478,11,216,234,450,False,2,4
21479,12,251,283,534,False,2,4
21480,13,285,369,654,False,2,4
21481,14,219,309,528,False,2,4
21482,15,206,171,377,False,2,4
21483,16,192,184,376,False,2,4
21484,17,134,187,321,False,2,4
21485,18,151,147,298,False,2,4
21486,19,95,163,258,False,2,4
21487,20,89,476,565,False,2,4
21488,21,69,368,437,False,2,4
21489,22,32,180,212,False,2,4
21490,23,26,93,119,False,2,4
21491,0,9,71,80,False,3,4
21492,1,9,18,27,False,3,4
21493,2,11,14,25,False,3,4
21494,3,14,20,34,False,3,4
21495,4,123,55,178,False,3,4
21496,5,225,158,383,False,3,4
21497,6,382,215,597,False,3,4
21498,7,264,165,429,False,3,4
21499,8,209,182,391,False,3,4
21500,9,261,206,467,False,3,4
21501,10,223,230,453,False,3,4
21502,11,218,228,446,False,3,4
21503,12,232,284,516,False,3,4
21504,13,291,364,655,False,3,4
21505,14,213,287,500,False,3,4
21506,15,180,180,360,False,3,4
21507,16,181,186,367,False,3,4
21508,17,117,172,289,False,3,4
21509,18,140,190,330,False,3,4
21510,19,121,142,263,False,3,4
21511,20,103,119,222,False,3,4
21512,21,34,69,103,False,3,4
21513,22,40,52,92,False,3,4
21514,23,24,33,57,False,3,4
21515,0,7,25,32,False,4,5
21516,1,9,22,31,False,4,5
21517,2,8,18,26,False,4,5
21518,3,22,22,44,False,4,5
21519,4,116,51,167,False,4,5
21520,5,213,135,348,False,4,5
21521,6,384,186,570,False,4,5
21522,7,261,185,446,False,4,5
21523,8,219,189,408,False,4,5
21524,9,244,233,477,False,4,5
21525,10,237,232,469,False,4,5
21526,11,250,276,526,False,4,5
21527,12,278,345,623,False,4,5
21528,13,279,376,655,False,4,5
21529,14,191,254,445,False,4,5
21530,15,147,188,335,False,4,5
21531,16,205,167,372,False,4,5
21532,17,132,163,295,False,4,5
21533,18,110,133,243,False,4,5
21534,19,100,128,228,False,4,5
21535,20,81,102,183,False,4,5
21536,21,65,74,139,False,4,5
21537,22,48,53,101,False,4,5
21538,23,35,48,83,False,4,5
21539,0,21,32,53,False,5,5
21540,1,21,34,55,False,5,5
21541,2,17,17,34,False,5,5
21542,3,14,23,37,False,5,5
21543,4,40,14,54,False,5,5
21544,5,29,101,130,False,5,5
21545,6,45,41,86,False,5,5
21546,7,79,64,143,False,5,5
21547,8,92,91,183,False,5,5
21548,9,144,116,260,False,5,5
21549,10,133,121,254,False,5,5
21550,11,128,153,281,False,5,5
21551,12,141,157,298,False,5,5
21552,13,133,153,286,False,5,5
21553,14,126,154,280,False,5,5
21554,15,150,172,322,False,5,5
21555,16,152,142,294,False,5,5
21556,17,106,118,224,False,5,5
21557,18,101,109,210,False,5,5
21558,19,79,106,185,False,5,5
21559,20,66,100,166,False,5,5
21560,21,57,82,139,False,5,5
21561,22,48,63,111,False,5,5
21562,23,41,42,83,False,5,5
21563,0,29,45,74,True,6,5
21564,1,18,40,58,True,6,5
21565,2,19,44,63,True,6,5
21566,3,15,20,35,True,6,5
21567,4,13,12,25,True,6,5
21568,5,17,13,30,True,6,5
21569,6,32,24,56,True,6,5
21570,7,63,49,112,True,6,5
21571,8,81,69,150,True,6,5
21572,9,125,96,221,True,6,5
21573,10,131,162,293,True,6,5
21574,11,172,160,332,True,6,5
21575,12,150,177,327,True,6,5
21576,13,154,170,324,True,6,5
21577,14,146,169,315,True,6,5
21578,15,173,224,397,True,6,5
21579,16,148,153,301,True,6,5
21580,17,152,192,344,True,6,5
21581,18,156,168,324,True,6,5
21582,19,116,146,262,True,6,5
21583,20,49,94,143,True,6,5
21584,21,37,50,87,True,6,5
21585,22,43,43,86,True,6,5
21586,23,9,21,30,True,6,5
21587,0,17,15,32,False,0,5
21588,1,5,16,21,False,0,5
21589,2,10,10,20,False,0,5
21590,3,25,18,43,False,0,5
21591,4,122,56,178,False,0,5
21592,5,224,134,358,False,0,5
21593,6,388,198,586,False,0,5
21594,7,230,141,371,False,0,5
21595,8,234,177,411,False,0,5
21596,9,380,221,601,False,0,5
21597,10,270,199,469,False,0,5
21598,11,212,211,423,False,0,5
21599,12,215,267,482,False,0,5
21600,13,266,363,629,False,0,5
21601,14,200,300,500,False,0,5
21602,15,179,201,380,False,0,5
21603,16,161,160,321,False,0,5
21604,17,140,152,292,False,0,5
21605,18,119,126,245,False,0,5
21606,19,104,139,243,False,0,5
21607,20,69,113,182,False,0,5
21608,21,42,62,104,False,0,5
21609,22,27,29,56,False,0,5
21610,23,15,23,38,False,0,5
21611,0,8,19,27,False,1,5
21612,1,6,7,13,False,1,5
21613,2,6,10,16,False,1,5
21614,3,14,18,32,False,1,5
21615,4,104,51,155,False,1,5
21616,5,237,130,367,False,1,5
21617,6,411,180,591,False,1,5
21618,7,288,192,480,False,1,5
21619,8,234,193,427,False,1,5
21620,9,227,206,433,False,1,5
21621,10,193,196,389,False,1,5
21622,11,216,215,431,False,1,5
21623,12,194,260,454,False,1,5
21624,13,267,366,633,False,1,5
21625,14,186,302,488,False,1,5
21626,15,171,190,361,False,1,5
21627,16,159,146,305,False,1,5
21628,17,136,153,289,False,1,5
21629,18,122,136,258,False,1,5
21630,19,103,138,241,False,1,5
21631,20,85,106,191,False,1,5
21632,21,47,54,101,False,1,5
21633,22,22,24,46,False,1,5
21634,23,26,22,48,False,1,5
21635,0,12,15,27,False,2,5
21636,1,9,20,29,False,2,5
21637,2,18,10,28,False,2,5
21638,3,14,15,29,False,2,5
21639,4,103,55,158,False,2,5
21640,5,233,152,385,False,2,5
21641,6,387,194,581,False,2,5
21642,7,270,155,425,False,2,5
21643,8,231,189,420,False,2,5
21644,9,237,207,444,False,2,5
21645,10,199,207,406,False,2,5
21646,11,211,232,443,False,2,5
21647,12,205,277,482,False,2,5
21648,13,269,319,588,False,2,5
21649,14,185,269,454,False,2,5
21650,15,187,165,352,False,2,5
21651,16,148,167,315,False,2,5
21652,17,126,134,260,False,2,5
21653,18,119,122,241,False,2,5
21654,19,82,129,211,False,2,5
21655,20,89,85,174,False,2,5
21656,21,60,42,102,False,2,5
21657,22,34,30,64,False,2,5
21658,23,20,20,40,False,2,5
21659,0,17,23,40,False,3,5
21660,1,15,21,36,False,3,5
21661,2,13,9,22,False,3,5
21662,3,13,10,23,False,3,5
21663,4,127,56,183,False,3,5
21664,5,229,141,370,False,3,5
21665,6,389,190,579,False,3,5
21666,7,264,188,452,False,3,5
21667,8,217,185,402,False,3,5
21668,9,218,186,404,False,3,5
21669,10,203,209,412,False,3,5
21670,11,206,230,436,False,3,5
21671,12,220,271,491,False,3,5
21672,13,221,330,551,False,3,5
21673,14,200,236,436,False,3,5
21674,15,158,203,361,False,3,5
21675,16,180,193,373,False,3,5
21676,17,151,181,332,False,3,5
21677,18,113,155,268,False,3,5
21678,19,93,144,237,False,3,5
21679,20,87,106,193,False,3,5
21680,21,57,51,108,False,3,5
21681,22,28,96,124,False,3,5
21682,23,16,31,47,False,3,5
21683,0,16,19,35,False,4,5
21684,1,9,29,38,False,4,5
21685,2,10,17,27,False,4,5
21686,3,16,14,30,False,4,5
21687,4,110,58,168,False,4,5
21688,5,217,145,362,False,4,5
21689,6,368,216,584,False,4,5
21690,7,262,165,427,False,4,5
21691,8,238,183,421,False,4,5
21692,9,234,207,441,False,4,5
21693,10,216,226,442,False,4,5
21694,11,230,246,476,False,4,5
21695,12,223,279,502,False,4,5
21696,13,247,379,626,False,4,5
21697,14,191,259,450,False,4,5
21698,15,158,192,350,False,4,5
21699,16,198,141,339,False,4,5
21700,17,179,150,329,False,4,5
21701,18,122,114,236,False,4,5
21702,19,92,106,198,False,4,5
21703,20,73,102,175,False,4,5
21704,21,79,64,143,False,4,5
21705,22,48,66,114,False,4,5
21706,23,41,45,86,False,4,5
21707,0,24,36,60,False,5,5
21708,1,14,25,39,False,5,5
21709,2,16,22,38,False,5,5
21710,3,20,17,37,False,5,5
21711,4,32,22,54,False,5,5
21712,5,33,24,57,False,5,5
21713,6,52,36,88,False,5,5
21714,7,96,71,167,False,5,5
21715,8,111,92,203,False,5,5
21716,9,159,100,259,False,5,5
21717,10,193,128,321,False,5,5
21718,11,169,151,320,False,5,5
21719,12,192,156,348,False,5,5
21720,13,173,157,330,False,5,5
21721,14,164,150,314,False,5,5
21722,15,156,162,318,False,5,5
21723,16,136,138,274,False,5,5
21724,17,106,123,229,False,5,5
21725,18,94,111,205,False,5,5
21726,19,67,87,154,False,5,5
21727,20,66,89,155,False,5,5
21728,21,48,84,132,False,5,5
21729,22,39,76,115,False,5,5
21730,23,40,46,86,False,5,5
21731,0,24,40,64,True,6,5
21732,1,26,52,78,True,6,5
21733,2,15,38,53,True,6,5
21734,3,18,9,27,True,6,5
21735,4,15,21,36,True,6,5
21736,5,19,16,35,True,6,5
21737,6,33,18,51,True,6,5
21738,7,49,47,96,True,6,5
21739,8,84,66,150,True,6,5
21740,9,126,84,210,True,6,5
21741,10,167,150,317,True,6,5
21742,11,170,171,341,True,6,5
21743,12,176,209,385,True,6,5
21744,13,168,211,379,True,6,5
21745,14,171,280,451,True,6,5
21746,15,163,193,356,True,6,5
21747,16,148,157,305,True,6,5
21748,17,139,192,331,True,6,5
21749,18,124,138,262,True,6,5
21750,19,97,124,221,True,6,5
21751,20,133,94,227,True,6,5
21752,21,55,54,109,True,6,5
21753,22,30,29,59,True,6,5
21754,23,14,22,36,True,6,5
21755,0,13,16,29,False,0,5
21756,1,7,17,24,False,0,5
21757,2,15,12,27,False,0,5
21758,3,16,14,30,False,0,5
21759,4,120,57,177,False,0,5
21760,5,226,135,361,False,0,5
21761,6,373,211,584,False,0,5
21762,7,287,193,480,False,0,5
21763,8,215,190,405,False,0,5
21764,9,210,172,382,False,0,5
21765,10,234,240,474,False,0,5
21766,11,232,245,477,False,0,5
21767,12,200,284,484,False,0,5
21768,13,258,321,579,False,0,5
21769,14,212,300,512,False,0,5
21770,15,172,178,350,False,0,5
21771,16,163,171,334,False,0,5
21772,17,136,163,299,False,0,5
21773,18,116,129,245,False,0,5
21774,19,103,125,228,False,0,5
21775,20,72,86,158,False,0,5
21776,21,39,37,76,False,0,5
21777,22,30,30,60,False,0,5
21778,23,23,17,40,False,0,5
21779,0,12,13,25,False,1,5
21780,1,11,10,21,False,1,5
21781,2,16,15,31,False,1,5
21782,3,19,11,30,False,1,5
21783,4,115,66,181,False,1,5
21784,5,216,138,354,False,1,5
21785,6,359,206,565,False,1,5
21786,7,242,170,412,False,1,5
21787,8,227,184,411,False,1,5
21788,9,228,189,417,False,1,5
21789,10,248,232,480,False,1,5
21790,11,226,235,461,False,1,5
21791,12,211,253,464,False,1,5
21792,13,269,318,587,False,1,5
21793,14,239,284,523,False,1,5
21794,15,165,188,353,False,1,5
21795,16,176,173,349,False,1,5
21796,17,135,158,293,False,1,5
21797,18,140,151,291,False,1,5
21798,19,102,121,223,False,1,5
21799,20,70,73,143,False,1,5
21800,21,50,75,125,False,1,5
21801,22,33,44,77,False,1,5
21802,23,17,31,48,False,1,5
21803,0,12,21,33,False,2,5
21804,1,15,23,38,False,2,5
21805,2,17,16,33,False,2,5
21806,3,12,13,25,False,2,5
21807,4,117,55,172,False,2,5
21808,5,226,147,373,False,2,5
21809,6,386,206,592,False,2,5
21810,7,288,178,466,False,2,5
21811,8,223,175,398,False,2,5
21812,9,259,200,459,False,2,5
21813,10,253,234,487,False,2,5
21814,11,226,215,441,False,2,5
21815,12,228,265,493,False,2,5
21816,13,259,353,612,False,2,5
21817,14,242,278,520,False,2,5
21818,15,180,221,401,False,2,5
21819,16,151,176,327,False,2,5
21820,17,140,150,290,False,2,5
21821,18,136,161,297,False,2,5
21822,19,88,113,201,False,2,5
21823,20,81,111,192,False,2,5
21824,21,55,61,116,False,2,5
21825,22,28,51,79,False,2,5
21826,23,24,47,71,False,2,5
21827,0,15,66,81,False,3,5
21828,1,3,43,46,False,3,5
21829,2,6,28,34,False,3,5
21830,3,17,14,31,False,3,5
21831,4,116,67,183,False,3,5
21832,5,219,121,340,False,3,5
21833,6,419,229,648,False,3,5
21834,7,271,179,450,False,3,5
21835,8,231,178,409,False,3,5
21836,9,222,182,404,False,3,5
21837,10,245,232,477,False,3,5
21838,11,222,238,460,False,3,5
21839,12,216,273,489,False,3,5
21840,13,283,362,645,False,3,5
21841,14,250,342,592,False,3,5
21842,15,195,193,388,False,3,5
21843,16,172,181,353,False,3,5
21844,17,140,145,285,False,3,5
21845,18,122,135,257,False,3,5
21846,19,92,115,207,False,3,5
21847,20,82,102,184,False,3,5
21848,21,55,77,132,False,3,5
21849,22,39,36,75,False,3,5
21850,23,24,27,51,False,3,5
21851,0,13,29,42,False,4,5
21852,1,20,16,36,False,4,5
21853,2,15,17,32,False,4,5
21854,3,16,12,28,False,4,5
21855,4,112,48,160,False,4,5
21856,5,243,145,388,False,4,5
21857,6,368,213,581,False,4,5
21858,7,259,216,475,False,4,5
21859,8,235,157,392,False,4,5
21860,9,281,223,504,False,4,5
21861,10,245,231,476,False,4,5
21862,11,235,257,492,False,4,5
21863,12,273,282,555,False,4,5
21864,13,250,329,579,False,4,5
21865,14,197,279,476,False,4,5
21866,15,155,195,350,False,4,5
21867,16,132,153,285,False,4,5
21868,17,129,140,269,False,4,5
21869,18,98,96,194,False,4,5
21870,19,76,100,176,False,4,5
21871,20,87,98,185,False,4,5
21872,21,66,83,149,False,4,5
21873,22,46,60,106,False,4,5
21874,23,23,50,73,False,4,5
21875,0,26,45,71,False,5,5
21876,1,22,38,60,False,5,5
21877,2,16,23,39,False,5,5
21878,3,15,17,32,False,5,5
21879,4,19,14,33,False,5,5
21880,5,32,22,54,False,5,5
21881,6,38,45,83,False,5,5
21882,7,73,66,139,False,5,5
21883,8,116,81,197,False,5,5
21884,9,199,123,322,False,5,5
21885,10,159,149,308,False,5,5
21886,11,159,151,310,False,5,5
21887,12,24,26,50,False,5,5
21888,10,217,186,403,False,0,5
21889,11,227,200,427,False,0,5
21890,12,189,248,437,False,0,5
21891,13,238,306,544,False,0,5
21892,14,190,263,453,False,0,5
21893,15,151,188,339,False,0,5
21894,16,145,167,312,False,0,5
21895,17,126,123,249,False,0,5
21896,18,101,90,191,False,0,5
21897,19,69,93,162,False,0,5
21898,20,75,95,170,False,0,5
21899,21,44,48,92,False,0,5
21900,22,18,28,46,False,0,5
21901,23,8,29,37,False,0,5
21902,0,8,14,22,False,1,5
21903,1,11,15,26,False,1,5
21904,2,10,11,21,False,1,5
21905,3,17,16,33,False,1,5
21906,4,101,56,157,False,1,5
21907,5,214,140,354,False,1,5
21908,6,278,142,420,False,1,5
21909,7,257,187,444,False,1,5
21910,8,187,185,372,False,1,5
21911,9,209,206,415,False,1,5
21912,10,211,213,424,False,1,5
21913,11,208,205,413,False,1,5
21914,12,211,245,456,False,1,5
21915,13,263,305,568,False,1,5
21916,14,215,257,472,False,1,5
21917,15,158,170,328,False,1,5
21918,16,143,150,293,False,1,5
21919,17,119,132,251,False,1,5
21920,18,110,114,224,False,1,5
21921,19,69,79,148,False,1,5
21922,20,73,76,149,False,1,5
21923,21,39,133,172,False,1,5
21924,22,18,41,59,False,1,5
21925,23,15,22,37,False,1,5
21926,0,15,14,29,False,2,5
21927,1,9,16,25,False,2,5
21928,2,7,12,19,False,2,5
21929,3,11,10,21,False,2,5
21930,4,111,53,164,False,2,5
21931,5,197,140,337,False,2,5
21932,6,314,177,491,False,2,5
21933,7,243,176,419,False,2,5
21934,8,196,181,377,False,2,5
21935,9,224,170,394,False,2,5
21936,10,191,195,386,False,2,5
21937,11,216,213,429,False,2,5
21938,12,209,240,449,False,2,5
21939,13,239,323,562,False,2,5
21940,14,194,279,473,False,2,5
21941,15,132,165,297,False,2,5
21942,16,158,175,333,False,2,5
21943,17,114,137,251,False,2,5
21944,18,102,113,215,False,2,5
21945,19,82,94,176,False,2,5
21946,20,80,294,374,False,2,5
21947,21,40,192,232,False,2,5
21948,22,24,97,121,False,2,5
21949,23,17,58,75,False,2,5
21950,0,15,53,68,False,3,5
21951,1,8,45,53,False,3,5
21952,2,11,39,50,False,3,5
21953,3,14,38,52,False,3,5
21954,4,109,45,154,False,3,5
21955,5,205,140,345,False,3,5
21956,6,300,165,465,False,3,5
21957,7,236,184,420,False,3,5
21958,8,198,158,356,False,3,5
21959,9,214,174,388,False,3,5
21960,10,203,199,402,False,3,5
21961,11,228,206,434,False,3,5
21962,12,230,249,479,False,3,5
21963,13,249,302,551,False,3,5
21964,14,182,247,429,False,3,5
21965,15,149,220,369,False,3,5
21966,16,147,161,308,False,3,5
21967,17,137,140,277,False,3,5
21968,18,108,131,239,False,3,5
21969,19,84,97,181,False,3,5
21970,20,55,432,487,False,3,5
21971,21,41,273,314,False,3,5
21972,22,16,187,203,False,3,5
21973,23,20,96,116,False,3,5
21974,0,9,30,39,False,4,5
21975,1,8,25,33,False,4,5
21976,2,5,11,16,False,4,5
21977,3,14,15,29,False,4,5
21978,4,108,45,153,False,4,5
21979,5,195,128,323,False,4,5
21980,6,286,146,432,False,4,5
21981,7,240,162,402,False,4,5
21982,8,214,188,402,False,4,5
21983,9,227,222,449,False,4,5
21984,10,248,207,455,False,4,5
21985,11,221,224,445,False,4,5
21986,12,224,307,531,False,4,5
21987,13,243,304,547,False,4,5
21988,14,151,218,369,False,4,5
21989,15,138,158,296,False,4,5
21990,16,140,141,281,False,4,5
21991,17,109,131,240,False,4,5
21992,18,116,101,217,False,4,5
21993,19,84,107,191,False,4,5
21994,20,64,74,138,False,4,5
21995,21,39,65,104,False,4,5
21996,22,33,56,89,False,4,5
21997,23,22,36,58,False,4,5
21998,0,11,29,40,False,5,5
21999,1,20,26,46,False,5,5
22000,2,13,22,35,False,5,5
22001,3,16,12,28,False,5,5
22002,4,25,9,34,False,5,5
22003,5,21,30,51,False,5,5
22004,6,38,28,66,False,5,5
22005,7,59,57,116,False,5,5
22006,8,101,88,189,False,5,5
22007,9,123,111,234,False,5,5
22008,10,124,118,242,False,5,5
22009,11,140,158,298,False,5,5
22010,12,131,152,283,False,5,5
22011,13,113,141,254,False,5,5
22012,14,107,141,248,False,5,5
22013,15,91,109,200,False,5,5
22014,16,118,132,250,False,5,5
22015,17,92,122,214,False,5,5
22016,18,76,91,167,False,5,5
22017,19,70,79,149,False,5,5
22018,20,61,96,157,False,5,5
22019,21,55,86,141,False,5,5
22020,22,37,45,82,False,5,5
22021,23,23,39,62,False,5,5
22022,0,23,45,68,True,6,6
22023,1,13,30,43,True,6,6
22024,2,16,32,48,True,6,6
22025,3,13,13,26,True,6,6
22026,4,17,9,26,True,6,6
22027,5,21,19,40,True,6,6
22028,6,27,23,50,True,6,6
22029,7,41,43,84,True,6,6
22030,8,73,64,137,True,6,6
22031,9,96,77,173,True,6,6
22032,10,107,125,232,True,6,6
22033,11,129,122,251,True,6,6
22034,12,151,162,313,True,6,6
22035,13,137,187,324,True,6,6
22036,14,119,181,300,True,6,6
22037,15,115,159,274,True,6,6
22038,16,115,139,254,True,6,6
22039,17,136,159,295,True,6,6
22040,18,163,134,297,True,6,6
22041,19,92,96,188,True,6,6
22042,20,54,56,110,True,6,6
22043,21,56,69,125,True,6,6
22044,22,28,29,57,True,6,6
22045,23,14,23,37,True,6,6
22046,0,13,17,30,False,0,6
22047,1,8,19,27,False,0,6
22048,2,7,13,20,False,0,6
22049,3,18,12,30,False,0,6
22050,4,102,36,138,False,0,6
22051,5,181,127,308,False,0,6
22052,6,248,158,406,False,0,6
22053,7,237,154,391,False,0,6
22054,8,228,155,383,False,0,6
22055,9,207,174,381,False,0,6
22056,10,185,203,388,False,0,6
22057,11,185,218,403,False,0,6
22058,12,185,239,424,False,0,6
22059,13,211,272,483,False,0,6
22060,14,187,231,418,False,0,6
22061,15,122,161,283,False,0,6
22062,16,127,123,250,False,0,6
22063,17,128,147,275,False,0,6
22064,18,106,119,225,False,0,6
22065,19,85,90,175,False,0,6
22066,20,83,266,349,False,0,6
22067,21,40,187,227,False,0,6
22068,22,25,72,97,False,0,6
22069,23,19,52,71,False,0,6
22070,0,8,16,24,False,1,6
22071,1,10,9,19,False,1,6
22072,2,2,6,8,False,1,6
22073,3,13,11,24,False,1,6
22074,4,99,43,142,False,1,6
22075,5,194,122,316,False,1,6
22076,6,259,147,406,False,1,6
22077,7,121,101,222,False,1,6
22078,9,202,165,367,False,1,6
22079,10,192,191,383,False,1,6
22080,11,198,188,386,False,1,6
22081,12,226,257,483,False,1,6
22082,13,230,272,502,False,1,6
22083,14,177,216,393,False,1,6
22084,15,137,168,305,False,1,6
22085,16,122,116,238,False,1,6
22086,17,114,118,232,False,1,6
22087,18,96,102,198,False,1,6
22088,19,78,78,156,False,1,6
22089,20,54,68,122,False,1,6
22090,21,37,77,114,False,1,6
22091,22,23,24,47,False,1,6
22092,23,23,62,85,False,1,6
22093,0,13,50,63,False,2,6
22094,1,15,29,44,False,2,6
22095,2,12,28,40,False,2,6
22096,3,19,13,32,False,2,6
22097,4,97,39,136,False,2,6
22098,5,168,114,282,False,2,6
22099,6,256,144,400,False,2,6
22100,7,217,136,353,False,2,6
22101,8,137,120,257,False,2,6
22102,10,191,190,381,False,2,6
22103,11,179,176,355,False,2,6
22104,12,202,228,430,False,2,6
22105,13,193,247,440,False,2,6
22106,14,152,225,377,False,2,6
22107,15,148,145,293,False,2,6
22108,16,122,140,262,False,2,6
22109,17,106,108,214,False,2,6
22110,18,113,107,220,False,2,6
22111,19,69,82,151,False,2,6
22112,20,64,248,312,False,2,6
22113,21,33,164,197,False,2,6
22114,22,34,82,116,False,2,6
22115,23,14,61,75,False,2,6
22116,0,13,15,28,False,3,6
22117,1,8,10,18,False,3,6
22118,2,12,11,23,False,3,6
22119,3,14,13,27,False,3,6
22120,4,95,38,133,False,3,6
22121,5,172,110,282,False,3,6
22122,6,233,141,374,False,3,6
22123,7,220,146,366,False,3,6
22124,8,187,147,334,False,3,6
22125,9,180,162,342,False,3,6
22126,10,200,163,363,False,3,6
22127,11,186,222,408,False,3,6
22128,12,213,226,439,False,3,6
22129,13,184,277,461,False,3,6
22130,14,164,202,366,False,3,6
22131,15,148,154,302,False,3,6
22132,16,133,134,267,False,3,6
22133,17,115,108,223,False,3,6
22134,18,104,94,198,False,3,6
22135,19,68,91,159,False,3,6
22136,20,49,77,126,False,3,6
22137,21,45,42,87,False,3,6
22138,22,23,34,57,False,3,6
22139,23,12,15,27,False,3,6
22140,0,10,26,36,False,4,6
22141,1,7,19,26,False,4,6
22142,2,7,8,15,False,4,6
22143,3,15,5,20,False,4,6
22144,4,91,38,129,False,4,6
22145,5,149,94,243,False,4,6
22146,6,200,139,339,False,4,6
22147,7,222,137,359,False,4,6
22148,8,171,135,306,False,4,6
22149,9,189,166,355,False,4,6
22150,10,188,172,360,False,4,6
22151,11,175,209,384,False,4,6
22152,12,194,214,408,False,4,6
22153,13,183,265,448,False,4,6
22154,14,131,177,308,False,4,6
22155,15,92,133,225,False,4,6
22156,16,121,109,230,False,4,6
22157,17,89,107,196,False,4,6
22158,18,64,74,138,False,4,6
22159,19,55,51,106,False,4,6
22160,20,57,73,130,False,4,6
22161,21,41,39,80,False,4,6
22162,22,22,42,64,False,4,6
22163,23,22,30,52,False,4,6
22164,0,22,27,49,False,5,6
22165,1,14,31,45,False,5,6
22166,2,8,8,16,False,5,6
22167,3,10,7,17,False,5,6
22168,4,17,15,32,False,5,6
22169,5,26,21,47,False,5,6
22170,6,27,34,61,False,5,6
22171,7,52,38,90,False,5,6
22172,8,74,52,126,False,5,6
22173,9,84,75,159,False,5,6
22174,10,100,100,200,False,5,6
22175,11,108,122,230,False,5,6
22176,12,104,103,207,False,5,6
22177,13,101,128,229,False,5,6
22178,14,86,98,184,False,5,6
22179,15,69,75,144,False,5,6
22180,16,74,94,168,False,5,6
22181,17,72,75,147,False,5,6
22182,18,62,81,143,False,5,6
22183,19,57,64,121,False,5,6
22184,20,41,50,91,False,5,6
22185,21,49,69,118,False,5,6
22186,22,32,48,80,False,5,6
22187,23,19,42,61,False,5,6
22188,0,27,32,59,True,6,6
22189,1,16,45,61,True,6,6
22190,2,15,22,37,True,6,6
22191,3,11,11,22,True,6,6
22192,4,13,12,25,True,6,6
22193,5,8,19,27,True,6,6
22194,6,29,21,50,True,6,6
22195,7,27,37,64,True,6,6
22196,8,66,37,103,True,6,6
22197,9,80,67,147,True,6,6
22198,10,79,95,174,True,6,6
22199,11,95,91,186,True,6,6
22200,12,117,148,265,True,6,6
22201,13,109,134,243,True,6,6
22202,14,88,146,234,True,6,6
22203,15,123,133,256,True,6,6
22204,16,113,121,234,True,6,6
22205,17,97,115,212,True,6,6
22206,18,77,116,193,True,6,6
22207,19,63,71,134,True,6,6
22208,20,51,52,103,True,6,6
22209,21,23,26,49,True,6,6
22210,22,20,29,49,True,6,6
22211,23,9,12,21,True,6,6
22212,0,4,10,14,True,0,6
22213,1,4,8,12,True,0,6
22214,2,7,9,16,True,0,6
22215,3,11,16,27,True,0,6
22216,4,65,33,98,True,0,6
22217,5,110,95,205,True,0,6
22218,6,154,83,237,True,0,6
22219,7,161,103,264,True,0,6
22220,8,162,123,285,True,0,6
22221,9,154,132,286,True,0,6
22222,10,146,170,316,True,0,6
22223,11,150,157,307,True,0,6
22224,12,157,192,349,True,0,6
22225,13,129,192,321,True,0,6
22226,14,119,161,280,True,0,6
22227,15,115,144,259,True,0,6
22228,16,113,109,222,True,0,6
22229,17,88,104,192,True,0,6
22230,18,95,90,185,True,0,6
22231,19,84,84,168,True,0,6
22232,20,44,85,129,True,0,6
22233,21,32,54,86,True,0,6
22234,22,27,21,48,True,0,6
22235,23,11,21,32,True,0,6
22236,0,10,15,25,True,1,6
22237,1,5,6,11,True,1,6
22238,2,8,9,17,True,1,6
22239,3,13,18,31,True,1,6
22240,4,66,30,96,True,1,6
22241,5,122,98,220,True,1,6
22242,6,142,95,237,True,1,6
22243,7,159,110,269,True,1,6
22244,8,150,138,288,True,1,6
22245,9,143,132,275,True,1,6
22246,10,155,128,283,True,1,6
22247,11,164,182,346,True,1,6
22248,12,161,197,358,True,1,6
22249,13,144,209,353,True,1,6
22250,14,124,161,285,True,1,6
22251,15,105,150,255,True,1,6
22252,16,91,92,183,True,1,6
22253,17,101,110,211,True,1,6
22254,18,63,74,137,True,1,6
22255,19,42,64,106,True,1,6
22256,20,68,331,399,True,1,6
22257,21,28,147,175,True,1,6
22258,22,18,27,45,True,1,6
22259,23,17,21,38,True,1,6
22260,0,10,20,30,True,2,6
22261,1,17,15,32,True,2,6
22262,2,13,15,28,True,2,6
22263,3,11,19,30,True,2,6
22264,4,75,25,100,True,2,6
22265,5,95,78,173,True,2,6
22266,6,150,94,244,True,2,6
22267,7,135,102,237,True,2,6
22268,8,130,126,256,True,2,6
22269,9,141,127,268,True,2,6
22270,10,131,142,273,True,2,6
22271,11,150,150,300,True,2,6
22272,12,151,158,309,True,2,6
22273,13,133,183,316,True,2,6
22274,14,118,173,291,True,2,6
22275,15,97,129,226,True,2,6
22276,16,143,126,269,True,2,6
22277,17,94,115,209,True,2,6
22278,18,64,66,130,True,2,6
22279,19,46,56,102,True,2,6
22280,20,46,81,127,True,2,6
22281,21,45,75,120,True,2,6
22282,22,20,32,52,True,2,6
22283,23,16,13,29,True,2,6
22284,0,7,21,28,True,3,6
22285,1,11,18,29,True,3,6
22286,2,8,16,24,True,3,6
22287,3,10,13,23,True,3,6
22288,4,60,30,90,True,3,6
22289,5,102,81,183,True,3,6
22290,6,148,89,237,True,3,6
22291,7,120,97,217,True,3,6
22292,8,132,110,242,True,3,6
22293,9,134,110,244,True,3,6
22294,10,158,173,331,True,3,6
22295,11,148,159,307,True,3,6
22296,12,158,169,327,True,3,6
22297,13,133,194,327,True,3,6
22298,14,125,173,298,True,3,6
22299,15,108,117,225,True,3,6
22300,16,109,121,230,True,3,6
22301,17,103,94,197,True,3,6
22302,18,84,82,166,True,3,6
22303,19,68,114,182,True,3,6
22304,20,48,69,117,True,3,6
22305,21,30,39,69,True,3,6
22306,22,33,26,59,True,3,6
22307,23,12,16,28,True,3,6
22308,0,7,20,27,True,4,6
22309,1,10,24,34,True,4,6
22310,2,9,15,24,True,4,6
22311,3,9,6,15,True,4,6
22312,4,57,33,90,True,4,6
22313,5,101,80,181,True,4,6
22314,6,132,93,225,True,4,6
22315,7,144,96,240,True,4,6
22316,8,158,123,281,True,4,6
22317,9,178,129,307,True,4,6
22318,10,164,158,322,True,4,6
22319,11,146,160,306,True,4,6
22320,12,168,206,374,True,4,6
22321,13,173,185,358,True,4,6
22322,14,103,144,247,True,4,6
22323,15,104,130,234,True,4,6
22324,16,108,106,214,True,4,6
22325,17,82,89,171,True,4,6
22326,18,64,75,139,True,4,6
22327,19,68,67,135,True,4,6
22328,20,47,55,102,True,4,6
22329,21,43,39,82,True,4,6
22330,22,23,31,54,True,4,6
22331,23,17,33,50,True,4,6
22332,0,14,15,29,True,5,6
22333,1,14,32,46,True,5,6
22334,2,10,11,21,True,5,6
22335,3,7,10,17,True,5,6
22336,4,16,13,29,True,5,6
22337,5,24,22,46,True,5,6
22338,6,22,28,50,True,5,6
22339,7,42,44,86,True,5,6
22340,8,65,54,119,True,5,6
22341,9,71,68,139,True,5,6
22342,10,115,83,198,True,5,6
22343,11,114,104,218,True,5,6
22344,12,86,107,193,True,5,6
22345,13,100,110,210,True,5,6
22346,14,74,102,176,True,5,6
22347,15,76,97,173,True,5,6
22348,16,75,86,161,True,5,6
22349,17,84,84,168,True,5,6
22350,18,63,63,126,True,5,6
22351,19,57,67,124,True,5,6
22352,20,34,54,88,True,5,6
22353,21,37,43,80,True,5,6
22354,22,35,33,68,True,5,6
22355,23,19,33,52,True,5,6
22356,0,16,26,42,True,6,6
22357,1,16,24,40,True,6,6
22358,2,16,30,46,True,6,6
22359,3,11,15,26,True,6,6
22360,4,13,7,20,True,6,6
22361,5,10,13,23,True,6,6
22362,6,23,23,46,True,6,6
22363,7,33,35,68,True,6,6
22364,8,54,41,95,True,6,6
22365,9,76,58,134,True,6,6
22366,10,88,103,191,True,6,6
22367,11,89,93,182,True,6,6
22368,12,109,127,236,True,6,6
22369,13,113,124,237,True,6,6
22370,14,112,128,240,True,6,6
22371,15,61,84,145,True,6,6
22372,16,51,59,110,True,6,6
22373,17,107,101,208,True,6,6
22374,18,82,119,201,True,6,6
22375,19,64,94,158,True,6,6
22376,20,79,62,141,True,6,6
22377,21,61,43,104,True,6,6
22378,22,31,32,63,True,6,6
22379,23,13,14,27,True,6,6
22380,0,10,8,18,True,0,6
22381,1,17,22,39,True,0,6
22382,2,10,12,22,True,0,6
22383,3,13,9,22,True,0,6
22384,4,62,34,96,True,0,6
22385,5,98,78,176,True,0,6
22386,6,122,78,200,True,0,6
22387,7,127,106,233,True,0,6
22388,8,147,110,257,True,0,6
22389,9,130,130,260,True,0,6
22390,10,148,172,320,True,0,6
22391,11,154,139,293,True,0,6
22392,12,149,126,275,True,0,6
22393,13,153,198,351,True,0,6
22394,14,111,147,258,True,0,6
22395,15,104,110,214,True,0,6
22396,16,96,108,204,True,0,6
22397,17,90,111,201,True,0,6
22398,18,86,90,176,True,0,6
22399,19,92,106,198,True,0,6
22400,20,72,71,143,True,0,6
22401,21,42,44,86,True,0,6
22402,22,27,20,47,True,0,6
22403,23,10,17,27,True,0,6
22404,0,8,15,23,True,1,6
22405,1,14,14,28,True,1,6
22406,2,11,15,26,True,1,6
22407,3,9,8,17,True,1,6
22408,4,70,33,103,True,1,6
22409,5,109,81,190,True,1,6
22410,6,124,85,209,True,1,6
22411,7,103,98,201,True,1,6
22412,8,162,104,266,True,1,6
22413,9,143,111,254,True,1,6
22414,10,158,132,290,True,1,6
22415,11,151,140,291,True,1,6
22416,12,178,174,352,True,1,6
22417,13,131,183,314,True,1,6
22418,14,134,159,293,True,1,6
22419,15,121,123,244,True,1,6
22420,16,99,102,201,True,1,6
22421,17,87,85,172,True,1,6
22422,18,75,100,175,True,1,6
22423,19,51,79,130,True,1,6
22424,20,37,81,118,True,1,6
22425,21,41,51,92,True,1,6
22426,22,26,35,61,True,1,6
22427,23,22,20,42,True,1,6
22428,0,17,19,36,True,2,6
22429,1,15,28,43,True,2,6
22430,2,7,14,21,True,2,6
22431,3,10,13,23,True,2,6
22432,4,60,27,87,True,2,6
22433,5,93,65,158,True,2,6
22434,6,113,63,176,True,2,6
22435,7,121,88,209,True,2,6
22436,8,151,124,275,True,2,6
22437,9,161,128,289,True,2,6
22438,10,170,167,337,True,2,6
22439,11,151,167,318,True,2,6
22440,12,152,187,339,True,2,6
22441,13,150,186,336,True,2,6
22442,14,124,153,277,True,2,6
22443,15,108,146,254,True,2,6
22444,16,105,121,226,True,2,6
22445,17,63,94,157,True,2,6
22446,18,80,98,178,True,2,6
22447,19,80,92,172,True,2,6
22448,20,58,59,117,True,2,6
22449,21,36,44,80,True,2,6
22450,22,16,24,40,True,2,6
22451,23,10,16,26,True,2,6
22452,0,6,24,30,True,3,6
22453,1,12,19,31,True,3,6
22454,2,12,15,27,True,3,6
22455,3,12,6,18,True,3,6
22456,4,61,32,93,True,3,6
22457,5,97,75,172,True,3,6
22458,6,108,94,202,True,3,6
22459,7,115,88,203,True,3,6
22460,8,119,119,238,True,3,6
22461,9,147,128,275,True,3,6
22462,10,137,116,253,True,3,6
22463,11,146,146,292,True,3,6
22464,12,151,162,313,True,3,6
22465,13,143,158,301,True,3,6
22466,14,112,145,257,True,3,6
22467,15,111,134,245,True,3,6
22468,16,97,115,212,True,3,6
22469,17,95,110,205,True,3,6
22470,18,76,89,165,True,3,6
22471,19,62,80,142,True,3,6
22472,20,53,82,135,True,3,6
22473,21,35,63,98,True,3,6
22474,22,26,34,60,True,3,6
22475,23,11,23,34,True,3,6
22476,0,10,21,31,True,4,6
22477,1,7,28,35,True,4,6
22478,2,11,17,28,True,4,6
22479,3,11,7,18,True,4,6
22480,4,57,27,84,True,4,6
22481,5,86,73,159,True,4,6
22482,6,111,88,199,True,4,6
22483,7,125,88,213,True,4,6
22484,8,125,102,227,True,4,6
22485,9,162,105,267,True,4,6
22486,10,146,141,287,True,4,6
22487,11,154,167,321,True,4,6
22488,12,145,165,310,True,4,6
22489,13,152,160,312,True,4,6
22490,14,116,156,272,True,4,6
22491,15,99,124,223,True,4,6
22492,16,112,106,218,True,4,6
22493,17,83,100,183,True,4,6
22494,18,75,100,175,True,4,6
22495,19,62,78,140,True,4,6
22496,20,58,69,127,True,4,6
22497,21,41,50,91,True,4,6
22498,22,25,37,62,True,4,6
22499,23,19,27,46,True,4,6
22500,0,11,21,32,True,5,6
22501,1,10,27,37,True,5,6
22502,2,6,9,15,True,5,6
22503,3,9,8,17,True,5,6
22504,4,16,10,26,True,5,6
22505,5,14,14,28,True,5,6
22506,6,27,27,54,True,5,6
22507,7,36,35,71,True,5,6
22508,8,69,48,117,True,5,6
22509,9,80,75,155,True,5,6
22510,10,94,94,188,True,5,6
22511,11,95,98,193,True,5,6
22512,12,107,108,215,True,5,6
22513,13,107,116,223,True,5,6
22514,14,88,141,229,True,5,6
22515,15,109,140,249,True,5,6
22516,16,97,102,199,True,5,6
22517,17,80,88,168,True,5,6
22518,18,68,69,137,True,5,6
22519,19,54,70,124,True,5,6
22520,20,46,47,93,True,5,6
22521,21,30,47,77,True,5,6
22522,22,28,42,70,True,5,6
22523,23,13,28,41,True,5,6
22524,0,20,30,50,True,6,6
22525,1,14,40,54,True,6,6
22526,2,7,26,33,True,6,6
22527,3,7,20,27,True,6,6
22528,4,13,9,22,True,6,6
22529,5,9,19,28,True,6,6
22530,6,14,20,34,True,6,6
22531,7,27,33,60,True,6,6
22532,8,52,47,99,True,6,6
22533,9,93,72,165,True,6,6
22534,10,90,90,180,True,6,6
22535,11,94,103,197,True,6,6
22536,12,104,122,226,True,6,6
22537,13,91,116,207,True,6,6
22538,14,101,138,239,True,6,6
22539,15,100,118,218,True,6,6
22540,16,126,132,258,True,6,6
22541,17,82,116,198,True,6,6
22542,18,89,96,185,True,6,6
22543,19,76,88,164,True,6,6
22544,20,44,51,95,True,6,6
22545,21,36,46,82,True,6,6
22546,22,26,21,47,True,6,6
22547,23,8,19,27,True,6,6
22548,0,7,10,17,True,0,6
22549,1,11,18,29,True,0,6
22550,2,4,11,15,True,0,6
22551,3,19,13,32,True,0,6
22552,4,63,27,90,True,0,6
22553,5,113,80,193,True,0,6
22554,6,125,104,229,True,0,6
22555,7,131,101,232,True,0,6
22556,8,145,111,256,True,0,6
22557,9,150,97,247,True,0,6
22558,10,130,139,269,True,0,6
22559,11,146,152,298,True,0,6
22560,12,148,174,322,True,0,6
22561,13,126,205,331,True,0,6
22562,14,119,164,283,True,0,6
22563,15,126,131,257,True,0,6
22564,16,118,102,220,True,0,6
22565,17,94,108,202,True,0,6
22566,18,92,106,198,True,0,6
22567,19,60,80,140,True,0,6
22568,20,64,62,126,True,0,6
22569,21,32,37,69,True,0,6
22570,22,22,22,44,True,0,6
22571,23,12,15,27,True,0,6
22572,0,9,10,19,True,1,6
22573,1,21,8,29,True,1,6
22574,2,9,6,15,True,1,6
22575,3,15,11,26,True,1,6
22576,4,64,29,93,True,1,6
22577,5,100,74,174,True,1,6
22578,6,108,101,209,True,1,6
22579,7,118,106,224,True,1,6
22580,8,148,111,259,True,1,6
22581,9,138,113,251,True,1,6
22582,10,164,142,306,True,1,6
22583,11,213,166,379,True,1,6
22584,12,176,166,342,True,1,6
22585,13,229,216,445,True,1,6
22586,14,317,289,606,True,1,6
22587,15,122,158,280,True,1,6
22588,16,118,99,217,True,1,6
22589,17,107,105,212,True,1,6
22590,18,77,88,165,True,1,6
22591,19,77,82,159,True,1,6
22592,20,51,66,117,True,1,6
22593,21,28,43,71,True,1,6
22594,22,21,23,44,True,1,6
22595,23,18,18,36,True,1,6
22596,0,11,14,25,True,2,6
22597,1,17,14,31,True,2,6
22598,2,14,19,33,True,2,6
22599,3,18,14,32,True,2,6
22600,4,59,23,82,True,2,6
22601,5,104,69,173,True,2,6
22602,6,102,96,198,True,2,6
22603,7,129,100,229,True,2,6
22604,8,141,102,243,True,2,6
22605,9,145,127,272,True,2,6
22606,10,142,154,296,True,2,6
22607,11,150,151,301,True,2,6
22608,12,133,170,303,True,2,6
22609,13,163,180,343,True,2,6
22610,14,118,152,270,True,2,6
22611,15,117,129,246,True,2,6
22612,16,113,121,234,True,2,6
22613,17,94,126,220,True,2,6
22614,18,76,105,181,True,2,6
22615,19,78,86,164,True,2,6
22616,20,73,83,156,True,2,6
22617,21,34,40,74,True,2,6
22618,22,29,39,68,True,2,6
22619,23,16,14,30,True,2,6
22620,0,20,17,37,True,3,6
22621,1,12,16,28,True,3,6
22622,2,9,12,21,True,3,6
22623,3,18,8,26,True,3,6
22624,4,67,33,100,True,3,6
22625,5,92,83,175,True,3,6
22626,6,103,91,194,True,3,6
22627,7,141,105,246,True,3,6
22628,8,108,105,213,True,3,6
22629,9,173,132,305,True,3,6
22630,10,146,157,303,True,3,6
22631,11,158,127,285,True,3,6
22632,12,130,176,306,True,3,6
22633,13,163,166,329,True,3,6
22634,14,110,163,273,True,3,6
22635,15,118,135,253,True,3,6
22636,16,107,133,240,True,3,6
22637,17,90,96,186,True,3,6
22638,18,92,110,202,True,3,6
22639,19,64,88,152,True,3,6
22640,20,71,61,132,True,3,6
22641,21,55,55,110,True,3,6
22642,22,22,25,47,True,3,6
22643,23,15,14,29,True,3,6
22644,0,6,19,25,True,4,6
22645,1,10,20,30,True,4,6
22646,2,8,11,19,True,4,6
22647,3,8,11,19,True,4,6
22648,4,67,27,94,True,4,6
22649,5,102,74,176,True,4,6
22650,6,111,106,217,True,4,6
22651,7,126,99,225,True,4,6
22652,8,125,121,246,True,4,6
22653,9,149,122,271,True,4,6
22654,10,150,150,300,True,4,6
22655,11,141,147,288,True,4,6
22656,12,140,181,321,True,4,6
22657,13,149,175,324,True,4,6
22658,14,112,102,214,True,4,6
22659,15,97,113,210,True,4,6
22660,16,105,109,214,True,4,6
22661,17,75,99,174,True,4,6
22662,18,64,91,155,True,4,6
22663,19,55,80,135,True,4,6
22664,20,56,64,120,True,4,6
22665,21,49,59,108,True,4,6
22666,22,30,45,75,True,4,6
22667,23,18,33,51,True,4,6
22668,0,17,25,42,True,5,6
22669,1,11,25,36,True,5,6
22670,2,12,15,27,True,5,6
22671,3,11,11,22,True,5,6
22672,4,15,9,24,True,5,6
22673,5,17,16,33,True,5,6
22674,6,23,18,41,True,5,6
22675,7,45,47,92,True,5,6
22676,8,71,54,125,True,5,6
22677,9,75,86,161,True,5,6
22678,10,94,96,190,True,5,6
22679,11,89,99,188,True,5,6
22680,12,107,117,224,True,5,6
22681,13,97,135,232,True,5,6
22682,14,111,117,228,True,5,6
22683,15,84,103,187,True,5,6
22684,16,105,111,216,True,5,6
22685,17,76,95,171,True,5,6
22686,18,74,110,184,True,5,6
22687,19,65,87,152,True,5,6
22688,20,49,58,107,True,5,6
22689,21,38,55,93,True,5,6
22690,22,41,64,105,True,5,6
22691,23,21,33,54,True,5,6
22692,0,14,31,45,True,6,6
22693,1,14,35,49,True,6,6
22694,2,13,24,37,True,6,6
22695,3,14,14,28,True,6,6
22696,4,16,15,31,True,6,6
22697,5,7,18,25,True,6,6
22698,6,25,19,44,True,6,6
22699,7,36,44,80,True,6,6
22700,8,65,43,108,True,6,6
22701,9,83,68,151,True,6,6
22702,10,108,107,215,True,6,6
22703,11,101,130,231,True,6,6
22704,12,131,145,276,True,6,6
22705,13,112,140,252,True,6,6
22706,14,106,161,267,True,6,6
22707,15,140,123,263,True,6,6
22708,16,122,157,279,True,6,6
22709,17,110,137,247,True,6,6
22710,18,106,132,238,True,6,6
22711,19,79,82,161,True,6,6
22712,20,55,63,118,True,6,6
22713,21,37,53,90,True,6,6
22714,22,16,31,47,True,6,6
22715,23,13,15,28,True,6,6
22716,0,4,15,19,False,0,6
22717,1,3,10,13,False,0,6
22718,2,7,7,14,False,0,6
22719,3,20,7,27,False,0,6
22720,4,81,39,120,False,0,6
22721,5,141,97,238,False,0,6
22722,6,176,119,295,False,0,6
22723,7,165,109,274,False,0,6
22724,8,167,140,307,False,0,6
22725,9,175,119,294,False,0,6
22726,10,168,161,329,False,0,6
22727,11,202,201,403,False,0,6
22728,12,167,217,384,False,0,6
22729,13,190,252,442,False,0,6
22730,14,174,215,389,False,0,6
22731,15,134,162,296,False,0,6
22732,16,153,147,300,False,0,6
22733,17,121,126,247,False,0,6
22734,18,92,117,209,False,0,6
22735,19,91,99,190,False,0,6
22736,20,70,87,157,False,0,6
22737,21,32,59,91,False,0,6
22738,22,17,24,41,False,0,6
22739,23,10,15,25,False,0,6
22740,0,6,13,19,False,1,6
22741,1,5,11,16,False,1,6
22742,2,16,10,26,False,1,6
22743,3,14,7,21,False,1,6
22744,4,69,39,108,False,1,6
22745,5,152,89,241,False,1,6
22746,6,196,121,317,False,1,6
22747,7,186,137,323,False,1,6
22748,8,177,141,318,False,1,6
22749,9,200,135,335,False,1,6
22750,10,180,164,344,False,1,6
22751,11,190,186,376,False,1,6
22752,12,186,187,373,False,1,6
22753,13,211,276,487,False,1,6
22754,14,159,226,385,False,1,6
22755,15,149,179,328,False,1,6
22756,16,154,144,298,False,1,6
22757,17,127,133,260,False,1,6
22758,18,99,119,218,False,1,6
22759,19,72,99,171,False,1,6
22760,20,47,87,134,False,1,6
22761,21,33,42,75,False,1,6
22762,22,19,21,40,False,1,6
22763,23,9,17,26,False,1,6
22764,0,7,12,19,False,2,7
22765,1,4,15,19,False,2,7
22766,2,8,8,16,False,2,7
22767,3,17,11,28,False,2,7
22768,4,79,38,117,False,2,7
22769,5,131,99,230,False,2,7
22770,6,204,116,320,False,2,7
22771,7,175,118,293,False,2,7
22772,8,154,143,297,False,2,7
22773,9,202,140,342,False,2,7
22774,10,194,194,388,False,2,7
22775,11,170,159,329,False,2,7
22776,12,160,213,373,False,2,7
22777,13,211,278,489,False,2,7
22778,14,168,237,405,False,2,7
22779,15,156,170,326,False,2,7
22780,16,131,147,278,False,2,7
22781,17,107,111,218,False,2,7
22782,18,83,104,187,False,2,7
22783,19,76,98,174,False,2,7
22784,20,45,94,139,False,2,7
22785,21,28,59,87,False,2,7
22786,22,15,27,42,False,2,7
22787,23,12,18,30,False,2,7
22788,0,10,12,22,False,3,7
22789,1,6,14,20,False,3,7
22790,2,8,17,25,False,3,7
22791,3,16,12,28,False,3,7
22792,4,97,28,125,False,3,7
22793,5,136,104,240,False,3,7
22794,6,181,123,304,False,3,7
22795,7,162,115,277,False,3,7
22796,8,137,118,255,False,3,7
22797,9,169,153,322,False,3,7
22798,10,175,156,331,False,3,7
22799,11,171,179,350,False,3,7
22800,12,180,205,385,False,3,7
22801,13,208,267,475,False,3,7
22802,14,169,219,388,False,3,7
22803,15,133,160,293,False,3,7
22804,16,120,134,254,False,3,7
22805,17,131,129,260,False,3,7
22806,18,87,110,197,False,3,7
22807,19,73,90,163,False,3,7
22808,20,49,66,115,False,3,7
22809,21,33,48,81,False,3,7
22810,22,24,25,49,False,3,7
22811,23,11,25,36,False,3,7
22812,0,12,24,36,False,4,7
22813,1,11,14,25,False,4,7
22814,2,9,9,18,False,4,7
22815,3,10,21,31,False,4,7
22816,4,88,30,118,False,4,7
22817,5,132,108,240,False,4,7
22818,6,193,107,300,False,4,7
22819,7,176,89,265,False,4,7
22820,8,158,126,284,False,4,7
22821,9,186,139,325,False,4,7
22822,10,188,183,371,False,4,7
22823,11,175,177,352,False,4,7
22824,12,189,220,409,False,4,7
22825,13,204,243,447,False,4,7
22826,14,150,222,372,False,4,7
22827,15,120,154,274,False,4,7
22828,16,125,128,253,False,4,7
22829,17,111,97,208,False,4,7
22830,18,79,80,159,False,4,7
22831,19,63,85,148,False,4,7
22832,20,45,72,117,False,4,7
22833,21,24,42,66,False,4,7
22834,22,39,41,80,False,4,7
22835,23,18,26,44,False,4,7
22836,0,11,27,38,False,5,7
22837,1,13,30,43,False,5,7
22838,2,7,22,29,False,5,7
22839,3,12,7,19,False,5,7
22840,4,27,13,40,False,5,7
22841,5,12,18,30,False,5,7
22842,6,36,31,67,False,5,7
22843,7,45,52,97,False,5,7
22844,8,75,69,144,False,5,7
22845,9,113,79,192,False,5,7
22846,10,137,93,230,False,5,7
22847,11,121,117,238,False,5,7
22848,12,133,138,271,False,5,7
22849,13,136,132,268,False,5,7
22850,14,101,159,260,False,5,7
22851,15,116,140,256,False,5,7
22852,16,94,135,229,False,5,7
22853,17,97,100,197,False,5,7
22854,18,67,90,157,False,5,7
22855,19,63,70,133,False,5,7
22856,20,57,60,117,False,5,7
22857,21,35,62,97,False,5,7
22858,22,30,66,96,False,5,7
22859,23,18,40,58,False,5,7
22860,0,29,39,68,True,6,7
22861,1,30,48,78,True,6,7
22862,2,11,31,42,True,6,7
22863,3,9,13,22,True,6,7
22864,4,12,7,19,True,6,7
22865,5,15,8,23,True,6,7
22866,6,26,12,38,True,6,7
22867,7,28,35,63,True,6,7
22868,8,69,55,124,True,6,7
22869,9,87,76,163,True,6,7
22870,10,128,124,252,True,6,7
22871,11,118,124,242,True,6,7
22872,12,128,162,290,True,6,7
22873,13,119,178,297,True,6,7
22874,14,138,185,323,True,6,7
22875,15,142,138,280,True,6,7
22876,16,124,131,255,True,6,7
22877,17,145,166,311,True,6,7
22878,18,109,137,246,True,6,7
22879,19,71,101,172,True,6,7
22880,20,56,64,120,True,6,7
22881,21,31,39,70,True,6,7
22882,22,30,28,58,True,6,7
22883,23,12,12,24,True,6,7
22884,0,6,15,21,False,0,7
22885,1,12,20,32,False,0,7
22886,2,11,6,17,False,0,7
22887,3,19,14,33,False,0,7
22888,4,92,48,140,False,0,7
22889,5,171,95,266,False,0,7
22890,6,298,157,455,False,0,7
22891,7,231,146,377,False,0,7
22892,8,200,170,370,False,0,7
22893,9,204,183,387,False,0,7
22894,10,196,194,390,False,0,7
22895,11,185,193,378,False,0,7
22896,12,191,258,449,False,0,7
22897,13,216,311,527,False,0,7
22898,14,173,298,471,False,0,7
22899,15,129,157,286,False,0,7
22900,16,132,184,316,False,0,7
22901,17,103,101,204,False,0,7
22902,18,98,100,198,False,0,7
22903,19,139,85,224,False,0,7
22904,20,60,68,128,False,0,7
22905,21,46,36,82,False,0,7
22906,22,19,32,51,False,0,7
22907,23,16,16,32,False,0,7
22908,0,15,9,24,False,1,7
22909,1,6,14,20,False,1,7
22910,2,4,11,15,False,1,7
22911,3,17,11,28,False,1,7
22912,4,113,51,164,False,1,7
22913,5,190,118,308,False,1,7
22914,6,263,157,420,False,1,7
22915,7,241,158,399,False,1,7
22916,8,189,131,320,False,1,7
22917,9,200,179,379,False,1,7
22918,10,200,194,394,False,1,7
22919,11,226,196,422,False,1,7
22920,12,191,275,466,False,1,7
22921,13,224,310,534,False,1,7
22922,14,181,268,449,False,1,7
22923,15,151,188,339,False,1,7
22924,16,152,146,298,False,1,7
22925,17,109,127,236,False,1,7
22926,18,106,142,248,False,1,7
22927,19,67,105,172,False,1,7
22928,20,51,78,129,False,1,7
22929,21,37,39,76,False,1,7
22930,22,26,45,71,False,1,7
22931,23,9,17,26,False,1,7
22932,0,7,13,20,False,2,7
22933,1,6,33,39,False,2,7
22934,2,7,47,54,False,2,7
22935,3,12,36,48,False,2,7
22936,4,103,46,149,False,2,7
22937,5,183,107,290,False,2,7
22938,6,285,126,411,False,2,7
22939,7,227,186,413,False,2,7
22940,8,206,167,373,False,2,7
22941,9,188,154,342,False,2,7
22942,10,224,199,423,False,2,7
22943,11,199,211,410,False,2,7
22944,12,222,262,484,False,2,7
22945,13,229,322,551,False,2,7
22946,14,210,290,500,False,2,7
22947,15,182,214,396,False,2,7
22948,16,147,138,285,False,2,7
22949,17,102,155,257,False,2,7
22950,18,110,125,235,False,2,7
22951,19,76,107,183,False,2,7
22952,20,62,261,323,False,2,7
22953,21,30,156,186,False,2,7
22954,22,20,99,119,False,2,7
22955,23,14,37,51,False,2,7
22956,0,7,30,37,False,3,7
22957,1,14,30,44,False,3,7
22958,2,11,29,40,False,3,7
22959,3,12,24,36,False,3,7
22960,4,111,42,153,False,3,7
22961,5,200,104,304,False,3,7
22962,6,272,141,413,False,3,7
22963,7,227,165,392,False,3,7
22964,8,210,181,391,False,3,7
22965,9,249,163,412,False,3,7
22966,10,244,197,441,False,3,7
22967,11,218,224,442,False,3,7
22968,12,224,278,502,False,3,7
22969,13,248,329,577,False,3,7
22970,14,193,269,462,False,3,7
22971,15,161,209,370,False,3,7
22972,16,153,155,308,False,3,7
22973,17,118,133,251,False,3,7
22974,18,100,114,214,False,3,7
22975,19,80,105,185,False,3,7
22976,20,76,86,162,False,3,7
22977,21,41,62,103,False,3,7
22978,22,30,33,63,False,3,7
22979,23,14,21,35,False,3,7
22980,0,16,22,38,False,4,7
22981,1,5,20,25,False,4,7
22982,2,10,19,29,False,4,7
22983,3,18,14,32,False,4,7
22984,4,107,45,152,False,4,7
22985,5,179,111,290,False,4,7
22986,6,311,168,479,False,4,7
22987,7,245,176,421,False,4,7
22988,8,237,185,422,False,4,7
22989,9,227,187,414,False,4,7
22990,10,233,191,424,False,4,7
22991,11,253,244,497,False,4,7
22992,12,260,308,568,False,4,7
22993,13,301,394,695,False,4,7
22994,14,202,322,524,False,4,7
22995,15,188,209,397,False,4,7
22996,16,140,182,322,False,4,7
22997,17,158,137,295,False,4,7
22998,18,112,134,246,False,4,7
22999,19,79,101,180,False,4,7
23000,20,65,85,150,False,4,7
23001,21,46,72,118,False,4,7
23002,22,32,52,84,False,4,7
23003,23,20,26,46,False,4,7
23004,0,17,24,41,False,5,7
23005,1,16,31,47,False,5,7
23006,2,11,23,34,False,5,7
23007,3,9,8,17,False,5,7
23008,4,25,16,41,False,5,7
23009,5,26,29,55,False,5,7
23010,6,35,43,78,False,5,7
23011,7,70,42,112,False,5,7
23012,8,103,84,187,False,5,7
23013,9,139,109,248,False,5,7
23014,10,173,129,302,False,5,7
23015,11,153,173,326,False,5,7
23016,12,147,190,337,False,5,7
23017,13,156,182,338,False,5,7
23018,14,158,165,323,False,5,7
23019,15,118,151,269,False,5,7
23020,16,137,117,254,False,5,7
23021,17,99,124,223,False,5,7
23022,18,84,91,175,False,5,7
23023,19,68,106,174,False,5,7
23024,20,51,72,123,False,5,7
23025,21,41,78,119,False,5,7
23026,22,51,60,111,False,5,7
23027,23,28,31,59,False,5,7
23028,0,19,35,54,True,6,7
23029,1,19,47,66,True,6,7
23030,2,10,27,37,True,6,7
23031,3,11,12,23,True,6,7
23032,4,17,15,32,True,6,7
23033,5,11,10,21,True,6,7
23034,6,32,21,53,True,6,7
23035,7,59,56,115,True,6,7
23036,8,105,74,179,True,6,7
23037,9,109,95,204,True,6,7
23038,10,140,148,288,True,6,7
23039,11,172,159,331,True,6,7
23040,12,171,172,343,True,6,7
23041,13,159,169,328,True,6,7
23042,14,161,216,377,True,6,7
23043,15,149,167,316,True,6,7
23044,16,128,158,286,True,6,7
23045,17,152,167,319,True,6,7
23046,18,140,151,291,True,6,7
23047,19,99,128,227,True,6,7
23048,20,67,80,147,True,6,7
23049,21,36,49,85,True,6,7
23050,22,24,27,51,True,6,7
23051,23,11,22,33,True,6,7
23052,0,7,18,25,False,0,7
23053,1,2,16,18,False,0,7
23054,2,9,2,11,False,0,7
23055,3,16,17,33,False,0,7
23056,4,125,52,177,False,0,7
23057,5,197,141,338,False,0,7
23058,6,369,144,513,False,0,7
23059,7,260,164,424,False,0,7
23060,8,197,191,388,False,0,7
23061,9,190,166,356,False,0,7
23062,10,235,189,424,False,0,7
23063,11,225,206,431,False,0,7
23064,12,230,313,543,False,0,7
23065,13,262,347,609,False,0,7
23066,14,217,327,544,False,0,7
23067,15,181,178,359,False,0,7
23068,16,139,167,306,False,0,7
23069,17,147,133,280,False,0,7
23070,18,128,137,265,False,0,7
23071,19,84,119,203,False,0,7
23072,20,99,81,180,False,0,7
23073,21,53,50,103,False,0,7
23074,22,26,25,51,False,0,7
23075,23,16,13,29,False,0,7
23076,0,13,13,26,False,1,7
23077,1,15,20,35,False,1,7
23078,2,15,17,32,False,1,7
23079,3,22,9,31,False,1,7
23080,4,126,57,183,False,1,7
23081,5,205,153,358,False,1,7
23082,6,361,170,531,False,1,7
23083,7,240,177,417,False,1,7
23084,8,212,179,391,False,1,7
23085,9,208,189,397,False,1,7
23086,10,209,210,419,False,1,7
23087,11,245,232,477,False,1,7
23088,12,224,263,487,False,1,7
23089,13,261,335,596,False,1,7
23090,14,217,302,519,False,1,7
23091,15,151,195,346,False,1,7
23092,16,176,144,320,False,1,7
23093,17,145,142,287,False,1,7
23094,18,127,131,258,False,1,7
23095,19,104,108,212,False,1,7
23096,20,62,82,144,False,1,7
23097,21,39,60,99,False,1,7
23098,22,30,66,96,False,1,7
23099,23,19,38,57,False,1,7
23100,0,11,36,47,False,2,7
23101,1,13,25,38,False,2,7
23102,2,13,15,28,False,2,7
23103,3,22,12,34,False,2,7
23104,4,117,49,166,False,2,7
23105,5,227,148,375,False,2,7
23106,6,368,185,553,False,2,7
23107,7,252,157,409,False,2,7
23108,8,231,183,414,False,2,7
23109,9,226,177,403,False,2,7
23110,10,216,193,409,False,2,7
23111,11,217,214,431,False,2,7
23112,12,195,268,463,False,2,7
23113,13,234,367,601,False,2,7
23114,14,217,295,512,False,2,7
23115,15,177,212,389,False,2,7
23116,16,157,150,307,False,2,7
23117,17,166,157,323,False,2,7
23118,18,128,144,272,False,2,7
23119,19,74,95,169,False,2,7
23120,20,63,92,155,False,2,7
23121,21,45,58,103,False,2,7
23122,22,23,38,61,False,2,7
23123,23,19,34,53,False,2,7
23124,0,13,36,49,False,3,7
23125,1,12,24,36,False,3,7
23126,2,14,10,24,False,3,7
23127,3,17,12,29,False,3,7
23128,4,104,48,152,False,3,7
23129,5,218,150,368,False,3,7
23130,6,363,160,523,False,3,7
23131,7,237,167,404,False,3,7
23132,8,233,165,398,False,3,7
23133,9,231,166,397,False,3,7
23134,10,238,318,556,False,3,7
23135,11,210,507,717,False,3,7
23136,12,244,335,579,False,3,7
23137,13,253,360,613,False,3,7
23138,14,214,366,580,False,3,7
23139,15,176,218,394,False,3,7
23140,16,183,158,341,False,3,7
23141,17,131,162,293,False,3,7
23142,18,113,153,266,False,3,7
23143,19,89,112,201,False,3,7
23144,20,75,73,148,False,3,7
23145,21,37,47,84,False,3,7
23146,22,30,41,71,False,3,7
23147,23,30,31,61,False,3,7
23148,0,13,38,51,False,4,7
23149,1,14,34,48,False,4,7
23150,2,10,18,28,False,4,7
23151,3,24,17,41,False,4,7
23152,4,108,56,164,False,4,7
23153,5,216,132,348,False,4,7
23154,6,390,179,569,False,4,7
23155,7,240,193,433,False,4,7
23156,8,211,176,387,False,4,7
23157,9,221,191,412,False,4,7
23158,10,234,231,465,False,4,7
23159,11,231,228,459,False,4,7
23160,12,254,292,546,False,4,7
23161,13,269,354,623,False,4,7
23162,14,201,291,492,False,4,7
23163,15,162,191,353,False,4,7
23164,16,165,168,333,False,4,7
23165,17,144,139,283,False,4,7
23166,18,91,128,219,False,4,7
23167,19,85,107,192,False,4,7
23168,20,68,80,148,False,4,7
23169,21,48,75,123,False,4,7
23170,22,44,58,102,False,4,7
23171,23,31,45,76,False,4,7
23172,0,21,47,68,False,5,7
23173,1,32,49,81,False,5,7
23174,2,7,24,31,False,5,7
23175,3,12,12,24,False,5,7
23176,4,21,13,34,False,5,7
23177,5,41,28,69,False,5,7
23178,6,35,39,74,False,5,7
23179,7,72,56,128,False,5,7
23180,8,105,65,170,False,5,7
23181,9,135,88,223,False,5,7
23182,10,178,124,302,False,5,7
23183,11,166,166,332,False,5,7
23184,12,174,178,352,False,5,7
23185,13,146,188,334,False,5,7
23186,14,157,186,343,False,5,7
23187,15,172,180,352,False,5,7
23188,16,166,200,366,False,5,7
23189,17,104,129,233,False,5,7
23190,18,78,111,189,False,5,7
23191,19,81,99,180,False,5,7
23192,20,65,92,157,False,5,7
23193,21,53,66,119,False,5,7
23194,22,46,82,128,False,5,7
23195,23,29,39,68,False,5,7
23196,0,35,53,88,True,6,7
23197,1,28,74,102,True,6,7
23198,2,17,46,63,True,6,7
23199,3,10,20,30,True,6,7
23200,4,21,17,38,True,6,7
23201,5,22,16,38,True,6,7
23202,6,26,16,42,True,6,7
23203,7,58,49,107,True,6,7
23204,8,83,63,146,True,6,7
23205,9,93,69,162,True,6,7
23206,10,137,159,296,True,6,7
23207,11,130,152,282,True,6,7
23208,12,181,189,370,True,6,7
23209,13,150,176,326,True,6,7
23210,14,155,235,390,True,6,7
23211,15,160,232,392,True,6,7
23212,16,148,161,309,True,6,7
23213,17,143,153,296,True,6,7
23214,18,225,160,385,True,6,7
23215,19,106,130,236,True,6,7
23216,20,71,90,161,True,6,7
23217,21,42,56,98,True,6,7
23218,22,16,22,38,True,6,7
23219,23,13,21,34,True,6,7
23220,0,7,10,17,False,0,7
23221,1,6,12,18,False,0,7
23222,2,6,14,20,False,0,7
23223,3,21,11,32,False,0,7
23224,4,141,52,193,False,0,7
23225,5,223,145,368,False,0,7
23226,6,399,180,579,False,0,7
23227,7,244,178,422,False,0,7
23228,8,238,180,418,False,0,7
23229,9,201,215,416,False,0,7
23230,10,226,204,430,False,0,7
23231,11,256,223,479,False,0,7
23232,12,209,268,477,False,0,7
23233,13,255,368,623,False,0,7
23234,14,234,293,527,False,0,7
23235,15,174,208,382,False,0,7
23236,16,151,194,345,False,0,7
23237,17,141,156,297,False,0,7
23238,18,112,165,277,False,0,7
23239,19,81,111,192,False,0,7
23240,20,49,64,113,False,0,7
23241,21,45,46,91,False,0,7
23242,22,23,24,47,False,0,7
23243,23,14,20,34,False,0,7
23244,0,10,20,30,False,1,7
23245,1,15,9,24,False,1,7
23246,2,11,10,21,False,1,7
23247,3,19,8,27,False,1,7
23248,4,124,62,186,False,1,7
23249,5,235,143,378,False,1,7
23250,6,403,256,659,False,1,7
23251,7,252,181,433,False,1,7
23252,8,236,161,397,False,1,7
23253,9,283,195,478,False,1,7
23254,10,185,201,386,False,1,7
23255,11,241,209,450,False,1,7
23256,12,220,275,495,False,1,7
23257,13,245,354,599,False,1,7
23258,14,193,332,525,False,1,7
23259,15,192,217,409,False,1,7
23260,16,167,150,317,False,1,7
23261,17,129,148,277,False,1,7
23262,18,143,143,286,False,1,7
23263,19,105,133,238,False,1,7
23264,20,50,80,130,False,1,7
23265,21,34,42,76,False,1,7
23266,22,19,30,49,False,1,7
23267,23,10,11,21,False,1,7
23268,0,5,14,19,False,2,7
23269,1,10,9,19,False,2,7
23270,2,6,4,10,False,2,7
23271,3,20,13,33,False,2,7
23272,4,130,50,180,False,2,7
23273,5,240,167,407,False,2,7
23274,6,417,211,628,False,2,7
23275,7,278,158,436,False,2,7
23276,8,230,179,409,False,2,7
23277,9,214,181,395,False,2,7
23278,10,241,195,436,False,2,7
23279,11,235,233,468,False,2,7
23280,12,219,280,499,False,2,7
23281,13,256,349,605,False,2,7
23282,14,271,301,572,False,2,7
23283,15,244,215,459,False,2,7
23284,16,155,179,334,False,2,7
23285,17,127,146,273,False,2,7
23286,18,110,172,282,False,2,7
23287,19,93,124,217,False,2,7
23288,20,78,73,151,False,2,7
23289,21,48,44,92,False,2,7
23290,22,21,26,47,False,2,7
23291,23,15,28,43,False,2,7
23292,0,7,13,20,False,3,7
23293,1,8,12,20,False,3,7
23294,2,8,10,18,False,3,7
23295,3,17,10,27,False,3,7
23296,4,124,50,174,False,3,7
23297,5,248,142,390,False,3,7
23298,6,383,221,604,False,3,7
23299,7,270,183,453,False,3,7
23300,8,233,183,416,False,3,7
23301,9,232,188,420,False,3,7
23302,10,253,209,462,False,3,7
23303,11,225,241,466,False,3,7
23304,12,250,285,535,False,3,7
23305,13,238,338,576,False,3,7
23306,14,252,412,664,False,3,7
23307,15,179,238,417,False,3,7
23308,16,176,164,340,False,3,7
23309,17,128,164,292,False,3,7
23310,18,124,142,266,False,3,7
23311,19,85,111,196,False,3,7
23312,20,65,79,144,False,3,7
23313,21,33,52,85,False,3,7
23314,22,26,31,57,False,3,7
23315,23,17,29,46,False,3,7
23316,0,12,27,39,False,4,7
23317,1,10,24,34,False,4,7
23318,2,10,20,30,False,4,7
23319,3,20,12,32,False,4,7
23320,4,115,46,161,False,4,7
23321,5,247,141,388,False,4,7
23322,6,365,187,552,False,4,7
23323,7,255,158,413,False,4,7
23324,8,237,190,427,False,4,7
23325,9,234,175,409,False,4,7
23326,10,211,245,456,False,4,7
23327,11,197,242,439,False,4,7
23328,12,244,314,558,False,4,7
23329,13,256,395,651,False,4,7
23330,14,196,310,506,False,4,7
23331,15,178,183,361,False,4,7
23332,16,149,165,314,False,4,7
23333,17,143,130,273,False,4,7
23334,18,116,108,224,False,4,7
23335,19,93,98,191,False,4,7
23336,20,56,84,140,False,4,7
23337,21,52,64,116,False,4,7
23338,22,43,59,102,False,4,7
23339,23,34,50,84,False,4,7
23340,0,27,51,78,False,5,7
23341,1,22,51,73,False,5,7
23342,2,11,28,39,False,5,7
23343,3,7,10,17,False,5,7
23344,4,22,18,40,False,5,7
23345,5,28,26,54,False,5,7
23346,6,22,31,53,False,5,7
23347,7,56,64,120,False,5,7
23348,8,109,79,188,False,5,7
23349,9,148,114,262,False,5,7
23350,10,174,148,322,False,5,7
23351,11,154,170,324,False,5,7
23352,12,145,173,318,False,5,7
23353,13,154,188,342,False,5,7
23354,14,127,168,295,False,5,7
23355,15,158,147,305,False,5,7
23356,16,133,124,257,False,5,7
23357,17,115,119,234,False,5,7
23358,18,88,106,194,False,5,7
23359,19,70,91,161,False,5,7
23360,20,48,72,120,False,5,7
23361,21,39,62,101,False,5,7
23362,22,49,73,122,False,5,7
23363,23,30,52,82,False,5,7
23364,0,30,54,84,True,6,7
23365,1,34,52,86,True,6,7
23366,2,25,48,73,True,6,7
23367,3,11,26,37,True,6,7
23368,4,14,22,36,True,6,7
23369,5,18,27,45,True,6,7
23370,6,37,24,61,True,6,7
23371,7,55,43,98,True,6,7
23372,8,135,72,207,True,6,7
23373,9,111,77,188,True,6,7
23374,10,133,156,289,True,6,7
23375,11,137,184,321,True,6,7
23376,12,154,217,371,True,6,7
23377,13,177,217,394,True,6,7
23378,14,144,217,361,True,6,7
23379,15,181,157,338,True,6,7
23380,16,167,190,357,True,6,7
23381,17,166,150,316,True,6,7
23382,18,105,160,265,True,6,7
23383,19,87,121,208,True,6,7
23384,20,58,74,132,True,6,7
23385,21,27,47,74,True,6,7
23386,22,23,23,46,True,6,7
23387,23,8,19,27,True,6,7
23388,0,6,7,13,False,0,7
23389,1,4,7,11,False,0,7
23390,2,8,8,16,False,0,7
23391,3,18,8,26,False,0,7
23392,4,117,63,180,False,0,7
23393,5,245,168,413,False,0,7
23394,6,390,201,591,False,0,7
23395,7,277,181,458,False,0,7
23396,8,240,177,417,False,0,7
23397,9,225,177,402,False,0,7
23398,10,218,195,413,False,0,7
23399,11,220,236,456,False,0,7
23400,12,201,273,474,False,0,7
23401,13,261,353,614,False,0,7
23402,14,200,304,504,False,0,7
23403,15,197,200,397,False,0,7
23404,16,170,158,328,False,0,7
23405,17,131,121,252,False,0,7
23406,18,115,151,266,False,0,7
23407,19,86,113,199,False,0,7
23408,20,50,63,113,False,0,7
23409,21,31,43,74,False,0,7
23410,22,21,21,42,False,0,7
23411,23,11,6,17,False,0,7
23412,0,1,9,10,False,1,7
23413,1,8,14,22,False,1,7
23414,2,10,9,19,False,1,7
23415,3,15,10,25,False,1,7
23416,4,129,52,181,False,1,7
23417,5,271,153,424,False,1,7
23418,6,358,187,545,False,1,7
23419,7,231,155,386,False,1,7
23420,8,227,213,440,False,1,7
23421,9,238,179,417,False,1,7
23422,10,208,232,440,False,1,7
23423,11,204,247,451,False,1,7
23424,12,214,275,489,False,1,7
23425,13,258,371,629,False,1,7
23426,14,211,296,507,False,1,7
23427,15,172,176,348,False,1,7
23428,16,219,146,365,False,1,7
23429,17,142,157,299,False,1,7
23430,18,118,168,286,False,1,7
23431,19,90,120,210,False,1,7
23432,20,59,108,167,False,1,7
23433,21,36,39,75,False,1,7
23434,22,14,28,42,False,1,7
23435,23,9,26,35,False,1,7
23436,0,7,16,23,False,2,7
23437,1,12,21,33,False,2,7
23438,2,8,17,25,False,2,7
23439,3,20,14,34,False,2,7
23440,4,126,52,178,False,2,7
23441,5,247,164,411,False,2,7
23442,6,353,186,539,False,2,7
23443,7,272,147,419,False,2,7
23444,8,221,148,369,False,2,7
23445,9,181,165,346,False,2,7
23446,10,229,212,441,False,2,7
23447,11,205,187,392,False,2,7
23448,12,238,258,496,False,2,7
23449,13,268,359,627,False,2,7
23450,14,257,295,552,False,2,7
23451,15,193,236,429,False,2,7
23452,16,229,213,442,False,2,7
23453,17,149,154,303,False,2,7
23454,18,130,133,263,False,2,7
23455,19,92,126,218,False,2,7
23456,20,84,99,183,False,2,7
23457,21,43,63,106,False,2,7
23458,22,22,27,49,False,2,7
23459,23,13,27,40,False,2,7
23460,0,10,13,23,False,3,7
23461,1,10,18,28,False,3,7
23462,2,7,8,15,False,3,7
23463,3,18,14,32,False,3,7
23464,4,116,52,168,False,3,7
23465,5,216,131,347,False,3,7
23466,6,399,185,584,False,3,7
23467,7,277,183,460,False,3,7
23468,8,211,182,393,False,3,7
23469,9,235,194,429,False,3,7
23470,10,219,215,434,False,3,7
23471,11,200,195,395,False,3,7
23472,12,238,281,519,False,3,7
23473,13,266,357,623,False,3,7
23474,14,219,283,502,False,3,7
23475,15,183,191,374,False,3,7
23476,16,188,173,361,False,3,7
23477,17,146,176,322,False,3,7
23478,18,115,154,269,False,3,7
23479,19,110,126,236,False,3,7
23480,20,63,84,147,False,3,7
23481,21,44,41,85,False,3,7
23482,22,21,27,48,False,3,7
23483,23,17,25,42,False,3,7
23484,0,14,29,43,False,4,7
23485,1,11,27,38,False,4,7
23486,2,8,19,27,False,4,7
23487,3,18,15,33,False,4,7
23488,4,123,57,180,False,4,7
23489,5,221,138,359,False,4,7
23490,6,369,173,542,False,4,7
23491,7,262,159,421,False,4,7
23492,8,245,183,428,False,4,7
23493,9,241,195,436,False,4,7
23494,10,260,196,456,False,4,7
23495,11,228,241,469,False,4,7
23496,12,266,319,585,False,4,7
23497,13,276,361,637,False,4,7
23498,14,180,306,486,False,4,7
23499,15,159,196,355,False,4,7
23500,16,148,147,295,False,4,7
23501,17,135,127,262,False,4,7
23502,18,98,114,212,False,4,7
23503,19,77,89,166,False,4,7
23504,20,59,75,134,False,4,7
23505,21,47,60,107,False,4,7
23506,22,41,51,92,False,4,7
23507,23,33,47,80,False,4,7
23508,0,12,42,54,False,5,8
23509,1,22,31,53,False,5,8
23510,2,7,16,23,False,5,8
23511,3,8,7,15,False,5,8
23512,4,19,18,37,False,5,8
23513,5,26,22,48,False,5,8
23514,6,37,44,81,False,5,8
23515,7,56,51,107,False,5,8
23516,8,99,64,163,False,5,8
23517,9,146,85,231,False,5,8
23518,10,145,135,280,False,5,8
23519,11,142,158,300,False,5,8
23520,12,140,148,288,False,5,8
23521,13,146,178,324,False,5,8
23522,14,122,163,285,False,5,8
23523,15,128,180,308,False,5,8
23524,16,123,148,271,False,5,8
23525,17,97,107,204,False,5,8
23526,18,85,87,172,False,5,8
23527,19,67,86,153,False,5,8
23528,20,44,59,103,False,5,8
23529,21,41,62,103,False,5,8
23530,22,30,45,75,False,5,8
23531,23,33,43,76,False,5,8
23532,0,25,49,74,True,6,8
23533,1,33,49,82,True,6,8
23534,2,18,40,58,True,6,8
23535,3,12,16,28,True,6,8
23536,4,17,8,25,True,6,8
23537,5,14,16,30,True,6,8
23538,6,34,28,62,True,6,8
23539,7,56,41,97,True,6,8
23540,8,77,58,135,True,6,8
23541,9,117,94,211,True,6,8
23542,10,138,114,252,True,6,8
23543,11,157,181,338,True,6,8
23544,12,174,209,383,True,6,8
23545,13,144,187,331,True,6,8
23546,14,155,225,380,True,6,8
23547,15,185,197,382,True,6,8
23548,16,160,173,333,True,6,8
23549,17,130,166,296,True,6,8
23550,18,172,173,345,True,6,8
23551,19,83,111,194,True,6,8
23552,20,52,53,105,True,6,8
23553,21,23,37,60,True,6,8
23554,22,15,21,36,True,6,8
23555,23,10,17,27,True,6,8
23556,0,5,9,14,False,0,8
23557,1,9,13,22,False,0,8
23558,2,7,8,15,False,0,8
23559,3,22,13,35,False,0,8
23560,4,123,54,177,False,0,8
23561,5,243,148,391,False,0,8
23562,6,420,189,609,False,0,8
23563,7,242,176,418,False,0,8
23564,8,188,167,355,False,0,8
23565,9,211,180,391,False,0,8
23566,10,190,186,376,False,0,8
23567,11,251,209,460,False,0,8
23568,12,205,249,454,False,0,8
23569,13,212,311,523,False,0,8
23570,14,214,316,530,False,0,8
23571,15,181,195,376,False,0,8
23572,16,162,157,319,False,0,8
23573,17,126,130,256,False,0,8
23574,18,101,144,245,False,0,8
23575,19,95,110,205,False,0,8
23576,20,50,78,128,False,0,8
23577,21,27,35,62,False,0,8
23578,22,16,21,37,False,0,8
23579,23,11,9,20,False,0,8
23580,0,6,23,29,False,1,8
23581,1,10,11,21,False,1,8
23582,2,10,10,20,False,1,8
23583,3,25,10,35,False,1,8
23584,4,125,49,174,False,1,8
23585,5,235,138,373,False,1,8
23586,6,391,201,592,False,1,8
23587,7,259,162,421,False,1,8
23588,8,199,150,349,False,1,8
23589,9,227,185,412,False,1,8
23590,10,238,221,459,False,1,8
23591,11,234,224,458,False,1,8
23592,12,218,270,488,False,1,8
23593,13,274,348,622,False,1,8
23594,14,214,328,542,False,1,8
23595,15,184,163,347,False,1,8
23596,16,174,176,350,False,1,8
23597,17,154,174,328,False,1,8
23598,18,133,145,278,False,1,8
23599,19,106,136,242,False,1,8
23600,20,43,81,124,False,1,8
23601,21,29,49,78,False,1,8
23602,22,18,22,40,False,1,8
23603,23,7,20,27,False,1,8
23604,0,4,20,24,False,2,8
23605,1,14,13,27,False,2,8
23606,2,8,13,21,False,2,8
23607,3,20,8,28,False,2,8
23608,4,109,50,159,False,2,8
23609,5,235,136,371,False,2,8
23610,6,353,188,541,False,2,8
23611,7,247,167,414,False,2,8
23612,8,225,176,401,False,2,8
23613,9,204,184,388,False,2,8
23614,10,229,210,439,False,2,8
23615,11,206,179,385,False,2,8
23616,12,199,278,477,False,2,8
23617,13,260,316,576,False,2,8
23618,14,221,297,518,False,2,8
23619,15,212,179,391,False,2,8
23620,16,152,144,296,False,2,8
23621,17,137,175,312,False,2,8
23622,18,120,146,266,False,2,8
23623,19,99,130,229,False,2,8
23624,20,66,90,156,False,2,8
23625,21,38,57,95,False,2,8
23626,22,15,29,44,False,2,8
23627,23,9,20,29,False,2,8
23628,0,11,15,26,False,3,8
23629,1,6,11,17,False,3,8
23630,2,7,10,17,False,3,8
23631,3,22,8,30,False,3,8
23632,4,123,53,176,False,3,8
23633,5,224,130,354,False,3,8
23634,6,392,215,607,False,3,8
23635,7,257,178,435,False,3,8
23636,8,231,150,381,False,3,8
23637,9,205,153,358,False,3,8
23638,10,258,226,484,False,3,8
23639,11,244,199,443,False,3,8
23640,12,213,275,488,False,3,8
23641,13,268,338,606,False,3,8
23642,14,240,328,568,False,3,8
23643,15,175,191,366,False,3,8
23644,16,203,144,347,False,3,8
23645,17,181,189,370,False,3,8
23646,18,114,139,253,False,3,8
23647,19,90,106,196,False,3,8
23648,20,82,84,166,False,3,8
23649,21,36,40,76,False,3,8
23650,22,17,23,40,False,3,8
23651,23,10,23,33,False,3,8
23652,0,6,19,25,False,4,8
23653,1,12,21,33,False,4,8
23654,2,7,13,20,False,4,8
23655,3,15,10,25,False,4,8
23656,4,112,53,165,False,4,8
23657,5,215,133,348,False,4,8
23658,6,335,190,525,False,4,8
23659,7,212,146,358,False,4,8
23660,8,204,157,361,False,4,8
23661,9,215,171,386,False,4,8
23662,10,225,226,451,False,4,8
23663,11,197,253,450,False,4,8
23664,12,238,324,562,False,4,8
23665,13,283,356,639,False,4,8
23666,14,203,266,469,False,4,8
23667,15,148,186,334,False,4,8
23668,16,138,141,279,False,4,8
23669,17,100,126,226,False,4,8
23670,18,100,133,233,False,4,8
23671,19,73,99,172,False,4,8
23672,20,62,66,128,False,4,8
23673,21,55,84,139,False,4,8
23674,22,28,47,75,False,4,8
23675,23,22,35,57,False,4,8
23676,0,19,28,47,False,5,8
23677,1,8,37,45,False,5,8
23678,2,9,19,28,False,5,8
23679,3,8,13,21,False,5,8
23680,4,23,13,36,False,5,8
23681,5,26,25,51,False,5,8
23682,6,36,43,79,False,5,8
23683,7,70,55,125,False,5,8
23684,8,132,78,210,False,5,8
23685,9,119,111,230,False,5,8
23686,10,145,135,280,False,5,8
23687,11,162,152,314,False,5,8
23688,12,152,172,324,False,5,8
23689,13,116,179,295,False,5,8
23690,14,130,196,326,False,5,8
23691,15,123,145,268,False,5,8
23692,16,125,137,262,False,5,8
23693,17,110,121,231,False,5,8
23694,18,92,105,197,False,5,8
23695,19,62,76,138,False,5,8
23696,20,43,63,106,False,5,8
23697,21,34,58,92,False,5,8
23698,22,44,55,99,False,5,8
23699,23,34,49,83,False,5,8
23700,0,30,44,74,True,6,8
23701,1,30,59,89,True,6,8
23702,2,11,34,45,True,6,8
23703,3,14,22,36,True,6,8
23704,4,20,15,35,True,6,8
23705,5,19,12,31,True,6,8
23706,6,33,28,61,True,6,8
23707,7,74,40,114,True,6,8
23708,8,120,68,188,True,6,8
23709,9,104,104,208,True,6,8
23710,10,128,141,269,True,6,8
23711,11,153,199,352,True,6,8
23712,12,183,208,391,True,6,8
23713,13,143,173,316,True,6,8
23714,14,144,197,341,True,6,8
23715,15,157,176,333,True,6,8
23716,16,170,172,342,True,6,8
23717,17,136,167,303,True,6,8
23718,18,120,142,262,True,6,8
23719,19,103,139,242,True,6,8
23720,20,48,55,103,True,6,8
23721,21,40,34,74,True,6,8
23722,22,16,22,38,True,6,8
23723,23,4,13,17,True,6,8
23724,0,7,18,25,False,0,8
23725,1,5,9,14,False,0,8
23726,2,7,6,13,False,0,8
23727,3,26,12,38,False,0,8
23728,4,115,53,168,False,0,8
23729,5,213,137,350,False,0,8
23730,6,391,180,571,False,0,8
23731,7,261,149,410,False,0,8
23732,8,217,174,391,False,0,8
23733,9,218,176,394,False,0,8
23734,10,173,203,376,False,0,8
23735,11,218,232,450,False,0,8
23736,12,227,261,488,False,0,8
23737,13,262,331,593,False,0,8
23738,14,233,326,559,False,0,8
23739,15,220,198,418,False,0,8
23740,16,184,169,353,False,0,8
23741,17,126,161,287,False,0,8
23742,18,127,148,275,False,0,8
23743,19,78,120,198,False,0,8
23744,20,63,94,157,False,0,8
23745,21,40,45,85,False,0,8
23746,22,23,22,45,False,0,8
23747,23,9,9,18,False,0,8
23748,0,11,11,22,False,1,8
23749,1,12,9,21,False,1,8
23750,2,11,6,17,False,1,8
23751,3,19,9,28,False,1,8
23752,4,124,51,175,False,1,8
23753,5,245,141,386,False,1,8
23754,6,409,242,651,False,1,8
23755,7,285,166,451,False,1,8
23756,8,234,164,398,False,1,8
23757,9,235,189,424,False,1,8
23758,10,217,187,404,False,1,8
23759,11,198,199,397,False,1,8
23760,12,222,283,505,False,1,8
23761,13,215,360,575,False,1,8
23762,14,240,316,556,False,1,8
23763,15,185,211,396,False,1,8
23764,16,187,146,333,False,1,8
23765,17,141,159,300,False,1,8
23766,18,122,137,259,False,1,8
23767,19,86,109,195,False,1,8
23768,20,59,126,185,False,1,8
23769,21,28,44,72,False,1,8
23770,22,10,18,28,False,1,8
23771,23,14,16,30,False,1,8
23772,0,4,16,20,False,2,8
23773,1,8,12,20,False,2,8
23774,2,7,8,15,False,2,8
23775,3,18,12,30,False,2,8
23776,4,121,53,174,False,2,8
23777,5,218,147,365,False,2,8
23778,6,446,225,671,False,2,8
23779,7,244,159,403,False,2,8
23780,8,221,182,403,False,2,8
23781,9,219,201,420,False,2,8
23782,10,205,206,411,False,2,8
23783,11,215,202,417,False,2,8
23784,12,191,240,431,False,2,8
23785,13,222,327,549,False,2,8
23786,14,265,302,567,False,2,8
23787,15,188,199,387,False,2,8
23788,16,156,173,329,False,2,8
23789,17,155,151,306,False,2,8
23790,18,116,154,270,False,2,8
23791,19,78,115,193,False,2,8
23792,20,76,411,487,False,2,8
23793,21,28,215,243,False,2,8
23794,22,15,77,92,False,2,8
23795,23,14,56,70,False,2,8
23796,0,3,52,55,False,3,8
23797,1,8,38,46,False,3,8
23798,2,6,49,55,False,3,8
23799,3,15,56,71,False,3,8
23800,4,115,48,163,False,3,8
23801,5,220,155,375,False,3,8
23802,6,427,187,614,False,3,8
23803,7,258,169,427,False,3,8
23804,8,204,171,375,False,3,8
23805,9,220,188,408,False,3,8
23806,10,219,208,427,False,3,8
23807,11,224,206,430,False,3,8
23808,12,225,263,488,False,3,8
23809,13,259,308,567,False,3,8
23810,14,248,307,555,False,3,8
23811,15,216,207,423,False,3,8
23812,16,180,180,360,False,3,8
23813,17,137,170,307,False,3,8
23814,18,108,136,244,False,3,8
23815,19,101,133,234,False,3,8
23816,20,57,113,170,False,3,8
23817,21,32,63,95,False,3,8
23818,22,27,24,51,False,3,8
23819,23,15,19,34,False,3,8
23820,0,10,33,43,False,4,8
23821,1,17,23,40,False,4,8
23822,2,9,11,20,False,4,8
23823,3,16,12,28,False,4,8
23824,4,114,54,168,False,4,8
23825,5,195,126,321,False,4,8
23826,6,366,194,560,False,4,8
23827,7,279,158,437,False,4,8
23828,8,240,168,408,False,4,8
23829,9,216,182,398,False,4,8
23830,10,236,218,454,False,4,8
23831,11,187,228,415,False,4,8
23832,12,224,295,519,False,4,8
23833,13,282,348,630,False,4,8
23834,14,232,305,537,False,4,8
23835,15,199,205,404,False,4,8
23836,16,139,154,293,False,4,8
23837,17,132,119,251,False,4,8
23838,18,135,114,249,False,4,8
23839,19,64,135,199,False,4,8
23840,20,53,71,124,False,4,8
23841,21,46,60,106,False,4,8
23842,22,38,58,96,False,4,8
23843,23,22,46,68,False,4,8
23844,0,23,48,71,False,5,8
23845,1,16,53,69,False,5,8
23846,2,14,29,43,False,5,8
23847,3,16,9,25,False,5,8
23848,4,25,11,36,False,5,8
23849,5,28,24,52,False,5,8
23850,6,43,40,83,False,5,8
23851,7,78,53,131,False,5,8
23852,8,136,88,224,False,5,8
23853,9,156,110,266,False,5,8
23854,10,151,173,324,False,5,8
23855,11,161,154,315,False,5,8
23856,12,165,180,345,False,5,8
23857,13,145,173,318,False,5,8
23858,14,150,189,339,False,5,8
23859,15,142,170,312,False,5,8
23860,16,138,165,303,False,5,8
23861,17,116,127,243,False,5,8
23862,18,108,122,230,False,5,8
23863,19,76,80,156,False,5,8
23864,20,52,78,130,False,5,8
23865,21,50,66,116,False,5,8
23866,22,54,70,124,False,5,8
23867,23,28,54,82,False,5,8
23868,0,30,64,94,True,6,8
23869,1,30,66,96,True,6,8
23870,2,28,41,69,True,6,8
23871,3,10,14,24,True,6,8
23872,4,15,11,26,True,6,8
23873,5,15,18,33,True,6,8
23874,6,30,12,42,True,6,8
23875,7,73,37,110,True,6,8
23876,8,133,57,190,True,6,8
23877,9,131,82,213,True,6,8
23878,10,188,218,406,True,6,8
23879,11,175,212,387,True,6,8
23880,12,200,200,400,True,6,8
23881,13,171,217,388,True,6,8
23882,14,157,254,411,True,6,8
23883,15,169,198,367,True,6,8
23884,16,156,157,313,True,6,8
23885,17,141,172,313,True,6,8
23886,18,120,144,264,True,6,8
23887,19,81,103,184,True,6,8
23888,20,50,70,120,True,6,8
23889,21,32,44,76,True,6,8
23890,22,18,19,37,True,6,8
23891,23,15,22,37,True,6,8
23892,0,3,9,12,False,0,8
23893,1,6,7,13,False,0,8
23894,2,8,6,14,False,0,8
23895,3,20,12,32,False,0,8
23896,4,116,48,164,False,0,8
23897,5,234,157,391,False,0,8
23898,6,379,219,598,False,0,8
23899,7,236,148,384,False,0,8
23900,8,227,166,393,False,0,8
23901,9,204,182,386,False,0,8
23902,10,202,205,407,False,0,8
23903,11,223,226,449,False,0,8
23904,12,197,263,460,False,0,8
23905,13,241,301,542,False,0,8
23906,14,226,319,545,False,0,8
23907,15,174,207,381,False,0,8
23908,16,165,146,311,False,0,8
23909,17,124,127,251,False,0,8
23910,18,120,136,256,False,0,8
23911,19,92,125,217,False,0,8
23912,20,55,86,141,False,0,8
23913,21,40,35,75,False,0,8
23914,22,17,18,35,False,0,8
23915,23,9,10,19,False,0,8
23916,0,5,13,18,False,1,8
23917,1,4,5,9,False,1,8
23918,2,10,5,15,False,1,8
23919,3,18,13,31,False,1,8
23920,4,121,43,164,False,1,8
23921,5,226,167,393,False,1,8
23922,6,391,210,601,False,1,8
23923,7,235,165,400,False,1,8
23924,8,210,143,353,False,1,8
23925,9,223,196,419,False,1,8
23926,10,179,177,356,False,1,8
23927,11,213,222,435,False,1,8
23928,12,222,231,453,False,1,8
23929,13,242,309,551,False,1,8
23930,14,204,304,508,False,1,8
23931,15,178,183,361,False,1,8
23932,16,175,142,317,False,1,8
23933,17,161,157,318,False,1,8
23934,18,113,122,235,False,1,8
23935,19,87,97,184,False,1,8
23936,20,59,86,145,False,1,8
23937,21,38,61,99,False,1,8
23938,22,6,25,31,False,1,8
23939,23,10,20,30,False,1,8
23940,0,9,15,24,False,2,8
23941,1,6,19,25,False,2,8
23942,2,7,9,16,False,2,8
23943,3,21,15,36,False,2,8
23944,4,103,50,153,False,2,8
23945,5,243,167,410,False,2,8
23946,6,391,215,606,False,2,8
23947,7,249,163,412,False,2,8
23948,8,246,191,437,False,2,8
23949,9,215,182,397,False,2,8
23950,10,226,227,453,False,2,8
23951,11,223,224,447,False,2,8
23952,12,202,250,452,False,2,8
23953,13,242,328,570,False,2,8
23954,14,233,300,533,False,2,8
23955,15,189,214,403,False,2,8
23956,16,199,165,364,False,2,8
23957,17,145,133,278,False,2,8
23958,18,127,134,261,False,2,8
23959,19,84,110,194,False,2,8
23960,20,57,109,166,False,2,8
23961,21,30,40,70,False,2,8
23962,22,24,23,47,False,2,8
23963,23,14,21,35,False,2,8
23964,0,14,20,34,False,3,8
23965,1,2,13,15,False,3,8
23966,2,1,5,6,False,3,8
23967,3,20,17,37,False,3,8
23968,4,111,62,173,False,3,8
23969,5,245,159,404,False,3,8
23970,6,408,210,618,False,3,8
23971,7,264,178,442,False,3,8
23972,8,223,187,410,False,3,8
23973,9,211,184,395,False,3,8
23974,10,219,222,441,False,3,8
23975,11,224,212,436,False,3,8
23976,12,233,264,497,False,3,8
23977,13,243,317,560,False,3,8
23978,14,231,297,528,False,3,8
23979,15,191,194,385,False,3,8
23980,16,208,172,380,False,3,8
23981,17,138,161,299,False,3,8
23982,18,115,127,242,False,3,8
23983,19,87,104,191,False,3,8
23984,20,57,95,152,False,3,8
23985,21,31,39,70,False,3,8
23986,22,22,23,45,False,3,8
23987,23,9,23,32,False,3,8
23988,0,14,21,35,False,4,8
23989,1,7,9,16,False,4,8
23990,2,7,9,16,False,4,8
23991,3,23,11,34,False,4,8
23992,4,112,44,156,False,4,8
23993,5,228,152,380,False,4,8
23994,6,377,210,587,False,4,8
23995,7,276,184,460,False,4,8
23996,8,222,153,375,False,4,8
23997,9,232,197,429,False,4,8
23998,10,265,229,494,False,4,8
23999,11,244,238,482,False,4,8
24000,12,254,314,568,False,4,8
24001,13,253,361,614,False,4,8
24002,14,261,317,578,False,4,8
24003,15,161,192,353,False,4,8
24004,16,150,151,301,False,4,8
24005,17,116,144,260,False,4,8
24006,18,92,107,199,False,4,8
24007,19,54,79,133,False,4,8
24008,20,68,76,144,False,4,8
24009,21,56,67,123,False,4,8
24010,22,45,56,101,False,4,8
24011,23,21,35,56,False,4,8
24012,0,18,31,49,False,5,8
24013,1,15,23,38,False,5,8
24014,2,9,18,27,False,5,8
24015,3,7,5,12,False,5,8
24016,4,22,17,39,False,5,8
24017,5,23,21,44,False,5,8
24018,6,40,36,76,False,5,8
24019,7,88,60,148,False,5,8
24020,8,113,89,202,False,5,8
24021,9,166,100,266,False,5,8
24022,10,157,138,295,False,5,8
24023,11,170,186,356,False,5,8
24024,12,169,195,364,False,5,8
24025,13,158,173,331,False,5,8
24026,14,145,211,356,False,5,8
24027,15,137,157,294,False,5,8
24028,16,137,153,290,False,5,8
24029,17,130,145,275,False,5,8
24030,18,110,124,234,False,5,8
24031,19,68,87,155,False,5,8
24032,20,44,68,112,False,5,8
24033,21,39,65,104,False,5,8
24034,22,38,48,86,False,5,8
24035,23,51,56,107,False,5,8
24036,0,27,47,74,True,6,8
24037,1,27,52,79,True,6,8
24038,2,18,43,61,True,6,8
24039,3,9,24,33,True,6,8
24040,4,15,11,26,True,6,8
24041,5,21,21,42,True,6,8
24042,6,31,15,46,True,6,8
24043,7,60,45,105,True,6,8
24044,8,87,67,154,True,6,8
24045,9,102,100,202,True,6,8
24046,10,177,154,331,True,6,8
24047,11,164,161,325,True,6,8
24048,12,218,206,424,True,6,8
24049,13,193,238,431,True,6,8
24050,14,163,255,418,True,6,8
24051,15,168,239,407,True,6,8
24052,16,174,174,348,True,6,8
24053,17,119,169,288,True,6,8
24054,18,173,148,321,True,6,8
24055,19,82,105,187,True,6,8
24056,20,57,75,132,True,6,8
24057,21,23,33,56,True,6,8
24058,22,25,17,42,True,6,8
24059,23,10,11,21,True,6,8
24060,0,9,14,23,False,0,8
24061,1,5,10,15,False,0,8
24062,2,6,11,17,False,0,8
24063,3,19,12,31,False,0,8
24064,4,127,55,182,False,0,8
24065,5,207,136,343,False,0,8
24066,6,418,207,625,False,0,8
24067,7,264,175,439,False,0,8
24068,8,207,147,354,False,0,8
24069,9,221,179,400,False,0,8
24070,10,206,190,396,False,0,8
24071,11,191,184,375,False,0,8
24072,12,212,238,450,False,0,8
24073,13,230,321,551,False,0,8
24074,14,214,330,544,False,0,8
24075,15,191,211,402,False,0,8
24076,16,167,162,329,False,0,8
24077,17,142,146,288,False,0,8
24078,18,124,125,249,False,0,8
24079,19,87,112,199,False,0,8
24080,20,71,95,166,False,0,8
24081,21,39,34,73,False,0,8
24082,22,17,16,33,False,0,8
24083,23,12,6,18,False,0,8
24084,0,8,12,20,False,1,8
24085,1,4,8,12,False,1,8
24086,2,11,3,14,False,1,8
24087,3,16,9,25,False,1,8
24088,4,117,62,179,False,1,8
24089,5,231,142,373,False,1,8
24090,6,439,202,641,False,1,8
24091,7,264,184,448,False,1,8
24092,8,209,175,384,False,1,8
24093,9,229,180,409,False,1,8
24094,10,219,181,400,False,1,8
24095,11,210,215,425,False,1,8
24096,12,225,239,464,False,1,8
24097,13,257,329,586,False,1,8
24098,14,201,308,509,False,1,8
24099,15,205,214,419,False,1,8
24100,16,195,177,372,False,1,8
24101,17,167,169,336,False,1,8
24102,18,121,141,262,False,1,8
24103,19,87,138,225,False,1,8
24104,20,53,394,447,False,1,8
24105,21,29,76,105,False,1,8
24106,22,15,40,55,False,1,8
24107,23,6,17,23,False,1,8
24108,0,10,16,26,False,2,8
24109,1,8,17,25,False,2,8
24110,2,8,5,13,False,2,8
24111,3,18,9,27,False,2,8
24112,4,113,45,158,False,2,8
24113,5,211,152,363,False,2,8
24114,6,388,221,609,False,2,8
24115,7,248,158,406,False,2,8
24116,8,219,165,384,False,2,8
24117,9,222,188,410,False,2,8
24118,10,197,175,372,False,2,8
24119,11,209,200,409,False,2,8
24120,12,202,263,465,False,2,8
24121,13,225,285,510,False,2,8
24122,14,256,304,560,False,2,8
24123,15,167,182,349,False,2,8
24124,16,225,147,372,False,2,8
24125,17,154,145,299,False,2,8
24126,18,109,137,246,False,2,8
24127,19,92,108,200,False,2,8
24128,20,84,94,178,False,2,8
24129,21,41,33,74,False,2,8
24130,22,26,22,48,False,2,8
24131,23,15,21,36,False,2,8
24132,0,7,17,24,False,3,8
24133,1,14,13,27,False,3,8
24134,2,10,8,18,False,3,8
24135,3,23,10,33,False,3,8
24136,4,109,56,165,False,3,8
24137,5,224,135,359,False,3,8
24138,6,423,199,622,False,3,8
24139,7,272,153,425,False,3,8
24140,8,215,166,381,False,3,8
24141,9,179,171,350,False,3,8
24142,10,213,197,410,False,3,8
24143,11,216,207,423,False,3,8
24144,12,218,245,463,False,3,8
24145,13,242,308,550,False,3,8
24146,14,200,294,494,False,3,8
24147,15,187,206,393,False,3,8
24148,16,193,186,379,False,3,8
24149,17,145,158,303,False,3,8
24150,18,112,125,237,False,3,8
24151,19,77,129,206,False,3,8
24152,20,64,123,187,False,3,8
24153,21,28,44,72,False,3,8
24154,22,26,35,61,False,3,8
24155,23,14,28,42,False,3,8
24156,0,18,31,49,False,4,8
24157,1,11,29,40,False,4,8
24158,2,10,12,22,False,4,8
24159,3,26,13,39,False,4,8
24160,4,105,52,157,False,4,8
24161,5,215,147,362,False,4,8
24162,6,377,208,585,False,4,8
24163,7,253,174,427,False,4,8
24164,8,211,185,396,False,4,8
24165,9,224,201,425,False,4,8
24166,10,241,202,443,False,4,8
24167,11,226,225,451,False,4,8
24168,12,214,276,490,False,4,8
24169,13,238,339,577,False,4,8
24170,14,195,264,459,False,4,8
24171,15,194,195,389,False,4,8
24172,16,161,182,343,False,4,8
24173,17,124,128,252,False,4,8
24174,18,85,154,239,False,4,8
24175,19,56,91,147,False,4,8
24176,20,77,71,148,False,4,8
24177,21,51,68,119,False,4,8
24178,22,34,57,91,False,4,8
24179,23,23,33,56,False,4,8
24180,0,16,41,57,False,5,8
24181,1,14,29,43,False,5,8
24182,2,7,26,33,False,5,8
24183,3,15,17,32,False,5,8
24184,4,19,8,27,False,5,8
24185,5,34,30,64,False,5,8
24186,6,39,39,78,False,5,8
24187,7,72,48,120,False,5,8
24188,8,100,90,190,False,5,8
24189,9,133,116,249,False,5,8
24190,10,180,134,314,False,5,8
24191,11,177,162,339,False,5,8
24192,12,155,158,313,False,5,8
24193,13,140,166,306,False,5,8
24194,14,128,176,304,False,5,8
24195,15,117,154,271,False,5,8
24196,16,141,158,299,False,5,8
24197,17,99,105,204,False,5,8
24198,18,85,115,200,False,5,8
24199,19,63,70,133,False,5,8
24200,20,61,85,146,False,5,8
24201,21,46,71,117,False,5,8
24202,22,44,53,97,False,5,8
24203,23,24,52,76,False,5,8
24204,0,30,51,81,True,6,8
24205,1,25,62,87,True,6,8
24206,2,15,35,50,True,6,8
24207,3,10,17,27,True,6,8
24208,4,15,14,29,True,6,8
24209,5,21,18,39,True,6,8
24210,6,30,16,46,True,6,8
24211,7,47,44,91,True,6,8
24212,8,116,44,160,True,6,8
24213,9,103,79,182,True,6,8
24214,10,161,166,327,True,6,8
24215,11,168,178,346,True,6,8
24216,12,165,202,367,True,6,8
24217,13,200,196,396,True,6,8
24218,14,156,254,410,True,6,8
24219,15,200,195,395,True,6,8
24220,16,171,171,342,True,6,8
24221,17,147,184,331,True,6,8
24222,18,110,135,245,True,6,8
24223,19,73,106,179,True,6,8
24224,20,47,64,111,True,6,8
24225,21,23,41,64,True,6,8
24226,22,21,24,45,True,6,8
24227,23,10,16,26,True,6,8
24228,0,5,12,17,False,0,9
24229,1,11,20,31,False,0,9
24230,2,9,3,12,False,0,9
24231,3,27,11,38,False,0,9
24232,4,119,57,176,False,0,9
24233,5,209,154,363,False,0,9
24234,6,421,222,643,False,0,9
24235,7,232,132,364,False,0,9
24236,8,233,166,399,False,0,9
24237,9,213,176,389,False,0,9
24238,10,207,196,403,False,0,9
24239,11,227,221,448,False,0,9
24240,12,220,231,451,False,0,9
24241,13,247,325,572,False,0,9
24242,14,220,333,553,False,0,9
24243,15,183,187,370,False,0,9
24244,16,165,143,308,False,0,9
24245,17,122,107,229,False,0,9
24246,18,103,122,225,False,0,9
24247,19,87,127,214,False,0,9
24248,20,49,79,128,False,0,9
24249,21,34,38,72,False,0,9
24250,22,21,25,46,False,0,9
24251,23,11,15,26,False,0,9
24252,0,5,7,12,False,1,9
24253,1,3,11,14,False,1,9
24254,2,9,3,12,False,1,9
24255,3,20,12,32,False,1,9
24256,4,114,45,159,False,1,9
24257,5,238,162,400,False,1,9
24258,6,405,222,627,False,1,9
24259,7,247,164,411,False,1,9
24260,8,226,158,384,False,1,9
24261,9,215,197,412,False,1,9
24262,10,200,195,395,False,1,9
24263,11,218,223,441,False,1,9
24264,12,232,265,497,False,1,9
24265,13,237,325,562,False,1,9
24266,14,265,337,602,False,1,9
24267,15,190,201,391,False,1,9
24268,16,189,156,345,False,1,9
24269,17,151,170,321,False,1,9
24270,18,112,135,247,False,1,9
24271,19,68,118,186,False,1,9
24272,20,57,79,136,False,1,9
24273,21,35,46,81,False,1,9
24274,22,15,21,36,False,1,9
24275,23,12,22,34,False,1,9
24276,0,2,9,11,False,2,9
24277,1,7,12,19,False,2,9
24278,2,8,9,17,False,2,9
24279,3,21,14,35,False,2,9
24280,4,115,55,170,False,2,9
24281,5,243,166,409,False,2,9
24282,6,450,221,671,False,2,9
24283,7,281,130,411,False,2,9
24284,8,224,179,403,False,2,9
24285,9,224,177,401,False,2,9
24286,10,208,171,379,False,2,9
24287,11,234,214,448,False,2,9
24288,12,227,270,497,False,2,9
24289,13,254,353,607,False,2,9
24290,14,270,341,611,False,2,9
24291,15,194,221,415,False,2,9
24292,16,170,179,349,False,2,9
24293,17,173,165,338,False,2,9
24294,18,113,154,267,False,2,9
24295,19,100,120,220,False,2,9
24296,20,77,81,158,False,2,9
24297,21,33,48,81,False,2,9
24298,22,25,28,53,False,2,9
24299,23,12,21,33,False,2,9
24300,0,5,25,30,False,3,9
24301,1,11,20,31,False,3,9
24302,2,10,26,36,False,3,9
24303,3,28,12,40,False,3,9
24304,4,106,51,157,False,3,9
24305,5,218,141,359,False,3,9
24306,6,426,225,651,False,3,9
24307,7,296,157,453,False,3,9
24308,8,209,165,374,False,3,9
24309,9,197,167,364,False,3,9
24310,10,213,201,414,False,3,9
24311,11,208,231,439,False,3,9
24312,12,235,263,498,False,3,9
24313,13,276,352,628,False,3,9
24314,14,252,333,585,False,3,9
24315,15,215,206,421,False,3,9
24316,16,217,195,412,False,3,9
24317,17,171,199,370,False,3,9
24318,18,104,145,249,False,3,9
24319,19,108,125,233,False,3,9
24320,20,55,102,157,False,3,9
24321,21,25,48,73,False,3,9
24322,22,22,25,47,False,3,9
24323,23,10,21,31,False,3,9
24324,0,14,17,31,False,4,9
24325,1,5,20,25,False,4,9
24326,2,6,7,13,False,4,9
24327,3,25,8,33,False,4,9
24328,4,114,51,165,False,4,9
24329,5,245,137,382,False,4,9
24330,6,410,190,600,False,4,9
24331,7,262,152,414,False,4,9
24332,8,257,186,443,False,4,9
24333,9,259,186,445,False,4,9
24334,10,238,216,454,False,4,9
24335,11,227,238,465,False,4,9
24336,12,272,330,602,False,4,9
24337,13,253,363,616,False,4,9
24338,14,220,294,514,False,4,9
24339,15,152,189,341,False,4,9
24340,16,167,135,302,False,4,9
24341,17,108,132,240,False,4,9
24342,18,109,109,218,False,4,9
24343,19,78,100,178,False,4,9
24344,20,57,72,129,False,4,9
24345,21,37,46,83,False,4,9
24346,22,30,49,79,False,4,9
24347,23,27,35,62,False,4,9
24348,0,14,35,49,False,5,9
24349,1,12,35,47,False,5,9
24350,2,9,18,27,False,5,9
24351,3,14,11,25,False,5,9
24352,4,20,17,37,False,5,9
24353,5,25,27,52,False,5,9
24354,6,40,40,80,False,5,9
24355,7,59,43,102,False,5,9
24356,8,87,81,168,False,5,9
24357,9,114,99,213,False,5,9
24358,10,153,119,272,False,5,9
24359,11,149,134,283,False,5,9
24360,12,145,178,323,False,5,9
24361,13,140,160,300,False,5,9
24362,14,137,157,294,False,5,9
24363,15,128,157,285,False,5,9
24364,16,128,125,253,False,5,9
24365,17,94,113,207,False,5,9
24366,18,89,85,174,False,5,9
24367,19,58,62,120,False,5,9
24368,20,61,67,128,False,5,9
24369,21,30,62,92,False,5,9
24370,22,36,57,93,False,5,9
24371,23,25,46,71,False,5,9
24372,0,23,42,65,True,6,9
24373,1,18,42,60,True,6,9
24374,2,14,42,56,True,6,9
24375,3,7,17,24,True,6,9
24376,4,17,16,33,True,6,9
24377,5,17,16,33,True,6,9
24378,6,28,18,46,True,6,9
24379,7,41,35,76,True,6,9
24380,8,87,74,161,True,6,9
24381,9,90,69,159,True,6,9
24382,10,128,133,261,True,6,9
24383,11,129,163,292,True,6,9
24384,12,163,186,349,True,6,9
24385,13,143,189,332,True,6,9
24386,14,131,195,326,True,6,9
24387,15,126,163,289,True,6,9
24388,16,144,149,293,True,6,9
24389,17,141,171,312,True,6,9
24390,18,79,120,199,True,6,9
24391,19,74,82,156,True,6,9
24392,20,100,72,172,True,6,9
24393,21,34,31,65,True,6,9
24394,22,16,21,37,True,6,9
24395,23,5,15,20,True,6,9
24396,0,4,14,18,True,0,9
24397,1,6,11,17,True,0,9
24398,2,12,8,20,True,0,9
24399,3,25,9,34,True,0,9
24400,4,109,53,162,True,0,9
24401,5,201,144,345,True,0,9
24402,6,273,162,435,True,0,9
24403,7,237,155,392,True,0,9
24404,8,213,143,356,True,0,9
24405,9,221,155,376,True,0,9
24406,10,190,199,389,True,0,9
24407,11,192,198,390,True,0,9
24408,12,199,233,432,True,0,9
24409,13,187,252,439,True,0,9
24410,14,205,281,486,True,0,9
24411,15,154,174,328,True,0,9
24412,16,156,151,307,True,0,9
24413,17,82,145,227,True,0,9
24414,18,85,107,192,True,0,9
24415,19,57,100,157,True,0,9
24416,20,51,313,364,True,0,9
24417,21,28,151,179,True,0,9
24418,22,16,76,92,True,0,9
24419,23,15,47,62,True,0,9
24420,0,2,25,27,True,1,9
24421,1,5,29,34,True,1,9
24422,2,5,36,41,True,1,9
24423,3,23,22,45,True,1,9
24424,4,103,50,153,True,1,9
24425,5,228,143,371,True,1,9
24426,6,284,166,450,True,1,9
24427,7,244,146,390,True,1,9
24428,8,242,154,396,True,1,9
24429,9,199,161,360,True,1,9
24430,10,218,176,394,True,1,9
24431,11,195,202,397,True,1,9
24432,12,189,265,454,True,1,9
24433,13,215,247,462,True,1,9
24434,14,209,303,512,True,1,9
24435,15,188,176,364,True,1,9
24436,16,172,156,328,True,1,9
24437,17,126,139,265,True,1,9
24438,18,105,119,224,True,1,9
24439,19,89,108,197,True,1,9
24440,20,54,262,316,True,1,9
24441,21,31,135,166,True,1,9
24442,22,16,58,74,True,1,9
24443,23,11,22,33,True,1,9
24444,0,4,13,17,True,2,9
24445,1,6,18,24,True,2,9
24446,2,7,18,25,True,2,9
24447,3,20,12,32,True,2,9
24448,4,102,48,150,True,2,9
24449,5,245,134,379,True,2,9
24450,6,295,157,452,True,2,9
24451,7,221,150,371,True,2,9
24452,8,235,166,401,True,2,9
24453,9,191,165,356,True,2,9
24454,10,219,183,402,True,2,9
24455,11,220,214,434,True,2,9
24456,12,184,281,465,True,2,9
24457,13,252,273,525,True,2,9
24458,14,185,254,439,True,2,9
24459,15,162,188,350,True,2,9
24460,16,156,169,325,True,2,9
24461,17,113,130,243,True,2,9
24462,18,103,120,223,True,2,9
24463,19,74,101,175,True,2,9
24464,20,50,87,137,True,2,9
24465,21,22,48,70,True,2,9
24466,22,19,56,75,True,2,9
24467,23,14,70,84,True,2,9
24468,0,10,27,37,True,3,9
24469,1,10,28,38,True,3,9
24470,2,7,31,38,True,3,9
24471,3,20,38,58,True,3,9
24472,4,97,36,133,True,3,9
24473,5,206,131,337,True,3,9
24474,6,244,151,395,True,3,9
24475,7,199,138,337,True,3,9
24476,8,193,151,344,True,3,9
24477,9,223,157,380,True,3,9
24478,10,193,214,407,True,3,9
24479,11,206,211,417,True,3,9
24480,12,200,231,431,True,3,9
24481,13,314,323,637,True,3,9
24482,14,258,382,640,True,3,9
24483,15,154,166,320,True,3,9
24484,16,121,159,280,True,3,9
24485,17,112,135,247,True,3,9
24486,18,97,114,211,True,3,9
24487,19,80,91,171,True,3,9
24488,20,49,77,126,True,3,9
24489,21,22,46,68,True,3,9
24490,22,24,29,53,True,3,9
24491,23,19,23,42,True,3,9
24492,0,9,28,37,True,4,9
24493,1,12,18,30,True,4,9
24494,2,14,18,32,True,4,9
24495,3,20,18,38,True,4,9
24496,4,81,49,130,True,4,9
24497,5,173,113,286,True,4,9
24498,6,262,121,383,True,4,9
24499,7,201,123,324,True,4,9
24500,8,213,137,350,True,4,9
24501,9,205,173,378,True,4,9
24502,10,189,205,394,True,4,9
24503,11,215,194,409,True,4,9
24504,12,238,256,494,True,4,9
24505,13,234,313,547,True,4,9
24506,14,205,274,479,True,4,9
24507,15,145,182,327,True,4,9
24508,16,106,126,232,True,4,9
24509,17,112,117,229,True,4,9
24510,18,88,98,186,True,4,9
24511,19,64,68,132,True,4,9
24512,20,54,68,122,True,4,9
24513,21,33,54,87,True,4,9
24514,22,34,49,83,True,4,9
24515,23,26,51,77,True,4,9
24516,0,29,38,67,True,5,9
24517,1,12,38,50,True,5,9
24518,2,13,26,39,True,5,9
24519,3,13,8,21,True,5,9
24520,4,26,13,39,True,5,9
24521,5,19,27,46,True,5,9
24522,6,18,26,44,True,5,9
24523,7,63,40,103,True,5,9
24524,8,88,66,154,True,5,9
24525,9,107,88,195,True,5,9
24526,10,139,124,263,True,5,9
24527,11,164,120,284,True,5,9
24528,12,152,174,326,True,5,9
24529,13,142,178,320,True,5,9
24530,14,128,153,281,True,5,9
24531,15,131,142,273,True,5,9
24532,16,127,113,240,True,5,9
24533,17,89,106,195,True,5,9
24534,18,93,87,180,True,5,9
24535,19,50,69,119,True,5,9
24536,20,48,61,109,True,5,9
24537,21,41,54,95,True,5,9
24538,22,35,61,96,True,5,9
24539,23,23,47,70,True,5,9
24540,0,27,48,75,True,6,9
24541,1,33,65,98,True,6,9
24542,2,16,45,61,True,6,9
24543,3,21,16,37,True,6,9
24544,4,17,13,30,True,6,9
24545,5,9,14,23,True,6,9
24546,6,30,20,50,True,6,9
24547,7,47,28,75,True,6,9
24548,8,110,64,174,True,6,9
24549,9,99,69,168,True,6,9
24550,10,131,107,238,True,6,9
24551,11,129,154,283,True,6,9
24552,12,146,150,296,True,6,9
24553,13,135,165,300,True,6,9
24554,14,154,208,362,True,6,9
24555,15,165,171,336,True,6,9
24556,16,154,155,309,True,6,9
24557,17,124,129,253,True,6,9
24558,18,108,134,242,True,6,9
24559,19,59,89,148,True,6,9
24560,20,51,47,98,True,6,9
24561,21,20,41,61,True,6,9
24562,22,8,14,22,True,6,9
24563,23,5,10,15,True,6,9
24564,0,5,14,19,False,0,9
24565,1,9,9,18,False,0,9
24566,2,11,12,23,False,0,9
24567,3,18,12,30,False,0,9
24568,4,121,56,177,False,0,9
24569,5,236,150,386,False,0,9
24570,6,384,195,579,False,0,9
24571,7,244,145,389,False,0,9
24572,8,221,166,387,False,0,9
24573,9,217,158,375,False,0,9
24574,10,210,195,405,False,0,9
24575,11,209,179,388,False,0,9
24576,12,181,231,412,False,0,9
24577,13,237,297,534,False,0,9
24578,14,203,285,488,False,0,9
24579,15,192,214,406,False,0,9
24580,16,175,156,331,False,0,9
24581,17,131,158,289,False,0,9
24582,18,106,158,264,False,0,9
24583,19,78,115,193,False,0,9
24584,20,67,79,146,False,0,9
24585,21,42,39,81,False,0,9
24586,22,9,19,28,False,0,9
24587,23,12,8,20,False,0,9
24588,0,15,9,24,False,1,9
24589,1,15,13,28,False,1,9
24590,2,12,12,24,False,1,9
24591,3,21,14,35,False,1,9
24592,4,108,50,158,False,1,9
24593,5,237,134,371,False,1,9
24594,6,376,194,570,False,1,9
24595,7,270,182,452,False,1,9
24596,8,209,160,369,False,1,9
24597,9,216,182,398,False,1,9
24598,10,189,215,404,False,1,9
24599,11,193,203,396,False,1,9
24600,12,203,233,436,False,1,9
24601,13,242,300,542,False,1,9
24602,14,228,288,516,False,1,9
24603,15,192,175,367,False,1,9
24604,16,158,147,305,False,1,9
24605,17,136,148,284,False,1,9
24606,18,109,135,244,False,1,9
24607,19,72,122,194,False,1,9
24608,20,49,107,156,False,1,9
24609,21,27,44,71,False,1,9
24610,22,19,11,30,False,1,9
24611,23,10,19,29,False,1,9
24612,0,9,13,22,False,2,9
24613,1,16,20,36,False,2,9
24614,2,10,13,23,False,2,9
24615,3,16,16,32,False,2,9
24616,4,113,47,160,False,2,9
24617,5,235,149,384,False,2,9
24618,6,401,208,609,False,2,9
24619,7,291,162,453,False,2,9
24620,8,192,158,350,False,2,9
24621,9,224,156,380,False,2,9
24622,10,209,196,405,False,2,9
24623,11,212,210,422,False,2,9
24624,12,190,247,437,False,2,9
24625,13,245,313,558,False,2,9
24626,14,230,292,522,False,2,9
24627,15,214,210,424,False,2,9
24628,16,176,162,338,False,2,9
24629,17,134,149,283,False,2,9
24630,18,123,121,244,False,2,9
24631,19,81,122,203,False,2,9
24632,20,51,95,146,False,2,9
24633,21,16,45,61,False,2,9
24634,22,15,25,40,False,2,9
24635,23,14,19,33,False,2,9
24636,0,13,19,32,False,3,9
24637,1,10,12,22,False,3,9
24638,2,7,10,17,False,3,9
24639,3,21,9,30,False,3,9
24640,4,100,65,165,False,3,9
24641,5,231,143,374,False,3,9
24642,6,398,202,600,False,3,9
24643,7,258,171,429,False,3,9
24644,8,230,175,405,False,3,9
24645,9,224,158,382,False,3,9
24646,10,219,218,437,False,3,9
24647,11,200,222,422,False,3,9
24648,12,226,267,493,False,3,9
24649,13,236,302,538,False,3,9
24650,14,250,322,572,False,3,9
24651,15,198,186,384,False,3,9
24652,16,208,174,382,False,3,9
24653,17,146,161,307,False,3,9
24654,18,109,115,224,False,3,9
24655,19,63,86,149,False,3,9
24656,20,68,285,353,False,3,9
24657,21,41,183,224,False,3,9
24658,22,19,73,92,False,3,9
24659,23,13,64,77,False,3,9
24660,0,8,52,60,False,4,9
24661,1,12,41,53,False,4,9
24662,2,10,20,30,False,4,9
24663,3,24,17,41,False,4,9
24664,4,103,54,157,False,4,9
24665,5,239,128,367,False,4,9
24666,6,383,181,564,False,4,9
24667,7,237,160,397,False,4,9
24668,8,229,156,385,False,4,9
24669,9,233,192,425,False,4,9
24670,10,225,200,425,False,4,9
24671,11,227,251,478,False,4,9
24672,12,221,311,532,False,4,9
24673,13,238,333,571,False,4,9
24674,14,197,271,468,False,4,9
24675,15,160,180,340,False,4,9
24676,16,175,164,339,False,4,9
24677,17,128,147,275,False,4,9
24678,18,104,134,238,False,4,9
24679,19,69,86,155,False,4,9
24680,20,64,69,133,False,4,9
24681,21,52,73,125,False,4,9
24682,22,26,53,79,False,4,9
24683,23,32,45,77,False,4,9
24684,0,15,26,41,False,5,9
24685,1,13,37,50,False,5,9
24686,2,13,22,35,False,5,9
24687,3,7,12,19,False,5,9
24688,4,26,11,37,False,5,9
24689,5,23,28,51,False,5,9
24690,6,31,26,57,False,5,9
24691,7,68,54,122,False,5,9
24692,8,107,69,176,False,5,9
24693,9,161,122,283,False,5,9
24694,10,172,129,301,False,5,9
24695,11,143,159,302,False,5,9
24696,12,148,176,324,False,5,9
24697,13,155,162,317,False,5,9
24698,14,142,193,335,False,5,9
24699,15,128,149,277,False,5,9
24700,16,130,141,271,False,5,9
24701,17,117,119,236,False,5,9
24702,18,95,95,190,False,5,9
24703,19,74,71,145,False,5,9
24704,20,45,85,130,False,5,9
24705,21,52,70,122,False,5,9
24706,22,41,74,115,False,5,9
24707,23,35,52,87,False,5,9
24708,0,28,48,76,True,6,9
24709,1,31,59,90,True,6,9
24710,2,19,43,62,True,6,9
24711,3,12,14,26,True,6,9
24712,4,19,15,34,True,6,9
24713,5,18,24,42,True,6,9
24714,6,67,13,80,True,6,9
24715,7,71,36,107,True,6,9
24716,8,103,73,176,True,6,9
24717,9,124,93,217,True,6,9
24718,10,181,176,357,True,6,9
24719,11,138,202,340,True,6,9
24720,12,169,183,352,True,6,9
24721,13,166,197,363,True,6,9
24722,14,175,239,414,True,6,9
24723,15,165,149,314,True,6,9
24724,16,163,145,308,True,6,9
24725,17,129,141,270,True,6,9
24726,18,103,127,230,True,6,9
24727,19,73,93,166,True,6,9
24728,20,54,70,124,True,6,9
24729,21,23,35,58,True,6,9
24730,22,15,21,36,True,6,9
24731,23,14,12,26,True,6,9
24732,0,6,15,21,False,0,9
24733,1,5,13,18,False,0,9
24734,2,3,3,6,False,0,9
24735,3,27,10,37,False,0,9
24736,4,103,56,159,False,0,9
24737,5,223,138,361,False,0,9
24738,6,402,195,597,False,0,9
24739,7,247,136,383,False,0,9
24740,8,195,150,345,False,0,9
24741,9,209,173,382,False,0,9
24742,10,205,191,396,False,0,9
24743,11,196,231,427,False,0,9
24744,12,197,243,440,False,0,9
24745,13,229,313,542,False,0,9
24746,14,251,313,564,False,0,9
24747,15,216,185,401,False,0,9
24748,16,166,165,331,False,0,9
24749,17,128,145,273,False,0,9
24750,18,109,126,235,False,0,9
24751,19,76,90,166,False,0,9
24752,20,50,76,126,False,0,9
24753,21,24,41,65,False,0,9
24754,22,17,14,31,False,0,9
24755,23,10,15,25,False,0,9
24756,0,3,6,9,False,1,9
24757,1,7,6,13,False,1,9
24758,2,6,7,13,False,1,9
24759,3,20,15,35,False,1,9
24760,4,108,48,156,False,1,9
24761,5,233,145,378,False,1,9
24762,6,404,193,597,False,1,9
24763,7,270,149,419,False,1,9
24764,8,223,160,383,False,1,9
24765,9,217,167,384,False,1,9
24766,10,221,192,413,False,1,9
24767,11,216,199,415,False,1,9
24768,12,245,259,504,False,1,9
24769,13,226,293,519,False,1,9
24770,14,218,310,528,False,1,9
24771,15,186,161,347,False,1,9
24772,16,203,143,346,False,1,9
24773,17,141,152,293,False,1,9
24774,18,95,113,208,False,1,9
24775,19,89,121,210,False,1,9
24776,20,60,83,143,False,1,9
24777,21,26,83,109,False,1,9
24778,22,18,46,64,False,1,9
24779,23,11,22,33,False,1,9
24780,0,6,12,18,False,2,9
24781,1,7,9,16,False,2,9
24782,2,9,11,20,False,2,9
24783,3,20,11,31,False,2,9
24784,4,106,59,165,False,2,9
24785,5,238,144,382,False,2,9
24786,6,405,170,575,False,2,9
24787,7,262,145,407,False,2,9
24788,8,222,155,377,False,2,9
24789,9,197,167,364,False,2,9
24790,10,199,219,418,False,2,9
24791,11,209,182,391,False,2,9
24792,12,229,242,471,False,2,9
24793,13,250,318,568,False,2,9
24794,14,231,304,535,False,2,9
24795,15,193,199,392,False,2,9
24796,16,159,152,311,False,2,9
24797,17,135,132,267,False,2,9
24798,18,120,139,259,False,2,9
24799,19,65,102,167,False,2,9
24800,20,37,78,115,False,2,9
24801,21,35,40,75,False,2,9
24802,22,17,10,27,False,2,9
24803,23,12,20,32,False,2,9
24804,0,7,13,20,False,3,9
24805,1,8,10,18,False,3,9
24806,2,6,10,16,False,3,9
24807,3,17,10,27,False,3,9
24808,4,119,45,164,False,3,9
24809,5,226,145,371,False,3,9
24810,6,400,186,586,False,3,9
24811,7,242,148,390,False,3,9
24812,8,220,151,371,False,3,9
24813,9,225,171,396,False,3,9
24814,10,208,200,408,False,3,9
24815,11,236,209,445,False,3,9
24816,12,195,251,446,False,3,9
24817,13,254,299,553,False,3,9
24818,14,230,304,534,False,3,9
24819,15,195,190,385,False,3,9
24820,16,200,173,373,False,3,9
24821,17,150,142,292,False,3,9
24822,18,96,104,200,False,3,9
24823,19,76,105,181,False,3,9
24824,20,59,78,137,False,3,9
24825,21,37,57,94,False,3,9
24826,22,22,30,52,False,3,9
24827,23,17,22,39,False,3,9
24828,0,6,23,29,False,4,9
24829,1,6,24,30,False,4,9
24830,2,9,18,27,False,4,9
24831,3,27,13,40,False,4,9
24832,4,107,54,161,False,4,9
24833,5,229,139,368,False,4,9
24834,6,360,152,512,False,4,9
24835,7,257,157,414,False,4,9
24836,8,234,150,384,False,4,9
24837,9,232,191,423,False,4,9
24838,10,217,238,455,False,4,9
24839,11,236,222,458,False,4,9
24840,12,245,272,517,False,4,9
24841,13,271,335,606,False,4,9
24842,14,206,272,478,False,4,9
24843,15,171,161,332,False,4,9
24844,16,133,162,295,False,4,9
24845,17,113,173,286,False,4,9
24846,18,96,110,206,False,4,9
24847,19,75,84,159,False,4,9
24848,20,41,72,113,False,4,9
24849,21,52,63,115,False,4,9
24850,22,35,49,84,False,4,9
24851,23,29,46,75,False,4,9
24852,0,22,28,50,False,5,9
24853,1,19,42,61,False,5,9
24854,2,14,15,29,False,5,9
24855,3,12,16,28,False,5,9
24856,4,24,11,35,False,5,9
24857,5,26,21,47,False,5,9
24858,6,49,42,91,False,5,9
24859,7,87,54,141,False,5,9
24860,8,107,86,193,False,5,9
24861,9,160,118,278,False,5,9
24862,10,195,141,336,False,5,9
24863,11,170,160,330,False,5,9
24864,12,164,202,366,False,5,9
24865,13,153,245,398,False,5,9
24866,14,163,197,360,False,5,9
24867,15,143,160,303,False,5,9
24868,16,158,148,306,False,5,9
24869,17,105,134,239,False,5,9
24870,18,100,97,197,False,5,9
24871,19,49,73,122,False,5,9
24872,20,53,82,135,False,5,9
24873,21,49,70,119,False,5,9
24874,22,46,65,111,False,5,9
24875,23,31,44,75,False,5,9
24876,0,22,47,69,True,6,9
24877,1,29,64,93,True,6,9
24878,2,20,36,56,True,6,9
24879,3,16,21,37,True,6,9
24880,4,15,14,29,True,6,9
24881,5,19,12,31,True,6,9
24882,6,15,16,31,True,6,9
24883,7,35,20,55,True,6,9
24884,8,47,31,78,True,6,9
24885,9,117,69,186,True,6,9
24886,10,120,92,212,True,6,9
24887,11,141,148,289,True,6,9
24888,12,157,200,357,True,6,9
24889,13,186,196,382,True,6,9
24890,14,160,206,366,True,6,9
24891,15,172,200,372,True,6,9
24892,16,147,198,345,True,6,9
24893,17,162,168,330,True,6,9
24894,18,132,173,305,True,6,9
24895,19,62,92,154,True,6,9
24896,20,55,73,128,True,6,9
24897,21,135,79,214,True,6,9
24898,22,27,32,59,True,6,9
24899,23,16,22,38,True,6,9
24900,0,15,13,28,False,0,9
24901,1,2,8,10,False,0,9
24902,2,5,9,14,False,0,9
24903,3,7,8,15,False,0,9
24904,4,26,13,39,False,0,9
24905,5,113,59,172,False,0,9
24906,6,230,144,374,False,0,9
24907,7,379,165,544,False,0,9
24908,8,243,176,419,False,0,9
24909,9,198,145,343,False,0,9
24910,10,213,191,404,False,0,9
24911,11,204,213,417,False,0,9
24912,12,222,222,444,False,0,9
24913,13,225,242,467,False,0,9
24914,14,216,292,508,False,0,9
24915,15,210,310,520,False,0,9
24916,16,175,177,352,False,0,9
24917,17,165,164,329,False,0,9
24918,18,114,119,233,False,0,9
24919,19,94,127,221,False,0,9
24920,20,82,103,185,False,0,9
24921,21,55,65,120,False,0,9
24922,22,24,27,51,False,0,9
24923,23,10,21,31,False,0,9
24924,0,8,19,27,False,1,9
24925,1,4,5,9,False,1,9
24926,2,5,8,13,False,1,9
24927,3,5,6,11,False,1,9
24928,4,24,13,37,False,1,9
24929,5,132,54,186,False,1,9
24930,6,227,146,373,False,1,9
24931,7,395,202,597,False,1,9
24932,8,258,149,407,False,1,9
24933,9,236,185,421,False,1,9
24934,10,182,183,365,False,1,9
24935,11,224,199,423,False,1,9
24936,12,210,186,396,False,1,9
24937,13,235,264,499,False,1,9
24938,14,216,281,497,False,1,9
24939,15,202,290,492,False,1,9
24940,16,179,188,367,False,1,9
24941,17,177,141,318,False,1,9
24942,18,134,139,273,False,1,9
24943,19,95,126,221,False,1,9
24944,20,68,86,154,False,1,9
24945,21,42,94,136,False,1,9
24946,22,23,36,59,False,1,9
24947,23,14,18,32,False,1,9
24948,0,9,16,25,False,2,9
24949,1,9,10,19,False,2,9
24950,2,15,14,29,False,2,9
24951,3,13,8,21,False,2,9
24952,4,16,9,25,False,2,9
24953,5,121,47,168,False,2,9
24954,6,227,141,368,False,2,9
24955,7,406,217,623,False,2,9
24956,8,228,144,372,False,2,9
24957,9,220,170,390,False,2,9
24958,10,224,154,378,False,2,9
24959,11,226,184,410,False,2,9
24960,12,222,216,438,False,2,9
24961,13,228,255,483,False,2,9
24962,14,257,298,555,False,2,9
24963,15,216,288,504,False,2,9
24964,16,209,182,391,False,2,9
24965,17,205,175,380,False,2,9
24966,18,121,161,282,False,2,9
24967,19,105,151,256,False,2,9
24968,20,70,112,182,False,2,9
24969,21,51,78,129,False,2,9
24970,22,40,56,96,False,2,9
24971,23,18,26,44,False,2,9
24972,0,12,23,35,False,3,10
24973,1,20,28,48,False,3,10
24974,2,9,14,23,False,3,10
24975,3,8,19,27,False,3,10
24976,4,20,14,34,False,3,10
24977,5,128,48,176,False,3,10
24978,6,230,153,383,False,3,10
24979,7,445,211,656,False,3,10
24980,8,257,172,429,False,3,10
24981,9,203,175,378,False,3,10
24982,10,234,198,432,False,3,10
24983,11,220,218,438,False,3,10
24984,12,237,230,467,False,3,10
24985,13,238,300,538,False,3,10
24986,14,266,318,584,False,3,10
24987,15,221,309,530,False,3,10
24988,16,205,205,410,False,3,10
24989,17,203,180,383,False,3,10
24990,18,136,156,292,False,3,10
24991,19,117,127,244,False,3,10
24992,20,71,120,191,False,3,10
24993,21,64,101,165,False,3,10
24994,22,33,53,86,False,3,10
24995,23,12,26,38,False,3,10
24996,0,19,33,52,False,4,10
24997,1,14,22,36,False,4,10
24998,2,14,11,25,False,4,10
24999,3,10,13,23,False,4,10
25000,4,18,17,35,False,4,10
25001,5,128,60,188,False,4,10
25002,6,211,128,339,False,4,10
25003,7,418,196,614,False,4,10
25004,8,256,158,414,False,4,10
25005,9,236,158,394,False,4,10
25006,10,230,192,422,False,4,10
25007,11,228,260,488,False,4,10
25008,12,242,240,482,False,4,10
25009,13,251,278,529,False,4,10
25010,14,265,371,636,False,4,10
25011,15,192,277,469,False,4,10
25012,16,200,184,384,False,4,10
25013,17,180,151,331,False,4,10
25014,18,113,126,239,False,4,10
25015,19,95,125,220,False,4,10
25016,20,66,82,148,False,4,10
25017,21,61,66,127,False,4,10
25018,22,35,52,87,False,4,10
25019,23,26,44,70,False,4,10
25020,0,25,29,54,False,5,10
25021,1,19,27,46,False,5,10
25022,2,19,46,65,False,5,10
25023,3,15,20,35,False,5,10
25024,4,13,11,24,False,5,10
25025,5,25,10,35,False,5,10
25026,6,24,20,44,False,5,10
25027,7,43,31,74,False,5,10
25028,8,61,47,108,False,5,10
25029,9,128,80,208,False,5,10
25030,10,160,112,272,False,5,10
25031,11,202,160,362,False,5,10
25032,12,207,184,391,False,5,10
25033,13,161,225,386,False,5,10
25034,14,141,250,391,False,5,10
25035,15,164,210,374,False,5,10
25036,16,150,144,294,False,5,10
25037,17,151,166,317,False,5,10
25038,18,84,117,201,False,5,10
25039,19,72,75,147,False,5,10
25040,20,49,85,134,False,5,10
25041,21,48,67,115,False,5,10
25042,22,52,70,122,False,5,10
25043,23,47,62,109,False,5,10
25044,0,46,61,107,True,6,10
25045,1,26,48,74,True,6,10
25046,2,27,50,77,True,6,10
25047,3,13,34,47,True,6,10
25048,4,15,22,37,True,6,10
25049,5,21,19,40,True,6,10
25050,6,13,12,25,True,6,10
25051,7,30,12,42,True,6,10
25052,8,54,19,73,True,6,10
25053,9,116,67,183,True,6,10
25054,10,102,92,194,True,6,10
25055,11,146,155,301,True,6,10
25056,12,149,198,347,True,6,10
25057,13,200,198,398,True,6,10
25058,14,190,208,398,True,6,10
25059,15,204,241,445,True,6,10
25060,16,258,164,422,True,6,10
25061,17,146,216,362,True,6,10
25062,18,131,247,378,True,6,10
25063,19,93,128,221,True,6,10
25064,20,71,94,165,True,6,10
25065,21,101,61,162,True,6,10
25066,22,26,27,53,True,6,10
25067,23,15,33,48,True,6,10
25068,0,6,14,20,False,0,10
25069,1,4,8,12,False,0,10
25070,2,6,12,18,False,0,10
25071,3,10,5,15,False,0,10
25072,4,22,15,37,False,0,10
25073,5,117,44,161,False,0,10
25074,6,231,147,378,False,0,10
25075,7,401,191,592,False,0,10
25076,8,240,185,425,False,0,10
25077,9,200,138,338,False,0,10
25078,10,216,175,391,False,0,10
25079,11,226,184,410,False,0,10
25080,12,213,200,413,False,0,10
25081,13,207,218,425,False,0,10
25082,14,238,322,560,False,0,10
25083,15,220,300,520,False,0,10
25084,16,191,195,386,False,0,10
25085,17,138,181,319,False,0,10
25086,18,129,141,270,False,0,10
25087,19,95,129,224,False,0,10
25088,20,79,86,165,False,0,10
25089,21,51,90,141,False,0,10
25090,22,17,34,51,False,0,10
25091,23,15,21,36,False,0,10
25092,0,13,15,28,False,1,10
25093,1,7,7,14,False,1,10
25094,2,3,11,14,False,1,10
25095,3,8,8,16,False,1,10
25096,4,25,17,42,False,1,10
25097,5,131,54,185,False,1,10
25098,6,219,126,345,False,1,10
25099,7,385,189,574,False,1,10
25100,8,265,182,447,False,1,10
25101,9,228,171,399,False,1,10
25102,10,208,170,378,False,1,10
25103,11,198,188,386,False,1,10
25104,12,228,181,409,False,1,10
25105,13,227,259,486,False,1,10
25106,14,247,324,571,False,1,10
25107,15,225,318,543,False,1,10
25108,16,213,198,411,False,1,10
25109,17,173,135,308,False,1,10
25110,18,144,137,281,False,1,10
25111,19,75,134,209,False,1,10
25112,20,58,127,185,False,1,10
25113,21,54,80,134,False,1,10
25114,22,33,39,72,False,1,10
25115,23,16,13,29,False,1,10
25116,0,14,21,35,False,2,10
25117,1,11,16,27,False,2,10
25118,2,13,9,22,False,2,10
25119,3,13,10,23,False,2,10
25120,4,18,9,27,False,2,10
25121,5,127,45,172,False,2,10
25122,6,227,131,358,False,2,10
25123,7,398,182,580,False,2,10
25124,8,269,150,419,False,2,10
25125,9,208,146,354,False,2,10
25126,10,189,187,376,False,2,10
25127,11,217,201,418,False,2,10
25128,12,200,209,409,False,2,10
25129,13,217,244,461,False,2,10
25130,14,242,281,523,False,2,10
25131,15,206,276,482,False,2,10
25132,16,175,190,365,False,2,10
25133,17,205,168,373,False,2,10
25134,18,147,158,305,False,2,10
25135,19,113,143,256,False,2,10
25136,20,70,115,185,False,2,10
25137,21,48,93,141,False,2,10
25138,22,30,47,77,False,2,10
25139,23,15,35,50,False,2,10
25140,0,10,28,38,False,3,10
25141,1,12,27,39,False,3,10
25142,2,8,16,24,False,3,10
25143,3,8,16,24,False,3,10
25144,4,25,19,44,False,3,10
25145,5,113,52,165,False,3,10
25146,6,251,141,392,False,3,10
25147,7,385,184,569,False,3,10
25148,8,278,135,413,False,3,10
25149,9,218,174,392,False,3,10
25150,10,209,189,398,False,3,10
25151,11,211,203,414,False,3,10
25152,12,210,228,438,False,3,10
25153,13,229,234,463,False,3,10
25154,14,265,321,586,False,3,10
25155,15,204,284,488,False,3,10
25156,16,176,194,370,False,3,10
25157,17,199,151,350,False,3,10
25158,18,133,153,286,False,3,10
25159,19,88,103,191,False,3,10
25160,20,90,106,196,False,3,10
25161,21,74,65,139,False,3,10
25162,22,48,52,100,False,3,10
25163,23,29,29,58,False,3,10
25164,0,15,10,25,False,4,10
25165,1,19,39,58,False,4,10
25166,2,14,32,46,False,4,10
25167,3,9,29,38,False,4,10
25168,4,26,18,44,False,4,10
25169,5,95,49,144,False,4,10
25170,6,250,117,367,False,4,10
25171,7,302,179,481,False,4,10
25172,8,252,162,414,False,4,10
25173,9,220,174,394,False,4,10
25174,10,285,188,473,False,4,10
25175,11,224,223,447,False,4,10
25176,12,254,238,492,False,4,10
25177,13,264,308,572,False,4,10
25178,14,261,326,587,False,4,10
25179,15,214,285,499,False,4,10
25180,16,144,195,339,False,4,10
25181,17,148,165,313,False,4,10
25182,18,116,123,239,False,4,10
25183,19,88,104,192,False,4,10
25184,20,68,76,144,False,4,10
25185,21,43,63,106,False,4,10
25186,22,56,69,125,False,4,10
25187,23,33,50,83,False,4,10
25188,0,20,29,49,False,5,10
25189,1,17,35,52,False,5,10
25190,2,13,33,46,False,5,10
25191,3,10,21,31,False,5,10
25192,4,14,10,24,False,5,10
25193,5,25,14,39,False,5,10
25194,6,54,31,85,False,5,10
25195,7,117,61,178,False,5,10
25196,8,83,54,137,False,5,10
25197,9,139,80,219,False,5,10
25198,10,183,118,301,False,5,10
25199,11,164,159,323,False,5,10
25200,12,178,199,377,False,5,10
25201,13,162,196,358,False,5,10
25202,14,156,265,421,False,5,10
25203,15,155,195,350,False,5,10
25204,16,133,176,309,False,5,10
25205,17,136,138,274,False,5,10
25206,18,108,132,240,False,5,10
25207,19,64,96,160,False,5,10
25208,20,51,63,114,False,5,10
25209,21,49,62,111,False,5,10
25210,22,68,73,141,False,5,10
25211,23,31,54,85,False,5,10
25212,0,35,50,85,True,6,10
25213,1,34,59,93,True,6,10
25214,2,26,57,83,True,6,10
25215,3,20,38,58,True,6,10
25216,4,11,24,35,True,6,10
25217,5,13,14,27,True,6,10
25218,6,12,14,26,True,6,10
25219,7,36,15,51,True,6,10
25220,8,72,30,102,True,6,10
25221,9,100,72,172,True,6,10
25222,10,109,83,192,True,6,10
25223,11,175,138,313,True,6,10
25224,12,157,195,352,True,6,10
25225,13,199,178,377,True,6,10
25226,14,153,234,387,True,6,10
25227,15,132,214,346,True,6,10
25228,16,178,194,372,True,6,10
25229,17,118,118,236,True,6,10
25230,18,120,144,264,True,6,10
25231,19,112,136,248,True,6,10
25232,20,79,91,170,True,6,10
25233,21,55,61,116,True,6,10
25234,22,36,43,79,True,6,10
25235,23,16,19,35,True,6,10
25236,0,15,19,34,False,0,10
25237,1,8,9,17,False,0,10
25238,2,9,16,25,False,0,10
25239,3,13,8,21,False,0,10
25240,4,16,10,26,False,0,10
25241,5,135,46,181,False,0,10
25242,6,221,125,346,False,0,10
25243,7,429,204,633,False,0,10
25244,8,273,191,464,False,0,10
25245,9,218,173,391,False,0,10
25246,10,200,166,366,False,0,10
25247,11,200,197,397,False,0,10
25248,12,215,196,411,False,0,10
25249,13,216,255,471,False,0,10
25250,14,251,300,551,False,0,10
25251,15,225,296,521,False,0,10
25252,16,175,197,372,False,0,10
25253,17,152,141,293,False,0,10
25254,18,133,136,269,False,0,10
25255,19,82,112,194,False,0,10
25256,20,71,98,169,False,0,10
25257,21,60,51,111,False,0,10
25258,22,34,40,74,False,0,10
25259,23,14,18,32,False,0,10
25260,0,8,12,20,False,1,10
25261,1,7,15,22,False,1,10
25262,2,11,20,31,False,1,10
25263,3,5,17,22,False,1,10
25264,4,28,17,45,False,1,10
25265,5,122,48,170,False,1,10
25266,6,251,131,382,False,1,10
25267,7,415,203,618,False,1,10
25268,8,258,157,415,False,1,10
25269,9,225,168,393,False,1,10
25270,10,231,172,403,False,1,10
25271,11,208,181,389,False,1,10
25272,12,196,192,388,False,1,10
25273,13,192,248,440,False,1,10
25274,14,274,338,612,False,1,10
25275,15,200,317,517,False,1,10
25276,16,188,211,399,False,1,10
25277,17,143,153,296,False,1,10
25278,18,154,142,296,False,1,10
25279,19,109,121,230,False,1,10
25280,20,84,104,188,False,1,10
25281,21,65,117,182,False,1,10
25282,22,36,37,73,False,1,10
25283,23,16,24,40,False,1,10
25284,0,11,12,23,False,2,10
25285,1,3,13,16,False,2,10
25286,2,5,7,12,False,2,10
25287,3,4,8,12,False,2,10
25288,4,13,16,29,False,2,10
25289,5,118,57,175,False,2,10
25290,6,235,134,369,False,2,10
25291,7,388,200,588,False,2,10
25292,8,262,159,421,False,2,10
25293,9,239,161,400,False,2,10
25294,10,213,173,386,False,2,10
25295,11,215,185,400,False,2,10
25296,12,216,210,426,False,2,10
25297,13,226,252,478,False,2,10
25298,14,253,296,549,False,2,10
25299,15,261,308,569,False,2,10
25300,16,209,238,447,False,2,10
25301,17,167,178,345,False,2,10
25302,18,130,125,255,False,2,10
25303,19,112,112,224,False,2,10
25304,20,81,103,184,False,2,10
25305,21,57,74,131,False,2,10
25306,22,36,44,80,False,2,10
25307,23,22,22,44,False,2,10
25308,0,9,23,32,False,3,10
25309,1,10,19,29,False,3,10
25310,2,12,23,35,False,3,10
25311,3,9,10,19,False,3,10
25312,4,31,13,44,False,3,10
25313,5,110,52,162,False,3,10
25314,6,214,120,334,False,3,10
25315,7,393,204,597,False,3,10
25316,8,247,167,414,False,3,10
25317,9,223,166,389,False,3,10
25318,10,189,184,373,False,3,10
25319,11,182,213,395,False,3,10
25320,12,216,173,389,False,3,10
25321,13,230,257,487,False,3,10
25322,14,295,288,583,False,3,10
25323,15,243,346,589,False,3,10
25324,16,187,200,387,False,3,10
25325,17,185,160,345,False,3,10
25326,18,133,140,273,False,3,10
25327,19,106,131,237,False,3,10
25328,20,82,109,191,False,3,10
25329,21,49,96,145,False,3,10
25330,22,33,46,79,False,3,10
25331,23,14,34,48,False,3,10
25332,0,11,25,36,False,4,10
25333,1,9,29,38,False,4,10
25334,2,15,36,51,False,4,10
25335,3,9,16,25,False,4,10
25336,4,28,11,39,False,4,10
25337,5,120,57,177,False,4,10
25338,6,242,122,364,False,4,10
25339,7,392,180,572,False,4,10
25340,8,262,158,420,False,4,10
25341,9,193,176,369,False,4,10
25342,10,231,186,417,False,4,10
25343,11,235,210,445,False,4,10
25344,12,225,201,426,False,4,10
25345,13,235,291,526,False,4,10
25346,14,276,325,601,False,4,10
25347,15,178,252,430,False,4,10
25348,16,152,195,347,False,4,10
25349,17,167,143,310,False,4,10
25350,18,129,123,252,False,4,10
25351,19,98,95,193,False,4,10
25352,20,69,88,157,False,4,10
25353,21,49,71,120,False,4,10
25354,22,47,77,124,False,4,10
25355,23,29,67,96,False,4,10
25356,0,22,51,73,False,5,10
25357,1,15,33,48,False,5,10
25358,2,11,35,46,False,5,10
25359,3,12,31,43,False,5,10
25360,4,12,18,30,False,5,10
25361,5,28,12,40,False,5,10
25362,6,28,24,52,False,5,10
25363,7,43,28,71,False,5,10
25364,8,66,45,111,False,5,10
25365,9,108,68,176,False,5,10
25366,10,121,67,188,False,5,10
25367,11,131,113,244,False,5,10
25368,12,165,159,324,False,5,10
25369,13,160,174,334,False,5,10
25370,14,150,188,338,False,5,10
25371,15,137,175,312,False,5,10
25372,16,158,168,326,False,5,10
25373,17,130,117,247,False,5,10
25374,18,114,103,217,False,5,10
25375,19,66,87,153,False,5,10
25376,20,56,69,125,False,5,10
25377,21,46,67,113,False,5,10
25378,22,51,75,126,False,5,10
25379,23,41,49,90,False,5,10
25380,0,33,45,78,True,6,10
25381,1,35,57,92,True,6,10
25382,2,27,64,91,True,6,10
25383,3,17,36,53,True,6,10
25384,4,17,17,34,True,6,10
25385,5,21,14,35,True,6,10
25386,6,21,19,40,True,6,10
25387,7,23,17,40,True,6,10
25388,8,71,25,96,True,6,10
25389,9,116,62,178,True,6,10
25390,10,100,85,185,True,6,10
25391,11,163,151,314,True,6,10
25392,12,150,191,341,True,6,10
25393,13,189,184,373,True,6,10
25394,14,176,195,371,True,6,10
25395,15,168,207,375,True,6,10
25396,16,121,149,270,True,6,10
25397,17,152,135,287,True,6,10
25398,18,128,147,275,True,6,10
25399,19,116,149,265,True,6,10
25400,20,74,78,152,True,6,10
25401,21,55,76,131,True,6,10
25402,22,28,40,68,True,6,10
25403,23,11,17,28,True,6,10
25404,0,11,18,29,False,0,10
25405,1,9,10,19,False,0,10
25406,2,9,11,20,False,0,10
25407,3,7,13,20,False,0,10
25408,4,30,7,37,False,0,10
25409,5,123,54,177,False,0,10
25410,6,207,131,338,False,0,10
25411,7,393,202,595,False,0,10
25412,8,267,176,443,False,0,10
25413,9,196,136,332,False,0,10
25414,10,180,157,337,False,0,10
25415,11,200,179,379,False,0,10
25416,12,193,208,401,False,0,10
25417,13,223,236,459,False,0,10
25418,14,224,287,511,False,0,10
25419,15,199,292,491,False,0,10
25420,16,174,181,355,False,0,10
25421,17,162,161,323,False,0,10
25422,18,136,140,276,False,0,10
25423,19,116,137,253,False,0,10
25424,20,61,88,149,False,0,10
25425,21,53,67,120,False,0,10
25426,22,34,43,77,False,0,10
25427,23,19,22,41,False,0,10
25428,0,6,14,20,False,1,10
25429,1,4,10,14,False,1,10
25430,2,6,12,18,False,1,10
25431,3,5,4,9,False,1,10
25432,4,21,11,32,False,1,10
25433,5,109,46,155,False,1,10
25434,6,213,140,353,False,1,10
25435,7,403,192,595,False,1,10
25436,8,251,190,441,False,1,10
25437,9,224,163,387,False,1,10
25438,10,204,172,376,False,1,10
25439,11,196,187,383,False,1,10
25440,12,211,187,398,False,1,10
25441,13,214,251,465,False,1,10
25442,14,254,301,555,False,1,10
25443,15,205,305,510,False,1,10
25444,16,192,189,381,False,1,10
25445,17,175,159,334,False,1,10
25446,18,140,121,261,False,1,10
25447,19,105,108,213,False,1,10
25448,20,75,108,183,False,1,10
25449,21,59,98,157,False,1,10
25450,22,21,36,57,False,1,10
25451,23,14,23,37,False,1,10
25452,0,8,10,18,False,2,10
25453,1,11,15,26,False,2,10
25454,2,5,11,16,False,2,10
25455,3,8,16,24,False,2,10
25456,4,17,8,25,False,2,10
25457,5,109,48,157,False,2,10
25458,6,225,111,336,False,2,10
25459,7,420,207,627,False,2,10
25460,8,241,166,407,False,2,10
25461,9,237,171,408,False,2,10
25462,10,214,187,401,False,2,10
25463,11,203,174,377,False,2,10
25464,12,222,189,411,False,2,10
25465,13,207,251,458,False,2,10
25466,14,235,280,515,False,2,10
25467,15,207,323,530,False,2,10
25468,16,210,197,407,False,2,10
25469,17,162,158,320,False,2,10
25470,18,133,147,280,False,2,10
25471,19,107,150,257,False,2,10
25472,20,79,98,177,False,2,10
25473,21,50,288,338,False,2,10
25474,22,27,138,165,False,2,10
25475,23,19,61,80,False,2,10
25476,0,11,34,45,False,3,10
25477,1,13,17,30,False,3,10
25478,2,7,19,26,False,3,10
25479,3,8,9,17,False,3,10
25480,4,26,11,37,False,3,10
25481,5,112,45,157,False,3,10
25482,6,205,111,316,False,3,10
25483,7,398,174,572,False,3,10
25484,8,256,153,409,False,3,10
25485,9,198,160,358,False,3,10
25486,10,207,155,362,False,3,10
25487,11,191,187,378,False,3,10
25488,12,209,211,420,False,3,10
25489,13,201,233,434,False,3,10
25490,14,249,284,533,False,3,10
25491,15,239,303,542,False,3,10
25492,16,188,189,377,False,3,10
25493,17,177,168,345,False,3,10
25494,18,130,154,284,False,3,10
25495,19,102,136,238,False,3,10
25496,20,79,117,196,False,3,10
25497,21,65,86,151,False,3,10
25498,22,40,54,94,False,3,10
25499,23,13,24,37,False,3,10
25500,0,13,17,30,False,4,10
25501,1,5,16,21,False,4,10
25502,2,12,42,54,False,4,10
25503,3,5,16,21,False,4,10
25504,4,20,13,33,False,4,10
25505,5,124,47,171,False,4,10
25506,6,229,130,359,False,4,10
25507,7,367,182,549,False,4,10
25508,8,262,142,404,False,4,10
25509,9,217,159,376,False,4,10
25510,10,212,189,401,False,4,10
25511,11,220,238,458,False,4,10
25512,12,189,230,419,False,4,10
25513,13,237,257,494,False,4,10
25514,14,240,359,599,False,4,10
25515,15,190,229,419,False,4,10
25516,16,176,181,357,False,4,10
25517,17,167,148,315,False,4,10
25518,18,133,133,266,False,4,10
25519,19,91,98,189,False,4,10
25520,20,82,90,172,False,4,10
25521,21,57,73,130,False,4,10
25522,22,47,60,107,False,4,10
25523,23,36,47,83,False,4,10
25524,0,30,67,97,False,5,10
25525,1,23,26,49,False,5,10
25526,2,23,41,64,False,5,10
25527,3,16,41,57,False,5,10
25528,4,11,14,25,False,5,10
25529,5,26,14,40,False,5,10
25530,6,22,18,40,False,5,10
25531,7,43,47,90,False,5,10
25532,8,54,37,91,False,5,10
25533,9,95,73,168,False,5,10
25534,10,145,100,245,False,5,10
25535,11,175,125,300,False,5,10
25536,12,168,149,317,False,5,10
25537,13,215,177,392,False,5,10
25538,14,408,190,598,False,5,10
25539,15,443,194,637,False,5,10
25540,16,185,528,713,False,5,10
25541,17,141,222,363,False,5,10
25542,18,81,134,215,False,5,10
25543,19,111,94,205,False,5,10
25544,20,56,97,153,False,5,10
25545,21,63,67,130,False,5,10
25546,22,55,77,132,False,5,10
25547,23,39,52,91,False,5,10
25548,0,34,50,84,True,6,10
25549,1,26,53,79,True,6,10
25550,2,31,49,80,True,6,10
25551,3,15,36,51,True,6,10
25552,4,12,16,28,True,6,10
25553,5,18,15,33,True,6,10
25554,6,16,16,32,True,6,10
25555,7,30,12,42,True,6,10
25556,8,47,28,75,True,6,10
25557,9,97,72,169,True,6,10
25558,10,103,77,180,True,6,10
25559,11,142,150,292,True,6,10
25560,12,152,170,322,True,6,10
25561,13,159,178,337,True,6,10
25562,14,155,178,333,True,6,10
25563,15,169,194,363,True,6,10
25564,16,142,163,305,True,6,10
25565,17,133,133,266,True,6,10
25566,18,140,151,291,True,6,10
25567,19,104,144,248,True,6,10
25568,20,69,103,172,True,6,10
25569,21,55,45,100,True,6,10
25570,22,23,49,72,True,6,10
25571,23,17,22,39,True,6,10
25572,0,6,19,25,False,0,10
25573,1,6,11,17,False,0,10
25574,2,7,13,20,False,0,10
25575,3,5,6,11,False,0,10
25576,4,23,11,34,False,0,10
25577,5,112,53,165,False,0,10
25578,6,221,147,368,False,0,10
25579,7,379,179,558,False,0,10
25580,8,278,149,427,False,0,10
25581,9,191,155,346,False,0,10
25582,10,182,156,338,False,0,10
25583,11,210,182,392,False,0,10
25584,12,210,195,405,False,0,10
25585,13,216,234,450,False,0,10
25586,14,227,301,528,False,0,10
25587,15,208,274,482,False,0,10
25588,16,166,185,351,False,0,10
25589,17,137,157,294,False,0,10
25590,18,115,123,238,False,0,10
25591,19,105,141,246,False,0,10
25592,20,75,80,155,False,0,10
25593,21,54,66,120,False,0,10
25594,22,20,29,49,False,0,10
25595,23,13,19,32,False,0,10
25596,0,6,13,19,False,1,10
25597,1,4,7,11,False,1,10
25598,2,6,8,14,False,1,10
25599,3,7,12,19,False,1,10
25600,4,20,8,28,False,1,10
25601,5,119,50,169,False,1,10
25602,6,224,134,358,False,1,10
25603,7,399,177,576,False,1,10
25604,8,270,163,433,False,1,10
25605,9,217,176,393,False,1,10
25606,10,208,171,379,False,1,10
25607,11,217,207,424,False,1,10
25608,12,204,202,406,False,1,10
25609,13,197,271,468,False,1,10
25610,14,277,301,578,False,1,10
25611,15,244,306,550,False,1,10
25612,16,149,180,329,False,1,10
25613,17,164,168,332,False,1,10
25614,18,127,144,271,False,1,10
25615,19,92,110,202,False,1,10
25616,20,65,97,162,False,1,10
25617,21,57,103,160,False,1,10
25618,22,16,51,67,False,1,10
25619,23,15,73,88,False,1,10
25620,0,12,29,41,False,2,10
25621,1,6,31,37,False,2,10
25622,2,6,8,14,False,2,10
25623,3,7,11,18,False,2,10
25624,4,20,13,33,False,2,10
25625,5,110,51,161,False,2,10
25626,6,238,143,381,False,2,10
25627,7,371,201,572,False,2,10
25628,8,255,172,427,False,2,10
25629,9,244,165,409,False,2,10
25630,10,234,175,409,False,2,10
25631,11,211,195,406,False,2,10
25632,12,223,213,436,False,2,10
25633,13,209,232,441,False,2,10
25634,14,285,344,629,False,2,10
25635,15,227,266,493,False,2,10
25636,16,183,198,381,False,2,10
25637,17,194,186,380,False,2,10
25638,18,105,152,257,False,2,10
25639,19,102,138,240,False,2,10
25640,20,71,116,187,False,2,10
25641,21,62,71,133,False,2,10
25642,22,38,50,88,False,2,10
25643,23,26,24,50,False,2,10
25644,0,12,24,36,False,3,10
25645,1,6,11,17,False,3,10
25646,2,6,21,27,False,3,10
25647,3,7,13,20,False,3,10
25648,4,16,8,24,False,3,10
25649,5,112,46,158,False,3,10
25650,6,232,146,378,False,3,10
25651,7,374,196,570,False,3,10
25652,8,242,158,400,False,3,10
25653,9,221,171,392,False,3,10
25654,10,271,188,459,False,3,10
25655,11,204,195,399,False,3,10
25656,12,242,211,453,False,3,10
25657,13,199,260,459,False,3,10
25658,14,267,315,582,False,3,10
25659,15,230,293,523,False,3,10
25660,16,208,199,407,False,3,10
25661,17,215,167,382,False,3,10
25662,18,152,150,302,False,3,10
25663,19,106,148,254,False,3,10
25664,20,77,112,189,False,3,10
25665,21,53,94,147,False,3,10
25666,22,33,61,94,False,3,10
25667,23,16,26,42,False,3,10
25668,0,13,29,42,False,4,10
25669,1,9,18,27,False,4,10
25670,2,9,25,34,False,4,10
25671,3,10,16,26,False,4,10
25672,4,18,13,31,False,4,10
25673,5,118,57,175,False,4,10
25674,6,236,138,374,False,4,10
25675,7,391,207,598,False,4,10
25676,8,259,149,408,False,4,10
25677,9,234,169,403,False,4,10
25678,10,238,182,420,False,4,10
25679,11,236,205,441,False,4,10
25680,12,247,217,464,False,4,10
25681,13,254,315,569,False,4,10
25682,14,268,358,626,False,4,10
25683,15,225,292,517,False,4,10
25684,16,170,172,342,False,4,10
25685,17,178,193,371,False,4,10
25686,18,135,138,273,False,4,10
25687,19,98,121,219,False,4,10
25688,20,67,68,135,False,4,10
25689,21,64,75,139,False,4,10
25690,22,61,74,135,False,4,10
25691,23,49,55,104,False,4,10
25692,0,25,37,62,False,5,11
25693,1,22,37,59,False,5,11
25694,2,22,34,56,False,5,11
25695,3,18,40,58,False,5,11
25696,4,11,15,26,False,5,11
25697,5,23,15,38,False,5,11
25698,6,28,27,55,False,5,11
25699,7,41,32,73,False,5,11
25700,8,81,53,134,False,5,11
25701,9,117,94,211,False,5,11
25702,10,168,119,287,False,5,11
25703,11,169,166,335,False,5,11
25704,12,194,162,356,False,5,11
25705,13,183,225,408,False,5,11
25706,14,148,180,328,False,5,11
25707,15,170,217,387,False,5,11
25708,16,146,163,309,False,5,11
25709,17,123,165,288,False,5,11
25710,18,98,120,218,False,5,11
25711,19,69,83,152,False,5,11
25712,20,63,68,131,False,5,11
25713,21,57,80,137,False,5,11
25714,22,46,77,123,False,5,11
25715,23,49,57,106,False,5,11
25716,0,26,50,76,True,6,11
25717,1,27,46,73,True,6,11
25718,2,27,48,75,True,6,11
25719,3,11,35,46,True,6,11
25720,4,15,24,39,True,6,11
25721,5,16,16,32,True,6,11
25722,6,10,15,25,True,6,11
25723,7,31,17,48,True,6,11
25724,8,54,30,84,True,6,11
25725,9,107,85,192,True,6,11
25726,10,128,96,224,True,6,11
25727,11,139,163,302,True,6,11
25728,12,166,163,329,True,6,11
25729,13,207,210,417,True,6,11
25730,14,171,182,353,True,6,11
25731,15,151,207,358,True,6,11
25732,16,156,189,345,True,6,11
25733,17,161,176,337,True,6,11
25734,18,138,183,321,True,6,11
25735,19,97,140,237,True,6,11
25736,20,66,95,161,True,6,11
25737,21,60,63,123,True,6,11
25738,22,24,38,62,True,6,11
25739,23,20,32,52,True,6,11
25740,0,8,17,25,False,0,11
25741,1,14,9,23,False,0,11
25742,2,9,20,29,False,0,11
25743,3,11,11,22,False,0,11
25744,4,24,10,34,False,0,11
25745,5,137,57,194,False,0,11
25746,6,254,125,379,False,0,11
25747,7,426,231,657,False,0,11
25748,8,239,162,401,False,0,11
25749,9,216,142,358,False,0,11
25750,10,177,181,358,False,0,11
25751,11,244,196,440,False,0,11
25752,12,216,229,445,False,0,11
25753,13,225,230,455,False,0,11
25754,14,238,317,555,False,0,11
25755,15,222,312,534,False,0,11
25756,16,220,190,410,False,0,11
25757,17,156,167,323,False,0,11
25758,18,141,160,301,False,0,11
25759,19,111,124,235,False,0,11
25760,20,80,125,205,False,0,11
25761,21,58,65,123,False,0,11
25762,22,30,33,63,False,0,11
25763,23,19,19,38,False,0,11
25764,0,12,18,30,False,1,11
25765,1,10,12,22,False,1,11
25766,2,5,17,22,False,1,11
25767,3,8,20,28,False,1,11
25768,4,19,12,31,False,1,11
25769,5,135,44,179,False,1,11
25770,6,229,139,368,False,1,11
25771,7,420,205,625,False,1,11
25772,8,268,167,435,False,1,11
25773,9,216,172,388,False,1,11
25774,10,198,198,396,False,1,11
25775,11,213,185,398,False,1,11
25776,12,224,226,450,False,1,11
25777,13,213,245,458,False,1,11
25778,14,243,322,565,False,1,11
25779,15,211,287,498,False,1,11
25780,16,183,187,370,False,1,11
25781,17,189,166,355,False,1,11
25782,18,130,129,259,False,1,11
25783,19,91,129,220,False,1,11
25784,20,72,125,197,False,1,11
25785,21,70,80,150,False,1,11
25786,22,34,60,94,False,1,11
25787,23,26,17,43,False,1,11
25788,0,7,21,28,False,2,11
25789,1,10,15,25,False,2,11
25790,2,3,15,18,False,2,11
25791,3,14,13,27,False,2,11
25792,4,16,14,30,False,2,11
25793,5,105,59,164,False,2,11
25794,6,233,123,356,False,2,11
25795,7,401,197,598,False,2,11
25796,8,282,131,413,False,2,11
25797,9,239,193,432,False,2,11
25798,10,200,172,372,False,2,11
25799,11,235,207,442,False,2,11
25800,12,208,227,435,False,2,11
25801,13,205,268,473,False,2,11
25802,14,262,323,585,False,2,11
25803,15,219,292,511,False,2,11
25804,16,214,224,438,False,2,11
25805,17,172,178,350,False,2,11
25806,18,139,131,270,False,2,11
25807,19,95,134,229,False,2,11
25808,20,66,96,162,False,2,11
25809,21,77,100,177,False,2,11
25810,22,45,91,136,False,2,11
25811,23,18,34,52,False,2,11
25812,0,12,20,32,False,3,11
25813,1,7,14,21,False,3,11
25814,2,5,13,18,False,3,11
25815,3,15,11,26,False,3,11
25816,4,22,15,37,False,3,11
25817,5,113,55,168,False,3,11
25818,6,251,124,375,False,3,11
25819,7,419,192,611,False,3,11
25820,8,263,138,401,False,3,11
25821,9,224,154,378,False,3,11
25822,10,207,181,388,False,3,11
25823,11,212,196,408,False,3,11
25824,12,214,220,434,False,3,11
25825,13,237,233,470,False,3,11
25826,14,249,341,590,False,3,11
25827,15,244,330,574,False,3,11
25828,16,224,213,437,False,3,11
25829,17,190,166,356,False,3,11
25830,18,128,142,270,False,3,11
25831,19,116,117,233,False,3,11
25832,20,76,120,196,False,3,11
25833,21,63,85,148,False,3,11
25834,22,34,46,80,False,3,11
25835,23,26,34,60,False,3,11
25836,0,14,32,46,False,4,11
25837,1,10,33,43,False,4,11
25838,2,6,27,33,False,4,11
25839,3,13,20,33,False,4,11
25840,4,20,8,28,False,4,11
25841,5,134,57,191,False,4,11
25842,6,240,137,377,False,4,11
25843,7,384,189,573,False,4,11
25844,8,237,158,395,False,4,11
25845,9,223,183,406,False,4,11
25846,10,214,184,398,False,4,11
25847,11,218,218,436,False,4,11
25848,12,238,236,474,False,4,11
25849,13,248,290,538,False,4,11
25850,14,251,387,638,False,4,11
25851,15,207,296,503,False,4,11
25852,16,196,211,407,False,4,11
25853,17,225,189,414,False,4,11
25854,18,116,149,265,False,4,11
25855,19,90,109,199,False,4,11
25856,20,76,103,179,False,4,11
25857,21,60,77,137,False,4,11
25858,22,61,77,138,False,4,11
25859,23,61,61,122,False,4,11
25860,0,31,58,89,False,5,11
25861,1,31,43,74,False,5,11
25862,2,23,38,61,False,5,11
25863,3,12,36,48,False,5,11
25864,4,11,16,27,False,5,11
25865,5,28,8,36,False,5,11
25866,6,22,26,48,False,5,11
25867,7,36,26,62,False,5,11
25868,8,68,56,124,False,5,11
25869,9,108,75,183,False,5,11
25870,10,149,111,260,False,5,11
25871,11,175,161,336,False,5,11
25872,12,187,186,373,False,5,11
25873,13,181,184,365,False,5,11
25874,14,181,223,404,False,5,11
25875,15,198,210,408,False,5,11
25876,16,137,181,318,False,5,11
25877,17,151,146,297,False,5,11
25878,18,99,166,265,False,5,11
25879,19,76,79,155,False,5,11
25880,20,73,95,168,False,5,11
25881,21,43,68,111,False,5,11
25882,22,48,83,131,False,5,11
25883,23,46,69,115,False,5,11
25884,0,33,49,82,True,6,11
25885,1,22,35,57,True,6,11
25886,2,16,48,64,True,6,11
25887,3,20,40,60,True,6,11
25888,4,15,20,35,True,6,11
25889,5,17,10,27,True,6,11
25890,6,19,14,33,True,6,11
25891,7,34,19,53,True,6,11
25892,8,50,28,78,True,6,11
25893,9,86,36,122,True,6,11
25894,10,141,94,235,True,6,11
25895,11,159,141,300,True,6,11
25896,12,149,158,307,True,6,11
25897,13,212,189,401,True,6,11
25898,14,141,212,353,True,6,11
25899,15,171,238,409,True,6,11
25900,16,125,149,274,True,6,11
25901,17,141,126,267,True,6,11
25902,18,130,137,267,True,6,11
25903,19,98,138,236,True,6,11
25904,20,68,95,163,True,6,11
25905,21,53,64,117,True,6,11
25906,22,29,38,67,True,6,11
25907,23,27,27,54,True,6,11
25908,0,7,17,24,False,0,11
25909,1,3,8,11,False,0,11
25910,2,2,15,17,False,0,11
25911,3,16,15,31,False,0,11
25912,4,16,9,25,False,0,11
25913,5,120,51,171,False,0,11
25914,6,222,146,368,False,0,11
25915,7,433,196,629,False,0,11
25916,8,276,159,435,False,0,11
25917,9,230,145,375,False,0,11
25918,10,205,200,405,False,0,11
25919,11,194,177,371,False,0,11
25920,12,202,217,419,False,0,11
25921,13,235,250,485,False,0,11
25922,14,253,295,548,False,0,11
25923,15,208,326,534,False,0,11
25924,16,240,229,469,False,0,11
25925,17,151,177,328,False,0,11
25926,18,124,146,270,False,0,11
25927,19,110,136,246,False,0,11
25928,20,85,93,178,False,0,11
25929,21,71,65,136,False,0,11
25930,22,44,67,111,False,0,11
25931,23,23,25,48,False,0,11
25932,0,11,12,23,False,1,11
25933,1,4,12,16,False,1,11
25934,2,17,20,37,False,1,11
25935,3,12,9,21,False,1,11
25936,4,15,9,24,False,1,11
25937,5,117,58,175,False,1,11
25938,6,230,135,365,False,1,11
25939,7,440,193,633,False,1,11
25940,8,258,169,427,False,1,11
25941,9,200,144,344,False,1,11
25942,10,204,180,384,False,1,11
25943,11,202,192,394,False,1,11
25944,12,229,181,410,False,1,11
25945,13,204,250,454,False,1,11
25946,14,251,323,574,False,1,11
25947,15,217,329,546,False,1,11
25948,16,159,189,348,False,1,11
25949,17,163,149,312,False,1,11
25950,18,111,160,271,False,1,11
25951,19,112,124,236,False,1,11
25952,20,65,90,155,False,1,11
25953,21,44,330,374,False,1,11
25954,22,40,225,265,False,1,11
25955,23,16,96,112,False,1,11
25956,0,14,46,60,False,2,11
25957,1,9,33,42,False,2,11
25958,2,9,48,57,False,2,11
25959,3,12,35,47,False,2,11
25960,4,15,22,37,False,2,11
25961,5,113,54,167,False,2,11
25962,6,204,128,332,False,2,11
25963,7,394,186,580,False,2,11
25964,8,253,156,409,False,2,11
25965,9,197,149,346,False,2,11
25966,10,208,185,393,False,2,11
25967,11,219,221,440,False,2,11
25968,12,244,202,446,False,2,11
25969,13,227,272,499,False,2,11
25970,14,246,324,570,False,2,11
25971,15,247,274,521,False,2,11
25972,16,156,200,356,False,2,11
25973,17,152,170,322,False,2,11
25974,18,126,124,250,False,2,11
25975,19,122,124,246,False,2,11
25976,20,77,112,189,False,2,11
25977,21,67,348,415,False,2,11
25978,22,33,264,297,False,2,11
25979,23,23,93,116,False,2,11
25980,0,8,62,70,False,3,11
25981,1,8,56,64,False,3,11
25982,2,11,40,51,False,3,11
25983,3,11,27,38,False,3,11
25984,4,20,43,63,False,3,11
25985,5,111,45,156,False,3,11
25986,6,216,123,339,False,3,11
25987,7,392,195,587,False,3,11
25988,8,278,169,447,False,3,11
25989,9,200,159,359,False,3,11
25990,10,206,174,380,False,3,11
25991,11,242,191,433,False,3,11
25992,12,209,213,422,False,3,11
25993,13,256,272,528,False,3,11
25994,14,285,292,577,False,3,11
25995,15,244,313,557,False,3,11
25996,16,215,261,476,False,3,11
25997,17,167,167,334,False,3,11
25998,18,130,153,283,False,3,11
25999,19,100,120,220,False,3,11
26000,20,88,136,224,False,3,11
26001,21,86,97,183,False,3,11
26002,22,59,80,139,False,3,11
26003,23,28,34,62,False,3,11
26004,0,26,42,68,False,4,11
26005,1,14,35,49,False,4,11
26006,2,24,39,63,False,4,11
26007,3,18,21,39,False,4,11
26008,4,19,13,32,False,4,11
26009,5,114,40,154,False,4,11
26010,6,228,134,362,False,4,11
26011,7,404,194,598,False,4,11
26012,8,257,153,410,False,4,11
26013,9,219,156,375,False,4,11
26014,10,250,199,449,False,4,11
26015,11,233,229,462,False,4,11
26016,12,228,229,457,False,4,11
26017,13,225,313,538,False,4,11
26018,14,292,334,626,False,4,11
26019,15,200,305,505,False,4,11
26020,16,184,205,389,False,4,11
26021,17,195,180,375,False,4,11
26022,18,153,153,306,False,4,11
26023,19,92,166,258,False,4,11
26024,20,72,82,154,False,4,11
26025,21,55,82,137,False,4,11
26026,22,57,73,130,False,4,11
26027,23,50,54,104,False,4,11
26028,0,31,37,68,False,5,11
26029,1,23,43,66,False,5,11
26030,2,12,45,57,False,5,11
26031,3,17,39,56,False,5,11
26032,4,14,17,31,False,5,11
26033,5,25,13,38,False,5,11
26034,6,33,26,59,False,5,11
26035,7,44,44,88,False,5,11
26036,8,60,48,108,False,5,11
26037,9,108,83,191,False,5,11
26038,10,147,105,252,False,5,11
26039,11,145,150,295,False,5,11
26040,12,219,207,426,False,5,11
26041,13,187,195,382,False,5,11
26042,14,162,219,381,False,5,11
26043,15,180,228,408,False,5,11
26044,16,166,176,342,False,5,11
26045,17,151,193,344,False,5,11
26046,18,129,184,313,False,5,11
26047,19,95,116,211,False,5,11
26048,20,55,68,123,False,5,11
26049,21,50,78,128,False,5,11
26050,22,54,68,122,False,5,11
26051,23,44,65,109,False,5,11
26052,0,28,41,69,True,6,11
26053,1,31,53,84,True,6,11
26054,2,20,55,75,True,6,11
26055,3,15,38,53,True,6,11
26056,4,15,19,34,True,6,11
26057,5,13,13,26,True,6,11
26058,6,16,20,36,True,6,11
26059,7,30,14,44,True,6,11
26060,8,33,25,58,True,6,11
26061,9,93,44,137,True,6,11
26062,10,131,85,216,True,6,11
26063,11,152,154,306,True,6,11
26064,12,188,202,390,True,6,11
26065,13,193,181,374,True,6,11
26066,14,168,173,341,True,6,11
26067,15,184,246,430,True,6,11
26068,16,169,156,325,True,6,11
26069,17,140,141,281,True,6,11
26070,18,160,213,373,True,6,11
26071,19,86,142,228,True,6,11
26072,20,88,98,186,True,6,11
26073,21,56,65,121,True,6,11
26074,22,29,47,76,True,6,11
26075,23,25,24,49,True,6,11
26076,0,7,19,26,False,0,11
26077,1,7,11,18,False,0,11
26078,2,10,9,19,False,0,11
26079,3,12,10,22,False,0,11
26080,4,17,13,30,False,0,11
26081,5,117,56,173,False,0,11
26082,6,232,115,347,False,0,11
26083,7,361,171,532,False,0,11
26084,8,222,171,393,False,0,11
26085,9,229,150,379,False,0,11
26086,10,220,186,406,False,0,11
26087,11,234,193,427,False,0,11
26088,12,204,219,423,False,0,11
26089,13,242,225,467,False,0,11
26090,14,240,305,545,False,0,11
26091,15,212,311,523,False,0,11
26092,16,192,186,378,False,0,11
26093,17,170,165,335,False,0,11
26094,18,135,152,287,False,0,11
26095,19,105,129,234,False,0,11
26096,20,83,107,190,False,0,11
26097,21,53,65,118,False,0,11
26098,22,27,34,61,False,0,11
26099,23,25,22,47,False,0,11
26100,0,14,15,29,False,1,11
26101,1,10,22,32,False,1,11
26102,2,10,12,22,False,1,11
26103,3,3,10,13,False,1,11
26104,4,19,15,34,False,1,11
26105,5,120,53,173,False,1,11
26106,6,246,115,361,False,1,11
26107,7,382,188,570,False,1,11
26108,8,243,175,418,False,1,11
26109,9,221,178,399,False,1,11
26110,10,229,199,428,False,1,11
26111,11,241,202,443,False,1,11
26112,12,266,227,493,False,1,11
26113,13,198,260,458,False,1,11
26114,14,249,331,580,False,1,11
26115,15,230,304,534,False,1,11
26116,16,209,182,391,False,1,11
26117,17,176,137,313,False,1,11
26118,18,167,159,326,False,1,11
26119,19,113,166,279,False,1,11
26120,20,79,138,217,False,1,11
26121,21,46,282,328,False,1,11
26122,22,37,203,240,False,1,11
26123,23,16,80,96,False,1,11
26124,0,9,36,45,False,2,11
26125,1,14,40,54,False,2,11
26126,2,7,41,48,False,2,11
26127,3,13,27,40,False,2,11
26128,4,26,20,46,False,2,11
26129,5,106,48,154,False,2,11
26130,6,215,120,335,False,2,11
26131,7,363,193,556,False,2,11
26132,8,239,156,395,False,2,11
26133,9,242,193,435,False,2,11
26134,10,248,186,434,False,2,11
26135,11,239,228,467,False,2,11
26136,12,250,242,492,False,2,11
26137,13,246,274,520,False,2,11
26138,14,258,303,561,False,2,11
26139,15,246,303,549,False,2,11
26140,16,212,175,387,False,2,11
26141,17,228,152,380,False,2,11
26142,18,297,159,456,False,2,11
26143,19,83,158,241,False,2,11
26144,20,90,112,202,False,2,11
26145,21,74,75,149,False,2,11
26146,22,43,59,102,False,2,11
26147,23,38,32,70,False,2,11
26148,0,19,31,50,False,3,11
26149,1,13,24,37,False,3,11
26150,2,18,20,38,False,3,11
26151,3,11,12,23,False,3,11
26152,4,20,11,31,False,3,11
26153,5,97,43,140,False,3,11
26154,6,188,120,308,False,3,11
26155,7,372,171,543,False,3,11
26156,8,263,129,392,False,3,11
26157,9,235,173,408,False,3,11
26158,10,247,220,467,False,3,11
26159,11,294,254,548,False,3,11
26160,12,243,245,488,False,3,11
26161,13,266,293,559,False,3,11
26162,14,278,337,615,False,3,11
26163,15,239,327,566,False,3,11
26164,16,183,184,367,False,3,11
26165,17,181,196,377,False,3,11
26166,18,135,158,293,False,3,11
26167,19,107,170,277,False,3,11
26168,20,79,98,177,False,3,11
26169,21,68,128,196,False,3,11
26170,22,39,40,79,False,3,11
26171,23,19,36,55,False,3,11
26172,0,15,37,52,False,4,11
26173,1,14,27,41,False,4,11
26174,2,13,31,44,False,4,11
26175,3,12,16,28,False,4,11
26176,4,16,10,26,False,4,11
26177,5,102,43,145,False,4,11
26178,6,169,95,264,False,4,11
26179,7,315,145,460,False,4,11
26180,8,256,161,417,False,4,11
26181,9,213,199,412,False,4,11
26182,10,250,186,436,False,4,11
26183,11,244,274,518,False,4,11
26184,12,270,259,529,False,4,11
26185,13,260,288,548,False,4,11
26186,14,233,317,550,False,4,11
26187,15,234,272,506,False,4,11
26188,16,179,174,353,False,4,11
26189,17,157,150,307,False,4,11
26190,18,114,124,238,False,4,11
26191,19,96,124,220,False,4,11
26192,20,64,85,149,False,4,11
26193,21,53,89,142,False,4,11
26194,22,49,80,129,False,4,11
26195,23,32,55,87,False,4,11
26196,0,26,40,66,False,5,11
26197,1,24,35,59,False,5,11
26198,2,10,28,38,False,5,11
26199,3,11,32,43,False,5,11
26200,4,10,10,20,False,5,11
26201,5,19,20,39,False,5,11
26202,6,23,15,38,False,5,11
26203,7,31,32,63,False,5,11
26204,8,56,45,101,False,5,11
26205,9,104,82,186,False,5,11
26206,10,155,107,262,False,5,11
26207,11,179,146,325,False,5,11
26208,12,154,175,329,False,5,11
26209,13,171,178,349,False,5,11
26210,14,164,183,347,False,5,11
26211,15,157,164,321,False,5,11
26212,16,139,150,289,False,5,11
26213,17,128,142,270,False,5,11
26214,18,117,116,233,False,5,11
26215,19,104,116,220,False,5,11
26216,20,50,58,108,False,5,11
26217,21,50,54,104,False,5,11
26218,22,37,56,93,False,5,11
26219,23,38,42,80,False,5,11
26220,0,28,36,64,True,6,11
26221,1,16,30,46,True,6,11
26222,2,22,41,63,True,6,11
26223,3,14,35,49,True,6,11
26224,4,11,15,26,True,6,11
26225,5,19,11,30,True,6,11
26226,6,15,15,30,True,6,11
26227,7,29,14,43,True,6,11
26228,8,33,29,62,True,6,11
26229,9,50,46,96,True,6,11
26230,10,82,87,169,True,6,11
26231,11,130,124,254,True,6,11
26232,12,185,140,325,True,6,11
26233,13,208,177,385,True,6,11
26234,14,159,160,319,True,6,11
26235,15,151,139,290,True,6,11
26236,16,149,139,288,True,6,11
26237,17,120,118,238,True,6,11
26238,18,85,107,192,True,6,11
26239,19,80,111,191,True,6,11
26240,20,56,72,128,True,6,11
26241,21,44,39,83,True,6,11
26242,22,33,39,72,True,6,11
26243,23,18,32,50,True,6,11
26244,0,15,19,34,True,0,11
26245,1,6,18,24,True,0,11
26246,2,7,12,19,True,0,11
26247,3,13,8,21,True,0,11
26248,4,11,3,14,True,0,11
26249,5,28,14,42,True,0,11
26250,6,37,38,75,True,0,11
26251,7,38,41,79,True,0,11
26252,8,41,40,81,True,0,11
26253,9,75,84,159,True,0,11
26254,10,121,106,227,True,0,11
26255,11,140,160,300,True,0,11
26256,12,133,133,266,True,0,11
26257,13,146,125,271,True,0,11
26258,14,130,125,255,True,0,11
26259,15,110,144,254,True,0,11
26260,16,92,84,176,True,0,11
26261,17,42,52,94,True,0,11
26262,18,34,31,65,True,0,11
26263,19,52,44,96,True,0,11
26264,20,39,55,94,True,0,11
26265,21,85,71,156,True,0,11
26266,22,84,58,142,True,0,11
26267,23,41,47,88,True,0,11
26268,0,33,32,65,True,1,11
26269,1,10,11,21,True,1,11
26270,2,8,14,22,True,1,11
26271,3,6,5,11,True,1,11
26272,4,4,6,10,True,1,11
26273,5,12,8,20,True,1,11
26274,6,11,10,21,True,1,11
26275,7,14,11,25,True,1,11
26276,8,18,4,22,True,1,11
26277,9,30,16,46,True,1,11
26278,10,26,21,47,True,1,11
26279,11,55,64,119,True,1,11
26280,12,80,81,161,True,1,11
26281,13,97,93,190,True,1,11
26282,14,86,88,174,True,1,11
26283,15,91,103,194,True,1,11
26284,16,81,94,175,True,1,11
26285,17,62,72,134,True,1,11
26286,18,70,62,132,True,1,11
26287,19,72,77,149,True,1,11
26288,20,53,73,126,True,1,11
26289,21,54,55,109,True,1,11
26290,22,35,46,81,True,1,11
26291,23,22,38,60,True,1,11
26292,0,15,18,33,True,2,11
26293,1,10,11,21,True,2,11
26294,2,9,11,20,True,2,11
26295,3,7,12,19,True,2,11
26296,4,2,4,6,True,2,11
26297,5,14,10,24,True,2,11
26298,6,18,7,25,True,2,11
26299,7,20,10,30,True,2,11
26300,8,24,19,43,True,2,11
26301,9,42,35,77,True,2,11
26302,10,65,53,118,True,2,11
26303,11,89,148,237,True,2,11
26304,12,93,97,190,True,2,11
26305,13,113,134,247,True,2,11
26306,14,124,121,245,True,2,11
26307,15,87,106,193,True,2,11
26308,16,79,81,160,True,2,11
26309,17,85,109,194,True,2,11
26310,18,114,110,224,True,2,11
26311,19,86,91,177,True,2,11
26312,20,77,95,172,True,2,11
26313,21,46,64,110,True,2,11
26314,22,31,45,76,True,2,11
26315,23,33,45,78,True,2,11
26316,0,24,35,59,True,3,11
26317,1,23,36,59,True,3,11
26318,2,14,26,40,True,3,11
26319,3,13,32,45,True,3,11
26320,4,22,23,45,True,3,11
26321,5,43,21,64,True,3,11
26322,6,75,52,127,True,3,11
26323,7,82,64,146,True,3,11
26324,8,96,59,155,True,3,11
26325,9,94,90,184,True,3,11
26326,10,147,106,253,True,3,11
26327,11,151,146,297,True,3,11
26328,12,164,136,300,True,3,11
26329,13,164,191,355,True,3,11
26330,14,137,175,312,True,3,11
26331,15,125,161,286,True,3,11
26332,16,127,109,236,True,3,11
26333,17,115,95,210,True,3,11
26334,18,101,101,202,True,3,11
26335,19,89,76,165,True,3,11
26336,20,55,71,126,True,3,11
26337,21,49,104,153,True,3,11
26338,22,31,97,128,True,3,11
26339,23,27,36,63,True,3,11
26340,0,15,30,45,True,4,11
26341,1,7,13,20,True,4,11
26342,2,13,19,32,True,4,11
26343,3,7,9,16,True,4,11
26344,4,9,5,14,True,4,11
26345,5,39,12,51,True,4,11
26346,6,67,42,109,True,4,11
26347,7,75,53,128,True,4,11
26348,8,105,53,158,True,4,11
26349,9,112,85,197,True,4,11
26350,10,133,109,242,True,4,11
26351,11,160,136,296,True,4,11
26352,12,164,163,327,True,4,11
26353,13,181,171,352,True,4,11
26354,14,150,154,304,True,4,11
26355,15,112,153,265,True,4,11
26356,16,124,130,254,True,4,11
26357,17,106,117,223,True,4,11
26358,18,97,112,209,True,4,11
26359,19,86,69,155,True,4,11
26360,20,56,67,123,True,4,11
26361,21,42,46,88,True,4,11
26362,22,28,54,82,True,4,11
26363,23,32,38,70,True,4,11
26364,0,24,32,56,True,5,11
26365,1,7,23,30,True,5,11
26366,2,10,29,39,True,5,11
26367,3,8,23,31,True,5,11
26368,4,6,9,15,True,5,11
26369,5,19,12,31,True,5,11
26370,6,14,28,42,True,5,11
26371,7,16,18,34,True,5,11
26372,8,30,20,50,True,5,11
26373,9,61,45,106,True,5,11
26374,10,70,60,130,True,5,11
26375,11,105,106,211,True,5,11
26376,12,102,112,214,True,5,11
26377,13,124,124,248,True,5,11
26378,14,118,145,263,True,5,11
26379,15,109,112,221,True,5,11
26380,16,101,98,199,True,5,11
26381,17,109,112,221,True,5,11
26382,18,80,79,159,True,5,11
26383,19,72,88,160,True,5,11
26384,20,62,57,119,True,5,11
26385,21,36,49,85,True,5,11
26386,22,51,61,112,True,5,11
26387,23,44,53,97,True,5,11
26388,0,21,27,48,True,6,11
26389,1,27,21,48,True,6,11
26390,2,25,40,65,True,6,11
26391,3,13,29,42,True,6,11
26392,4,9,9,18,True,6,11
26393,5,18,7,25,True,6,11
26394,6,12,15,27,True,6,11
26395,7,18,5,23,True,6,11
26396,8,23,17,40,True,6,11
26397,9,46,37,83,True,6,11
26398,10,68,55,123,True,6,11
26399,11,103,79,182,True,6,11
26400,12,109,110,219,True,6,11
26401,13,146,140,286,True,6,11
26402,14,111,153,264,True,6,11
26403,15,106,146,252,True,6,11
26404,16,114,116,230,True,6,11
26405,17,98,106,204,True,6,11
26406,18,97,108,205,True,6,11
26407,19,88,103,191,True,6,11
26408,20,60,72,132,True,6,11
26409,21,41,48,89,True,6,11
26410,22,33,40,73,True,6,11
26411,23,29,41,70,True,6,11
26412,0,12,24,36,False,0,11
26413,1,11,11,22,False,0,11
26414,2,6,13,19,False,0,11
26415,3,7,8,15,False,0,11
26416,4,8,6,14,False,0,11
26417,5,31,12,43,False,0,11
26418,6,46,35,81,False,0,11
26419,7,40,41,81,False,0,11
26420,8,54,51,105,False,0,11
26421,9,60,66,126,False,0,11
26422,10,93,108,201,False,0,11
26423,11,151,122,273,False,0,11
26424,12,118,131,249,False,0,11
26425,13,117,127,244,False,0,11
26426,14,93,102,195,False,0,11
26427,15,115,109,224,False,0,11
26428,16,111,102,213,False,0,11
26429,17,99,101,200,False,0,11
26430,18,81,79,160,False,0,11
26431,19,63,68,131,False,0,11
26432,20,83,77,160,False,0,11
26433,21,62,64,126,False,0,11
26434,22,51,52,103,False,0,11
26435,23,54,71,125,False,0,11
26436,0,62,73,135,True,1,0
26437,1,58,70,128,True,1,0
26438,2,60,74,134,True,1,0
26439,3,36,54,90,True,1,0
26440,4,29,32,61,True,1,0
26441,5,22,27,49,True,1,0
26442,6,15,14,29,True,1,0
26443,7,11,12,23,True,1,0
26444,8,20,9,29,True,1,0
26445,9,25,20,45,True,1,0
26446,10,38,33,71,True,1,0
26447,11,48,56,104,True,1,0
26448,12,75,78,153,True,1,0
26449,13,99,96,195,True,1,0
26450,14,126,124,250,True,1,0
26451,15,113,136,249,True,1,0
26452,16,108,112,220,True,1,0
26453,17,121,103,224,True,1,0
26454,18,99,89,188,True,1,0
26455,19,87,99,186,True,1,0
26456,20,62,71,133,True,1,0
26457,21,53,70,123,True,1,0
26458,22,25,36,61,True,1,0
26459,23,23,19,42,True,1,0
26460,0,8,10,18,False,2,0
26461,1,3,9,12,False,2,0
26462,2,9,8,17,False,2,0
26463,3,7,6,13,False,2,0
26464,4,15,9,24,False,2,0
26465,5,86,49,135,False,2,0
26466,6,193,115,308,False,2,0
26467,7,268,130,398,False,2,0
26468,8,196,118,314,False,2,0
26469,9,154,120,274,False,2,0
26470,10,194,146,340,False,2,0
26471,11,181,160,341,False,2,0
26472,12,200,200,400,False,2,0
26473,13,193,203,396,False,2,0
26474,14,189,251,440,False,2,0
26475,15,169,271,440,False,2,0
26476,16,133,148,281,False,2,0
26477,17,143,112,255,False,2,0
26478,18,91,92,183,False,2,0
26479,19,81,105,186,False,2,0
26480,20,59,65,124,False,2,0
26481,21,35,58,93,False,2,0
26482,22,32,180,212,False,2,0
26483,23,22,34,56,False,2,0
26484,0,7,16,23,False,3,0
26485,1,7,13,20,False,3,0
26486,2,6,11,17,False,3,0
26487,3,8,11,19,False,3,0
26488,4,16,8,24,False,3,0
26489,5,93,44,137,False,3,0
26490,6,190,115,305,False,3,0
26491,7,349,170,519,False,3,0
26492,8,186,142,328,False,3,0
26493,9,183,135,318,False,3,0
26494,10,185,146,331,False,3,0
26495,11,190,179,369,False,3,0
26496,12,170,184,354,False,3,0
26497,13,172,206,378,False,3,0
26498,14,213,285,498,False,3,0
26499,15,195,261,456,False,3,0
26500,16,138,147,285,False,3,0
26501,17,125,133,258,False,3,0
26502,18,114,122,236,False,3,0
26503,19,91,96,187,False,3,0
26504,20,64,83,147,False,3,0
26505,21,39,55,94,False,3,0
26506,22,35,46,81,False,3,0
26507,23,12,25,37,False,3,0
26508,0,11,15,26,False,4,0
26509,1,9,18,27,False,4,0
26510,2,7,12,19,False,4,0
26511,3,6,10,16,False,4,0
26512,4,18,4,22,False,4,0
26513,5,97,45,142,False,4,0
26514,6,190,110,300,False,4,0
26515,7,365,157,522,False,4,0
26516,8,212,128,340,False,4,0
26517,9,186,119,305,False,4,0
26518,10,210,169,379,False,4,0
26519,11,194,184,378,False,4,0
26520,12,193,198,391,False,4,0
26521,13,202,229,431,False,4,0
26522,14,249,328,577,False,4,0
26523,15,175,274,449,False,4,0
26524,16,163,160,323,False,4,0
26525,17,131,141,272,False,4,0
26526,18,107,112,219,False,4,0
26527,19,76,97,173,False,4,0
26528,20,68,80,148,False,4,0
26529,21,37,47,84,False,4,0
26530,22,41,61,102,False,4,0
26531,23,35,38,73,False,4,0
26532,0,16,27,43,False,5,0
26533,1,10,28,38,False,5,0
26534,2,10,36,46,False,5,0
26535,3,12,17,29,False,5,0
26536,4,6,7,13,False,5,0
26537,5,17,10,27,False,5,0
26538,6,20,24,44,False,5,0
26539,7,26,13,39,False,5,0
26540,8,44,34,78,False,5,0
26541,9,86,46,132,False,5,0
26542,10,112,72,184,False,5,0
26543,11,142,107,249,False,5,0
26544,12,136,172,308,False,5,0
26545,13,167,139,306,False,5,0
26546,14,158,166,324,False,5,0
26547,15,153,159,312,False,5,0
26548,16,120,128,248,False,5,0
26549,17,149,164,313,False,5,0
26550,18,99,113,212,False,5,0
26551,19,82,79,161,False,5,0
26552,20,49,58,107,False,5,0
26553,21,46,52,98,False,5,0
26554,22,34,56,90,False,5,0
26555,23,37,51,88,False,5,0
26556,0,30,35,65,True,6,0
26557,1,17,39,56,True,6,0
26558,2,22,50,72,True,6,0
26559,3,14,30,44,True,6,0
26560,4,8,16,24,True,6,0
26561,5,20,7,27,True,6,0
26562,6,7,14,21,True,6,0
26563,7,21,10,31,True,6,0
26564,8,35,28,63,True,6,0
26565,9,79,43,122,True,6,0
26566,10,93,64,157,True,6,0
26567,11,102,125,227,True,6,0
26568,12,139,129,268,True,6,0
26569,13,167,149,316,True,6,0
26570,14,140,157,297,True,6,0
26571,15,135,202,337,True,6,0
26572,16,138,143,281,True,6,0
26573,17,124,118,242,True,6,0
26574,18,125,137,262,True,6,0
26575,19,78,130,208,True,6,0
26576,20,64,95,159,True,6,0
26577,21,50,60,110,True,6,0
26578,22,38,34,72,True,6,0
26579,23,20,23,43,True,6,0
26580,0,10,13,23,False,0,0
26581,1,1,13,14,False,0,0
26582,2,16,19,35,False,0,0
26583,3,8,10,18,False,0,0
26584,4,25,7,32,False,0,0
26585,5,115,55,170,False,0,0
26586,6,210,132,342,False,0,0
26587,7,397,175,572,False,0,0
26588,8,235,139,374,False,0,0
26589,9,201,123,324,False,0,0
26590,10,201,187,388,False,0,0
26591,11,205,204,409,False,0,0
26592,12,200,205,405,False,0,0
26593,13,178,232,410,False,0,0
26594,14,215,309,524,False,0,0
26595,15,238,320,558,False,0,0
26596,16,176,169,345,False,0,0
26597,17,131,159,290,False,0,0
26598,18,118,145,263,False,0,0
26599,19,89,101,190,False,0,0
26600,20,63,94,157,False,0,0
26601,21,54,59,113,False,0,0
26602,22,32,40,72,False,0,0
26603,23,20,19,39,False,0,0
26604,0,14,11,25,False,1,0
26605,1,5,5,10,False,1,0
26606,2,7,8,15,False,1,0
26607,3,9,8,17,False,1,0
26608,4,17,10,27,False,1,0
26609,5,121,48,169,False,1,0
26610,6,213,130,343,False,1,0
26611,7,368,184,552,False,1,0
26612,8,222,136,358,False,1,0
26613,9,226,158,384,False,1,0
26614,10,198,164,362,False,1,0
26615,11,193,158,351,False,1,0
26616,12,220,212,432,False,1,0
26617,13,210,252,462,False,1,0
26618,14,238,260,498,False,1,0
26619,15,196,324,520,False,1,0
26620,16,175,169,344,False,1,0
26621,17,177,134,311,False,1,0
26622,18,126,144,270,False,1,0
26623,19,106,108,214,False,1,0
26624,20,64,105,169,False,1,0
26625,21,48,78,126,False,1,0
26626,22,28,30,58,False,1,0
26627,23,11,15,26,False,1,0
26628,0,7,7,14,False,2,0
26629,1,4,12,16,False,2,0
26630,2,6,10,16,False,2,0
26631,3,9,12,21,False,2,0
26632,4,13,8,21,False,2,0
26633,5,107,53,160,False,2,0
26634,6,221,137,358,False,2,0
26635,7,373,182,555,False,2,0
26636,8,253,115,368,False,2,0
26637,9,179,162,341,False,2,0
26638,10,217,159,376,False,2,0
26639,11,212,210,422,False,2,0
26640,12,189,209,398,False,2,0
26641,13,202,235,437,False,2,0
26642,14,199,291,490,False,2,0
26643,15,193,299,492,False,2,0
26644,16,167,191,358,False,2,0
26645,17,165,152,317,False,2,0
26646,18,93,125,218,False,2,0
26647,19,91,108,199,False,2,0
26648,20,81,85,166,False,2,0
26649,21,48,79,127,False,2,0
26650,22,28,40,68,False,2,0
26651,23,16,26,42,False,2,0
26652,0,10,13,23,False,3,0
26653,1,12,22,34,False,3,0
26654,2,6,12,18,False,3,0
26655,3,10,6,16,False,3,0
26656,4,14,8,22,False,3,0
26657,5,117,49,166,False,3,0
26658,6,209,131,340,False,3,0
26659,7,395,183,578,False,3,0
26660,8,273,135,408,False,3,0
26661,9,212,149,361,False,3,0
26662,10,183,162,345,False,3,0
26663,11,188,209,397,False,3,0
26664,12,207,175,382,False,3,0
26665,13,193,258,451,False,3,0
26666,14,218,295,513,False,3,0
26667,15,215,301,516,False,3,0
26668,16,156,195,351,False,3,0
26669,17,163,139,302,False,3,0
26670,18,118,143,261,False,3,0
26671,19,103,103,206,False,3,0
26672,20,73,85,158,False,3,0
26673,21,54,87,141,False,3,0
26674,22,28,44,72,False,3,0
26675,23,20,37,57,False,3,0
26676,0,15,23,38,False,4,0
26677,1,7,21,28,False,4,0
26678,2,4,23,27,False,4,0
26679,3,7,12,19,False,4,0
26680,4,17,15,32,False,4,0
26681,5,109,40,149,False,4,0
26682,6,217,127,344,False,4,0
26683,7,362,188,550,False,4,0
26684,8,270,129,399,False,4,0
26685,9,220,158,378,False,4,0
26686,10,204,174,378,False,4,0
26687,11,193,210,403,False,4,0
26688,12,187,206,393,False,4,0
26689,13,221,255,476,False,4,0
26690,14,271,320,591,False,4,0
26691,15,188,289,477,False,4,0
26692,16,128,182,310,False,4,0
26693,17,112,136,248,False,4,0
26694,18,118,116,234,False,4,0
26695,19,76,84,160,False,4,0
26696,20,61,77,138,False,4,0
26697,21,53,66,119,False,4,0
26698,22,40,71,111,False,4,0
26699,23,45,55,100,False,4,0
26700,0,31,30,61,False,5,0
26701,1,18,22,40,False,5,0
26702,2,16,30,46,False,5,0
26703,3,13,30,43,False,5,0
26704,4,8,9,17,False,5,0
26705,5,25,11,36,False,5,0
26706,6,35,26,61,False,5,0
26707,7,35,29,64,False,5,0
26708,8,58,42,100,False,5,0
26709,9,103,51,154,False,5,0
26710,10,132,82,214,False,5,0
26711,11,137,125,262,False,5,0
26712,12,152,154,306,False,5,0
26713,13,181,174,355,False,5,0
26714,14,123,188,311,False,5,0
26715,15,138,151,289,False,5,0
26716,16,130,144,274,False,5,0
26717,17,114,137,251,False,5,0
26718,18,119,121,240,False,5,0
26719,19,67,83,150,False,5,0
26720,20,45,57,102,False,5,0
26721,21,43,59,102,False,5,0
26722,22,43,60,103,False,5,0
26723,23,30,58,88,False,5,0
26724,0,30,46,76,True,6,0
26725,1,26,62,88,True,6,0
26726,2,18,53,71,True,6,0
26727,3,8,39,47,True,6,0
26728,4,12,25,37,True,6,0
26729,5,19,9,28,True,6,0
26730,6,20,25,45,True,6,0
26731,7,28,19,47,True,6,0
26732,8,43,22,65,True,6,0
26733,9,92,50,142,True,6,0
26734,10,87,59,146,True,6,0
26735,11,154,150,304,True,6,0
26736,12,124,158,282,True,6,0
26737,13,211,221,432,True,6,0
26738,14,147,198,345,True,6,0
26739,15,152,192,344,True,6,0
26740,16,161,148,309,True,6,0
26741,17,139,124,263,True,6,0
26742,18,131,141,272,True,6,0
26743,19,97,124,221,True,6,0
26744,20,75,118,193,True,6,0
26745,21,48,75,123,True,6,0
26746,22,31,49,80,True,6,0
26747,23,21,24,45,True,6,0
26748,0,9,12,21,False,0,0
26749,1,5,10,15,False,0,0
26750,2,10,17,27,False,0,0
26751,3,7,5,12,False,0,0
26752,4,17,11,28,False,0,0
26753,5,109,53,162,False,0,0
26754,6,212,118,330,False,0,0
26755,7,358,177,535,False,0,0
26756,8,259,185,444,False,0,0
26757,9,224,161,385,False,0,0
26758,10,202,174,376,False,0,0
26759,11,178,177,355,False,0,0
26760,12,189,170,359,False,0,0
26761,13,192,224,416,False,0,0
26762,14,226,332,558,False,0,0
26763,15,210,327,537,False,0,0
26764,16,162,193,355,False,0,0
26765,17,163,134,297,False,0,0
26766,18,98,117,215,False,0,0
26767,19,98,116,214,False,0,0
26768,20,67,100,167,False,0,0
26769,21,43,70,113,False,0,0
26770,22,24,22,46,False,0,0
26771,23,23,15,38,False,0,0
26772,0,11,13,24,False,1,0
26773,1,10,13,23,False,1,0
26774,2,12,26,38,False,1,0
26775,3,10,20,30,False,1,0
26776,4,15,12,27,False,1,0
26777,5,116,47,163,False,1,0
26778,6,217,132,349,False,1,0
26779,7,337,176,513,False,1,0
26780,8,257,121,378,False,1,0
26781,9,185,163,348,False,1,0
26782,10,204,177,381,False,1,0
26783,11,205,161,366,False,1,0
26784,12,188,203,391,False,1,0
26785,13,229,257,486,False,1,0
26786,14,207,313,520,False,1,0
26787,15,198,268,466,False,1,0
26788,16,185,156,341,False,1,0
26789,17,192,138,330,False,1,0
26790,18,154,145,299,False,1,0
26791,19,96,133,229,False,1,0
26792,20,80,106,186,False,1,0
26793,21,54,86,140,False,1,0
26794,22,21,36,57,False,1,0
26795,23,18,21,39,False,1,0
26796,0,8,18,26,False,2,0
26797,1,1,9,10,False,2,0
26798,2,9,10,19,False,2,0
26799,3,7,4,11,False,2,0
26800,4,13,8,21,False,2,0
26801,5,114,50,164,False,2,0
26802,6,229,122,351,False,2,0
26803,7,387,183,570,False,2,0
26804,8,253,141,394,False,2,0
26805,9,197,154,351,False,2,0
26806,10,216,159,375,False,2,0
26807,11,216,204,420,False,2,0
26808,12,210,188,398,False,2,0
26809,13,212,261,473,False,2,0
26810,14,248,297,545,False,2,0
26811,15,228,297,525,False,2,0
26812,16,177,186,363,False,2,0
26813,17,178,152,330,False,2,0
26814,18,128,127,255,False,2,0
26815,19,107,117,224,False,2,0
26816,20,81,108,189,False,2,0
26817,21,55,67,122,False,2,0
26818,22,34,40,74,False,2,0
26819,23,15,31,46,False,2,0
26820,0,8,11,19,False,3,0
26821,1,10,17,27,False,3,0
26822,2,6,7,13,False,3,0
26823,3,6,9,15,False,3,0
26824,4,16,9,25,False,3,0
26825,5,112,41,153,False,3,0
26826,6,214,129,343,False,3,0
26827,7,375,181,556,False,3,0
26828,8,242,169,411,False,3,0
26829,9,231,151,382,False,3,0
26830,10,194,146,340,False,3,0
26831,11,188,187,375,False,3,0
26832,12,199,195,394,False,3,0
26833,13,194,233,427,False,3,0
26834,14,227,292,519,False,3,0
26835,15,222,306,528,False,3,0
26836,16,180,208,388,False,3,0
26837,17,169,178,347,False,3,0
26838,18,120,141,261,False,3,0
26839,19,106,110,216,False,3,0
26840,20,76,96,172,False,3,0
26841,21,82,69,151,False,3,0
26842,22,40,43,83,False,3,0
26843,23,20,22,42,False,3,0
26844,0,13,19,32,False,4,0
26845,1,21,24,45,False,4,0
26846,2,21,26,47,False,4,0
26847,3,14,12,26,False,4,0
26848,4,21,5,26,False,4,0
26849,5,98,49,147,False,4,0
26850,6,214,112,326,False,4,0
26851,7,369,193,562,False,4,0
26852,8,277,136,413,False,4,0
26853,9,211,139,350,False,4,0
26854,10,221,166,387,False,4,0
26855,11,184,207,391,False,4,0
26856,12,215,207,422,False,4,0
26857,13,240,249,489,False,4,0
26858,14,249,326,575,False,4,0
26859,15,161,299,460,False,4,0
26860,16,141,152,293,False,4,0
26861,17,133,130,263,False,4,0
26862,18,116,111,227,False,4,0
26863,19,78,95,173,False,4,0
26864,20,66,65,131,False,4,0
26865,21,42,53,95,False,4,0
26866,22,41,56,97,False,4,0
26867,23,35,50,85,False,4,0
26868,0,24,39,63,False,5,0
26869,1,22,33,55,False,5,0
26870,2,19,48,67,False,5,0
26871,3,12,24,36,False,5,0
26872,4,10,8,18,False,5,0
26873,5,30,11,41,False,5,0
26874,6,23,25,48,False,5,0
26875,7,33,30,63,False,5,0
26876,8,44,40,84,False,5,0
26877,9,118,76,194,False,5,0
26878,10,123,76,199,False,5,0
26879,11,111,135,246,False,5,0
26880,12,150,138,288,False,5,0
26881,13,148,169,317,False,5,0
26882,14,164,194,358,False,5,0
26883,15,142,166,308,False,5,0
26884,16,126,139,265,False,5,0
26885,17,144,135,279,False,5,0
26886,18,115,117,232,False,5,0
26887,19,62,82,144,False,5,0
26888,20,44,68,112,False,5,0
26889,21,44,59,103,False,5,0
26890,22,49,79,128,False,5,0
26891,23,37,65,102,False,5,0
26892,0,37,61,98,True,6,0
26893,1,19,68,87,True,6,0
26894,2,28,53,81,True,6,0
26895,3,16,43,59,True,6,0
26896,4,12,15,27,True,6,0
26897,5,19,13,32,True,6,0
26898,6,17,18,35,True,6,0
26899,7,26,21,47,True,6,0
26900,8,36,25,61,True,6,0
26901,9,86,46,132,True,6,0
26902,10,78,67,145,True,6,0
26903,11,117,122,239,True,6,0
26904,12,120,122,242,True,6,0
26905,13,176,175,351,True,6,0
26906,14,140,167,307,True,6,0
26907,15,138,205,343,True,6,0
26908,16,138,155,293,True,6,0
26909,17,131,127,258,True,6,0
26910,18,107,136,243,True,6,0
26911,19,108,127,235,True,6,0
26912,20,63,95,158,True,6,0
26913,21,60,79,139,True,6,0
26914,22,35,30,65,True,6,0
26915,23,17,24,41,True,6,0
26916,0,8,22,30,False,0,0
26917,1,10,7,17,False,0,0
26918,2,4,11,15,False,0,0
26919,3,14,7,21,False,0,0
26920,4,16,14,30,False,0,0
26921,5,119,54,173,False,0,0
26922,6,237,147,384,False,0,0
26923,7,414,218,632,False,0,0
26924,8,313,179,492,False,0,0
26925,9,192,144,336,False,0,0
26926,10,225,180,405,False,0,0
26927,11,180,201,381,False,0,0
26928,12,195,213,408,False,0,0
26929,13,207,264,471,False,0,0
26930,14,239,326,565,False,0,0
26931,15,204,321,525,False,0,0
26932,16,190,195,385,False,0,0
26933,17,167,145,312,False,0,0
26934,18,115,155,270,False,0,0
26935,19,125,130,255,False,0,0
26936,20,59,102,161,False,0,0
26937,21,70,64,134,False,0,0
26938,22,32,54,86,False,0,0
26939,23,22,21,43,False,0,0
26940,0,13,13,26,False,1,0
26941,1,7,5,12,False,1,0
26942,2,4,5,9,False,1,0
26943,3,12,10,22,False,1,0
26944,4,17,13,30,False,1,0
26945,5,120,50,170,False,1,0
26946,6,239,129,368,False,1,0
26947,7,404,194,598,False,1,0
26948,8,254,129,383,False,1,0
26949,9,197,171,368,False,1,0
26950,10,191,166,357,False,1,0
26951,11,216,181,397,False,1,0
26952,12,220,205,425,False,1,0
26953,13,224,242,466,False,1,0
26954,14,219,339,558,False,1,0
26955,15,198,301,499,False,1,0
26956,16,155,177,332,False,1,0
26957,17,153,160,313,False,1,0
26958,18,159,124,283,False,1,0
26959,19,89,103,192,False,1,0
26960,20,74,129,203,False,1,0
26961,21,51,89,140,False,1,0
26962,22,29,39,68,False,1,0
26963,23,11,21,32,False,1,0
26964,0,13,24,37,False,2,0
26965,1,8,11,19,False,2,0
26966,2,10,16,26,False,2,0
26967,3,11,15,26,False,2,0
26968,4,20,16,36,False,2,0
26969,5,123,45,168,False,2,0
26970,6,227,138,365,False,2,0
26971,7,401,191,592,False,2,0
26972,8,229,152,381,False,2,0
26973,9,202,132,334,False,2,0
26974,10,203,183,386,False,2,0
26975,11,206,203,409,False,2,0
26976,12,207,230,437,False,2,0
26977,13,246,244,490,False,2,0
26978,14,217,335,552,False,2,0
26979,15,220,297,517,False,2,0
26980,16,168,191,359,False,2,0
26981,17,163,156,319,False,2,0
26982,18,144,136,280,False,2,0
26983,19,131,116,247,False,2,0
26984,20,83,96,179,False,2,0
26985,21,51,80,131,False,2,0
26986,22,30,41,71,False,2,0
26987,23,18,23,41,False,2,0
26988,0,8,17,25,False,3,0
26989,1,11,19,30,False,3,0
26990,2,9,20,29,False,3,0
26991,3,15,15,30,False,3,0
26992,4,18,9,27,False,3,0
26993,5,103,44,147,False,3,0
26994,6,223,130,353,False,3,0
26995,7,394,181,575,False,3,0
26996,8,230,127,357,False,3,0
26997,9,180,171,351,False,3,0
26998,10,213,163,376,False,3,0
26999,11,183,176,359,False,3,0
27000,12,196,198,394,False,3,0
27001,13,189,238,427,False,3,0
27002,14,232,308,540,False,3,0
27003,15,216,300,516,False,3,0
27004,16,156,196,352,False,3,0
27005,17,175,173,348,False,3,0
27006,18,131,130,261,False,3,0
27007,19,96,107,203,False,3,0
27008,20,72,88,160,False,3,0
27009,21,65,96,161,False,3,0
27010,22,28,42,70,False,3,0
27011,23,16,25,41,False,3,0
27012,0,16,29,45,False,4,0
27013,1,10,27,37,False,4,0
27014,2,10,29,39,False,4,0
27015,3,9,15,24,False,4,0
27016,4,14,9,23,False,4,0
27017,5,100,52,152,False,4,0
27018,6,206,132,338,False,4,0
27019,7,375,173,548,False,4,0
27020,8,230,129,359,False,4,0
27021,9,226,155,381,False,4,0
27022,10,220,185,405,False,4,0
27023,11,201,210,411,False,4,0
27024,12,211,209,420,False,4,0
27025,13,212,267,479,False,4,0
27026,14,244,327,571,False,4,0
27027,15,189,285,474,False,4,0
27028,16,139,168,307,False,4,0
27029,17,146,107,253,False,4,0
27030,18,90,119,209,False,4,0
27031,19,86,72,158,False,4,0
27032,20,70,62,132,False,4,0
27033,21,57,65,122,False,4,0
27034,22,49,67,116,False,4,0
27035,23,30,44,74,False,4,0
27036,0,26,31,57,False,5,0
27037,1,15,27,42,False,5,0
27038,2,20,30,50,False,5,0
27039,3,17,25,42,False,5,0
27040,4,10,12,22,False,5,0
27041,5,21,13,34,False,5,0
27042,6,20,24,44,False,5,0
27043,7,41,42,83,False,5,0
27044,8,81,58,139,False,5,0
27045,9,86,56,142,False,5,0
27046,10,113,93,206,False,5,0
27047,11,120,118,238,False,5,0
27048,12,135,139,274,False,5,0
27049,13,130,154,284,False,5,0
27050,14,131,187,318,False,5,0
27051,15,105,149,254,False,5,0
27052,16,120,131,251,False,5,0
27053,17,136,127,263,False,5,0
27054,18,88,113,201,False,5,0
27055,19,67,91,158,False,5,0
27056,20,47,62,109,False,5,0
27057,21,42,48,90,False,5,0
27058,22,48,62,110,False,5,0
27059,23,29,61,90,False,5,0
27060,0,39,51,90,True,6,0
27061,1,29,52,81,True,6,0
27062,2,27,64,91,True,6,0
27063,3,20,28,48,True,6,0
27064,4,15,21,36,True,6,0
27065,5,12,16,28,True,6,0
27066,6,13,12,25,True,6,0
27067,7,25,21,46,True,6,0
27068,8,52,37,89,True,6,0
27069,9,96,45,141,True,6,0
27070,10,87,69,156,True,6,0
27071,11,130,128,258,True,6,0
27072,12,130,167,297,True,6,0
27073,13,133,202,335,True,6,0
27074,14,141,180,321,True,6,0
27075,15,141,164,305,True,6,0
27076,16,166,149,315,True,6,0
27077,17,118,106,224,True,6,0
27078,18,111,139,250,True,6,0
27079,19,84,132,216,True,6,0
27080,20,59,73,132,True,6,0
27081,21,38,64,102,True,6,0
27082,22,31,32,63,True,6,0
27083,23,15,20,35,True,6,0
27084,0,8,17,25,False,0,0
27085,1,3,9,12,False,0,0
27086,2,6,12,18,False,0,0
27087,3,8,10,18,False,0,0
27088,4,17,9,26,False,0,0
27089,5,107,56,163,False,0,0
27090,6,214,136,350,False,0,0
27091,7,407,206,613,False,0,0
27092,8,231,158,389,False,0,0
27093,9,206,154,360,False,0,0
27094,10,194,169,363,False,0,0
27095,11,202,185,387,False,0,0
27096,12,189,191,380,False,0,0
27097,13,192,224,416,False,0,0
27098,14,198,295,493,False,0,0
27099,15,181,299,480,False,0,0
27100,16,201,195,396,False,0,0
27101,17,164,160,324,False,0,0
27102,18,106,137,243,False,0,0
27103,19,90,115,205,False,0,0
27104,20,74,91,165,False,0,0
27105,21,65,81,146,False,0,0
27106,22,25,29,54,False,0,0
27107,23,15,28,43,False,0,0
27108,0,10,16,26,False,1,0
27109,1,8,9,17,False,1,0
27110,2,6,11,17,False,1,0
27111,3,8,3,11,False,1,0
27112,4,23,9,32,False,1,0
27113,5,116,54,170,False,1,0
27114,6,236,124,360,False,1,0
27115,7,392,201,593,False,1,0
27116,8,229,160,389,False,1,0
27117,9,200,169,369,False,1,0
27118,10,201,151,352,False,1,0
27119,11,164,163,327,False,1,0
27120,12,194,183,377,False,1,0
27121,13,191,228,419,False,1,0
27122,14,210,267,477,False,1,0
27123,15,200,304,504,False,1,0
27124,16,179,162,341,False,1,0
27125,17,151,129,280,False,1,0
27126,18,132,128,260,False,1,0
27127,19,82,110,192,False,1,0
27128,20,68,107,175,False,1,0
27129,21,44,62,106,False,1,0
27130,22,19,42,61,False,1,0
27131,23,12,23,35,False,1,0
27132,0,10,22,32,False,2,0
27133,1,10,13,23,False,2,0
27134,2,14,45,59,False,2,0
27135,3,9,11,20,False,2,0
27136,4,17,13,30,False,2,0
27137,5,108,46,154,False,2,0
27138,6,236,142,378,False,2,0
27139,7,395,200,595,False,2,0
27140,8,256,144,400,False,2,0
27141,9,189,160,349,False,2,0
27142,10,226,170,396,False,2,0
27143,11,206,200,406,False,2,0
27144,12,203,194,397,False,2,0
27145,13,222,227,449,False,2,0
27146,14,216,322,538,False,2,0
27147,15,229,310,539,False,2,0
27148,16,201,214,415,False,2,0
27149,17,179,159,338,False,2,0
27150,18,134,129,263,False,2,0
27151,19,97,120,217,False,2,0
27152,20,76,107,183,False,2,0
27153,21,46,80,126,False,2,0
27154,22,27,42,69,False,2,0
27155,23,18,33,51,False,2,0
27156,0,6,18,24,False,3,0
27157,1,5,18,23,False,3,0
27158,2,12,13,25,False,3,0
27159,3,5,11,16,False,3,0
27160,4,17,13,30,False,3,0
27161,5,119,44,163,False,3,0
27162,6,254,128,382,False,3,0
27163,7,395,184,579,False,3,0
27164,8,270,155,425,False,3,0
27165,9,206,164,370,False,3,0
27166,10,211,177,388,False,3,0
27167,11,246,218,464,False,3,0
27168,12,220,210,430,False,3,0
27169,13,222,223,445,False,3,0
27170,14,232,315,547,False,3,0
27171,15,194,293,487,False,3,0
27172,16,177,192,369,False,3,0
27173,17,163,176,339,False,3,0
27174,18,124,130,254,False,3,0
27175,19,93,102,195,False,3,0
27176,20,83,124,207,False,3,0
27177,21,72,91,163,False,3,0
27178,22,49,49,98,False,3,0
27179,23,28,34,62,False,3,0
27180,0,19,40,59,False,4,1
27181,1,8,43,51,False,4,1
27182,2,8,35,43,False,4,1
27183,3,6,31,37,False,4,1
27184,4,20,35,55,False,4,1
27185,5,102,46,148,False,4,1
27186,6,227,128,355,False,4,1
27187,7,277,181,458,False,4,1
27188,8,234,145,379,False,4,1
27189,9,230,137,367,False,4,1
27190,10,231,183,414,False,4,1
27191,11,197,177,374,False,4,1
27192,12,202,217,419,False,4,1
27193,13,215,253,468,False,4,1
27194,14,253,322,575,False,4,1
27195,15,185,252,437,False,4,1
27196,16,150,166,316,False,4,1
27197,17,124,131,255,False,4,1
27198,18,108,120,228,False,4,1
27199,19,72,109,181,False,4,1
27200,20,62,72,134,False,4,1
27201,21,51,58,109,False,4,1
27202,22,45,54,99,False,4,1
27203,23,34,51,85,False,4,1
27204,0,22,36,58,False,5,1
27205,1,16,47,63,False,5,1
27206,2,20,47,67,False,5,1
27207,3,12,23,35,False,5,1
27208,4,8,15,23,False,5,1
27209,5,29,16,45,False,5,1
27210,6,23,33,56,False,5,1
27211,7,31,25,56,False,5,1
27212,8,53,34,87,False,5,1
27213,9,76,58,134,False,5,1
27214,10,104,76,180,False,5,1
27215,11,129,97,226,False,5,1
27216,12,126,130,256,False,5,1
27217,13,157,140,297,False,5,1
27218,14,129,156,285,False,5,1
27219,15,109,141,250,False,5,1
27220,16,135,127,262,False,5,1
27221,17,118,112,230,False,5,1
27222,18,90,97,187,False,5,1
27223,19,70,81,151,False,5,1
27224,20,56,77,133,False,5,1
27225,21,35,68,103,False,5,1
27226,22,33,55,88,False,5,1
27227,23,35,60,95,False,5,1
27228,0,29,31,60,True,6,1
27229,1,27,44,71,True,6,1
27230,2,21,65,86,True,6,1
27231,3,14,35,49,True,6,1
27232,4,16,17,33,True,6,1
27233,5,16,16,32,True,6,1
27234,6,21,13,34,True,6,1
27235,7,29,10,39,True,6,1
27236,8,32,43,75,True,6,1
27237,9,96,42,138,True,6,1
27238,10,55,46,101,True,6,1
27239,13,169,167,336,True,6,1
27240,14,133,166,299,True,6,1
27241,15,131,184,315,True,6,1
27242,16,143,153,296,True,6,1
27243,17,136,118,254,True,6,1
27244,18,127,141,268,True,6,1
27245,19,101,139,240,True,6,1
27246,20,62,95,157,True,6,1
27247,21,63,59,122,True,6,1
27248,22,22,36,58,True,6,1
27249,23,18,21,39,True,6,1
27250,0,12,13,25,False,0,1
27251,1,7,15,22,False,0,1
27252,2,4,8,12,False,0,1
27253,3,10,13,23,False,0,1
27254,4,22,16,38,False,0,1
27255,5,105,54,159,False,0,1
27256,6,221,135,356,False,0,1
27257,7,366,190,556,False,0,1
27258,8,240,135,375,False,0,1
27259,9,187,147,334,False,0,1
27260,10,181,168,349,False,0,1
27261,11,179,188,367,False,0,1
27262,12,169,188,357,False,0,1
27263,13,202,239,441,False,0,1
27264,14,227,289,516,False,0,1
27265,15,187,308,495,False,0,1
27266,16,180,180,360,False,0,1
27267,17,162,142,304,False,0,1
27268,18,106,133,239,False,0,1
27269,19,101,114,215,False,0,1
27270,20,75,93,168,False,0,1
27271,21,53,68,121,False,0,1
27272,22,27,30,57,False,0,1
27273,23,21,20,41,False,0,1
27274,0,17,17,34,False,1,1
27275,1,4,13,17,False,1,1
27276,2,7,6,13,False,1,1
27277,3,11,7,18,False,1,1
27278,4,16,14,30,False,1,1
27279,5,102,54,156,False,1,1
27280,6,232,123,355,False,1,1
27281,7,374,193,567,False,1,1
27282,8,252,143,395,False,1,1
27283,9,227,149,376,False,1,1
27284,10,227,171,398,False,1,1
27285,11,178,195,373,False,1,1
27286,12,202,201,403,False,1,1
27287,13,224,222,446,False,1,1
27288,14,242,308,550,False,1,1
27289,15,222,364,586,False,1,1
27290,16,196,164,360,False,1,1
27291,17,176,142,318,False,1,1
27292,18,153,158,311,False,1,1
27293,19,85,109,194,False,1,1
27294,20,75,121,196,False,1,1
27295,21,74,86,160,False,1,1
27296,22,39,46,85,False,1,1
27297,23,20,29,49,False,1,1
27298,0,7,11,18,False,2,1
27299,1,7,7,14,False,2,1
27300,2,12,12,24,False,2,1
27301,3,18,3,21,False,2,1
27302,4,21,16,37,False,2,1
27303,5,119,47,166,False,2,1
27304,6,237,117,354,False,2,1
27305,7,410,181,591,False,2,1
27306,8,241,142,383,False,2,1
27307,9,211,160,371,False,2,1
27308,10,184,169,353,False,2,1
27309,11,189,166,355,False,2,1
27310,12,197,197,394,False,2,1
27311,13,175,253,428,False,2,1
27312,14,234,301,535,False,2,1
27313,15,222,301,523,False,2,1
27314,16,162,183,345,False,2,1
27315,17,179,170,349,False,2,1
27316,18,143,148,291,False,2,1
27317,19,102,101,203,False,2,1
27318,20,65,123,188,False,2,1
27319,21,50,91,141,False,2,1
27320,22,31,63,94,False,2,1
27321,23,18,25,43,False,2,1
27322,0,9,12,21,False,3,1
27323,1,6,19,25,False,3,1
27324,2,5,15,20,False,3,1
27325,3,8,13,21,False,3,1
27326,4,17,14,31,False,3,1
27327,5,115,48,163,False,3,1
27328,6,211,132,343,False,3,1
27329,7,388,178,566,False,3,1
27330,8,248,125,373,False,3,1
27331,9,198,172,370,False,3,1
27332,10,207,166,373,False,3,1
27333,11,197,203,400,False,3,1
27334,12,195,208,403,False,3,1
27335,13,222,260,482,False,3,1
27336,14,261,309,570,False,3,1
27337,15,219,293,512,False,3,1
27338,16,205,201,406,False,3,1
27339,17,156,163,319,False,3,1
27340,18,126,140,266,False,3,1
27341,19,97,125,222,False,3,1
27342,20,77,96,173,False,3,1
27343,21,52,82,134,False,3,1
27344,22,32,61,93,False,3,1
27345,23,18,39,57,False,3,1
27346,0,14,23,37,False,4,1
27347,1,14,21,35,False,4,1
27348,2,7,16,23,False,4,1
27349,3,8,11,19,False,4,1
27350,4,17,6,23,False,4,1
27351,5,114,49,163,False,4,1
27352,6,228,127,355,False,4,1
27353,7,383,199,582,False,4,1
27354,8,260,170,430,False,4,1
27355,9,213,164,377,False,4,1
27356,10,198,158,356,False,4,1
27357,11,175,209,384,False,4,1
27358,12,197,196,393,False,4,1
27359,13,229,270,499,False,4,1
27360,14,302,343,645,False,4,1
27361,15,189,327,516,False,4,1
27362,16,158,184,342,False,4,1
27363,17,119,125,244,False,4,1
27364,18,108,103,211,False,4,1
27365,19,80,82,162,False,4,1
27366,20,70,94,164,False,4,1
27367,21,49,70,119,False,4,1
27368,22,35,36,71,False,4,1
27369,23,28,46,74,False,4,1
27370,0,22,29,51,False,5,1
27371,1,22,31,53,False,5,1
27372,2,12,37,49,False,5,1
27373,3,14,25,39,False,5,1
27374,4,13,10,23,False,5,1
27375,5,30,4,34,False,5,1
27376,6,30,32,62,False,5,1
27377,7,37,29,66,False,5,1
27378,8,71,44,115,False,5,1
27379,9,87,49,136,False,5,1
27380,10,119,100,219,False,5,1
27381,11,154,132,286,False,5,1
27382,12,148,137,285,False,5,1
27383,13,149,155,304,False,5,1
27384,14,126,146,272,False,5,1
27385,15,133,150,283,False,5,1
27386,16,111,149,260,False,5,1
27387,17,145,125,270,False,5,1
27388,18,129,129,258,False,5,1
27389,19,70,91,161,False,5,1
27390,20,56,73,129,False,5,1
27391,21,42,189,231,False,5,1
27392,22,35,218,253,False,5,1
27393,23,40,67,107,False,5,1
27394,0,28,44,72,True,6,1
27395,1,32,54,86,True,6,1
27396,2,24,54,78,True,6,1
27397,3,18,44,62,True,6,1
27398,4,18,13,31,True,6,1
27399,5,16,13,29,True,6,1
27400,6,19,20,39,True,6,1
27401,7,29,15,44,True,6,1
27402,8,52,31,83,True,6,1
27403,9,72,55,127,True,6,1
27404,10,107,79,186,True,6,1
27405,11,116,133,249,True,6,1
27406,12,147,162,309,True,6,1
27407,13,164,180,344,True,6,1
27408,14,148,165,313,True,6,1
27409,15,163,186,349,True,6,1
27410,16,141,153,294,True,6,1
27411,17,141,124,265,True,6,1
27412,18,127,132,259,True,6,1
27413,19,108,112,220,True,6,1
27414,20,82,92,174,True,6,1
27415,21,58,74,132,True,6,1
27416,22,31,32,63,True,6,1
27417,23,18,21,39,True,6,1
27418,0,3,7,10,False,0,1
27419,1,4,8,12,False,0,1
27420,2,7,14,21,False,0,1
27421,3,13,14,27,False,0,1
27422,4,25,5,30,False,0,1
27423,5,125,52,177,False,0,1
27424,6,219,142,361,False,0,1
27425,7,399,183,582,False,0,1
27426,8,255,148,403,False,0,1
27427,9,199,155,354,False,0,1
27428,10,204,161,365,False,0,1
27429,11,180,174,354,False,0,1
27430,12,198,195,393,False,0,1
27431,13,178,223,401,False,0,1
27432,14,232,310,542,False,0,1
27433,15,177,298,475,False,0,1
27434,16,200,187,387,False,0,1
27435,17,154,147,301,False,0,1
27436,18,122,126,248,False,0,1
27437,19,85,123,208,False,0,1
27438,20,81,131,212,False,0,1
27439,21,54,70,124,False,0,1
27440,22,32,39,71,False,0,1
27441,23,18,17,35,False,0,1
27442,0,8,13,21,False,1,1
27443,1,7,9,16,False,1,1
27444,2,6,6,12,False,1,1
27445,3,10,6,16,False,1,1
27446,4,27,8,35,False,1,1
27447,5,131,47,178,False,1,1
27448,6,223,124,347,False,1,1
27449,7,408,200,608,False,1,1
27450,8,247,171,418,False,1,1
27451,9,222,162,384,False,1,1
27452,10,190,184,374,False,1,1
27453,11,188,184,372,False,1,1
27454,12,206,183,389,False,1,1
27455,13,189,256,445,False,1,1
27456,14,240,327,567,False,1,1
27457,15,224,307,531,False,1,1
27458,16,170,182,352,False,1,1
27459,17,181,158,339,False,1,1
27460,18,156,117,273,False,1,1
27461,19,100,132,232,False,1,1
27462,20,70,116,186,False,1,1
27463,21,46,90,136,False,1,1
27464,22,40,156,196,False,1,1
27465,23,10,14,24,False,1,1
27466,0,14,13,27,False,2,1
27467,1,6,5,11,False,2,1
27468,2,5,9,14,False,2,1
27469,3,9,13,22,False,2,1
27470,4,17,5,22,False,2,1
27471,5,107,53,160,False,2,1
27472,6,252,117,369,False,2,1
27473,7,396,175,571,False,2,1
27474,8,242,150,392,False,2,1
27475,9,228,163,391,False,2,1
27476,10,206,151,357,False,2,1
27477,11,177,168,345,False,2,1
27478,12,195,197,392,False,2,1
27479,13,203,256,459,False,2,1
27480,14,281,345,626,False,2,1
27481,15,207,320,527,False,2,1
27482,16,183,205,388,False,2,1
27483,17,174,151,325,False,2,1
27484,18,130,142,272,False,2,1
27485,19,100,109,209,False,2,1
27486,20,68,99,167,False,2,1
27487,21,34,71,105,False,2,1
27488,22,18,50,68,False,2,1
27489,23,11,30,41,False,2,1
27490,0,6,17,23,False,3,1
27491,1,3,9,12,False,3,1
27492,2,5,19,24,False,3,1
27493,3,10,14,24,False,3,1
27494,4,16,13,29,False,3,1
27495,5,125,49,174,False,3,1
27496,6,231,138,369,False,3,1
27497,7,427,214,641,False,3,1
27498,8,276,130,406,False,3,1
27499,9,226,177,403,False,3,1
27500,10,188,169,357,False,3,1
27501,11,182,191,373,False,3,1
27502,12,215,201,416,False,3,1
27503,13,223,240,463,False,3,1
27504,14,262,326,588,False,3,1
27505,15,213,323,536,False,3,1
27506,16,183,179,362,False,3,1
27507,17,185,170,355,False,3,1
27508,18,113,161,274,False,3,1
27509,19,96,123,219,False,3,1
27510,20,60,118,178,False,3,1
27511,21,60,86,146,False,3,1
27512,22,22,35,57,False,3,1
27513,23,14,22,36,False,3,1
27514,0,10,22,32,False,4,1
27515,1,14,27,41,False,4,1
27516,2,8,36,44,False,4,1
27517,3,10,12,22,False,4,1
27518,4,21,16,37,False,4,1
27519,5,127,39,166,False,4,1
27520,6,231,133,364,False,4,1
27521,7,379,180,559,False,4,1
27522,8,272,129,401,False,4,1
27523,9,221,154,375,False,4,1
27524,10,219,159,378,False,4,1
27525,11,190,194,384,False,4,1
27526,12,234,216,450,False,4,1
27527,13,209,266,475,False,4,1
27528,14,275,336,611,False,4,1
27529,15,162,267,429,False,4,1
27530,16,188,184,372,False,4,1
27531,17,137,153,290,False,4,1
27532,18,125,139,264,False,4,1
27533,19,85,103,188,False,4,1
27534,20,75,94,169,False,4,1
27535,21,54,80,134,False,4,1
27536,22,56,67,123,False,4,1
27537,23,35,62,97,False,4,1
27538,0,24,28,52,False,5,1
27539,1,17,36,53,False,5,1
27540,2,13,40,53,False,5,1
27541,3,12,11,23,False,5,1
27542,4,12,18,30,False,5,1
27543,5,25,14,39,False,5,1
27544,6,22,18,40,False,5,1
27545,7,41,29,70,False,5,1
27546,8,70,50,120,False,5,1
27547,9,120,70,190,False,5,1
27548,10,127,105,232,False,5,1
27549,11,142,127,269,False,5,1
27550,12,144,134,278,False,5,1
27551,13,156,174,330,False,5,1
27552,14,144,210,354,False,5,1
27553,15,126,166,292,False,5,1
27554,16,123,160,283,False,5,1
27555,17,132,126,258,False,5,1
27556,18,88,98,186,False,5,1
27557,19,64,109,173,False,5,1
27558,20,52,64,116,False,5,1
27559,21,52,62,114,False,5,1
27560,22,42,62,104,False,5,1
27561,23,44,51,95,False,5,1
27562,0,30,55,85,True,6,1
27563,1,34,54,88,True,6,1
27564,2,18,56,74,True,6,1
27565,3,16,37,53,True,6,1
27566,4,23,18,41,True,6,1
27567,5,18,14,32,True,6,1
27568,6,16,12,28,True,6,1
27569,7,33,16,49,True,6,1
27570,8,53,30,83,True,6,1
27571,9,99,42,141,True,6,1
27572,10,122,71,193,True,6,1
27573,11,133,131,264,True,6,1
27574,12,155,151,306,True,6,1
27575,13,157,176,333,True,6,1
27576,14,160,199,359,True,6,1
27577,15,143,224,367,True,6,1
27578,16,134,161,295,True,6,1
27579,17,143,154,297,True,6,1
27580,18,145,123,268,True,6,1
27581,19,89,118,207,True,6,1
27582,20,70,107,177,True,6,1
27583,21,47,72,119,True,6,1
27584,22,26,40,66,True,6,1
27585,23,10,20,30,True,6,1
27586,0,13,15,28,False,0,1
27587,1,8,15,23,False,0,1
27588,2,2,8,10,False,0,1
27589,3,11,11,22,False,0,1
27590,4,26,17,43,False,0,1
27591,5,126,58,184,False,0,1
27592,6,228,128,356,False,0,1
27593,7,422,176,598,False,0,1
27594,8,240,138,378,False,0,1
27595,9,216,157,373,False,0,1
27596,10,192,147,339,False,0,1
27597,11,204,178,382,False,0,1
27598,12,185,190,375,False,0,1
27599,13,180,257,437,False,0,1
27600,14,213,302,515,False,0,1
27601,15,179,292,471,False,0,1
27602,16,193,210,403,False,0,1
27603,17,169,160,329,False,0,1
27604,18,136,130,266,False,0,1
27605,19,117,140,257,False,0,1
27606,20,60,86,146,False,0,1
27607,21,58,81,139,False,0,1
27608,22,22,46,68,False,0,1
27609,23,13,20,33,False,0,1
27610,0,8,11,19,False,1,1
27611,1,3,9,12,False,1,1
27612,2,10,8,18,False,1,1
27613,3,16,9,25,False,1,1
27614,4,30,15,45,False,1,1
27615,5,132,55,187,False,1,1
27616,6,265,144,409,False,1,1
27617,7,462,217,679,False,1,1
27618,8,282,163,445,False,1,1
27619,9,218,202,420,False,1,1
27620,10,230,177,407,False,1,1
27621,11,208,188,396,False,1,1
27622,12,218,183,401,False,1,1
27623,13,228,273,501,False,1,1
27624,14,243,291,534,False,1,1
27625,15,223,335,558,False,1,1
27626,16,211,198,409,False,1,1
27627,17,178,175,353,False,1,1
27628,18,136,169,305,False,1,1
27629,19,101,146,247,False,1,1
27630,20,86,125,211,False,1,1
27631,21,49,78,127,False,1,1
27632,22,47,66,113,False,1,1
27633,23,22,15,37,False,1,1
27634,0,9,21,30,False,2,1
27635,1,11,31,42,False,2,1
27636,2,4,19,23,False,2,1
27637,3,14,24,38,False,2,1
27638,4,21,12,33,False,2,1
27639,5,109,53,162,False,2,1
27640,6,231,135,366,False,2,1
27641,7,451,199,650,False,2,1
27642,8,316,163,479,False,2,1
27643,9,223,182,405,False,2,1
27644,10,227,176,403,False,2,1
27645,11,193,208,401,False,2,1
27646,12,217,213,430,False,2,1
27647,13,194,246,440,False,2,1
27648,14,269,346,615,False,2,1
27649,15,237,295,532,False,2,1
27650,16,209,218,427,False,2,1
27651,17,168,172,340,False,2,1
27652,18,155,174,329,False,2,1
27653,19,104,125,229,False,2,1
27654,20,88,100,188,False,2,1
27655,21,47,80,127,False,2,1
27656,22,48,50,98,False,2,1
27657,23,17,17,34,False,2,1
27658,0,10,20,30,False,3,1
27659,1,12,19,31,False,3,1
27660,2,4,21,25,False,3,1
27661,3,7,10,17,False,3,1
27662,4,19,18,37,False,3,1
27663,5,116,60,176,False,3,1
27664,6,232,132,364,False,3,1
27665,7,449,221,670,False,3,1
27666,8,270,132,402,False,3,1
27667,9,230,159,389,False,3,1
27668,10,210,189,399,False,3,1
27669,11,211,204,415,False,3,1
27670,12,220,202,422,False,3,1
27671,13,213,239,452,False,3,1
27672,14,223,325,548,False,3,1
27673,15,213,306,519,False,3,1
27674,16,186,172,358,False,3,1
27675,17,162,162,324,False,3,1
27676,18,130,159,289,False,3,1
27677,19,91,122,213,False,3,1
27678,20,80,114,194,False,3,1
27679,21,65,87,152,False,3,1
27680,22,40,63,103,False,3,1
27681,23,20,47,67,False,3,1
27682,0,14,24,38,False,4,1
27683,1,5,26,31,False,4,1
27684,2,11,25,36,False,4,1
27685,3,11,17,28,False,4,1
27686,4,20,15,35,False,4,1
27687,5,120,53,173,False,4,1
27688,6,249,136,385,False,4,1
27689,7,398,192,590,False,4,1
27690,8,262,144,406,False,4,1
27691,9,220,171,391,False,4,1
27692,10,248,175,423,False,4,1
27693,11,168,221,389,False,4,1
27694,12,224,209,433,False,4,1
27695,13,235,363,598,False,4,1
27696,14,267,340,607,False,4,1
27697,15,172,291,463,False,4,1
27698,16,148,176,324,False,4,1
27699,17,126,133,259,False,4,1
27700,18,103,125,228,False,4,1
27701,19,80,81,161,False,4,1
27702,20,51,73,124,False,4,1
27703,21,44,64,108,False,4,1
27704,22,45,50,95,False,4,1
27705,23,28,45,73,False,4,1
27706,0,31,41,72,False,5,1
27707,1,16,32,48,False,5,1
27708,2,11,27,38,False,5,1
27709,3,21,24,45,False,5,1
27710,4,11,8,19,False,5,1
27711,5,21,11,32,False,5,1
27712,6,24,25,49,False,5,1
27713,7,37,36,73,False,5,1
27714,8,66,48,114,False,5,1
27715,9,87,55,142,False,5,1
27716,10,107,85,192,False,5,1
27717,11,125,108,233,False,5,1
27718,12,117,125,242,False,5,1
27719,13,149,171,320,False,5,1
27720,14,120,161,281,False,5,1
27721,15,135,146,281,False,5,1
27722,16,113,160,273,False,5,1
27723,17,128,138,266,False,5,1
27724,18,90,118,208,False,5,1
27725,19,67,91,158,False,5,1
27726,20,37,70,107,False,5,1
27727,21,34,74,108,False,5,1
27728,22,47,62,109,False,5,1
27729,23,43,64,107,False,5,1
27730,0,23,37,60,True,6,1
27731,1,20,49,69,True,6,1
27732,2,15,44,59,True,6,1
27733,3,13,26,39,True,6,1
27734,4,6,8,14,True,6,1
27735,5,17,22,39,True,6,1
27736,6,10,18,28,True,6,1
27737,7,28,13,41,True,6,1
27738,8,45,45,90,True,6,1
27739,9,81,48,129,True,6,1
27740,10,81,75,156,True,6,1
27741,11,116,117,233,True,6,1
27742,12,140,155,295,True,6,1
27743,13,150,165,315,True,6,1
27744,14,136,151,287,True,6,1
27745,15,114,172,286,True,6,1
27746,16,145,134,279,True,6,1
27747,17,104,124,228,True,6,1
27748,18,100,115,215,True,6,1
27749,19,82,130,212,True,6,1
27750,20,67,73,140,True,6,1
27751,21,46,62,108,True,6,1
27752,22,34,42,76,True,6,1
27753,23,14,20,34,True,6,1
27754,0,10,6,16,False,0,1
27755,1,6,7,13,False,0,1
27756,2,6,9,15,False,0,1
27757,3,10,6,16,False,0,1
27758,4,16,6,22,False,0,1
27759,5,118,59,177,False,0,1
27760,6,225,116,341,False,0,1
27761,7,283,160,443,False,0,1
27762,8,237,146,383,False,0,1
27763,9,221,150,371,False,0,1
27764,10,184,175,359,False,0,1
27765,11,190,183,373,False,0,1
27766,12,197,219,416,False,0,1
27767,13,212,230,442,False,0,1
27768,14,185,276,461,False,0,1
27769,15,193,279,472,False,0,1
27770,16,151,165,316,False,0,1
27771,17,132,131,263,False,0,1
27772,18,98,118,216,False,0,1
27773,19,95,118,213,False,0,1
27774,20,72,91,163,False,0,1
27775,21,56,68,124,False,0,1
27776,22,23,30,53,False,0,1
27777,23,15,17,32,False,0,1
27778,0,16,10,26,False,1,1
27779,1,3,11,14,False,1,1
27780,2,4,10,14,False,1,1
27781,3,9,5,14,False,1,1
27782,4,16,7,23,False,1,1
27783,5,112,38,150,False,1,1
27784,6,211,114,325,False,1,1
27785,7,311,161,472,False,1,1
27786,8,210,151,361,False,1,1
27787,9,181,123,304,False,1,1
27788,10,208,168,376,False,1,1
27789,11,154,165,319,False,1,1
27790,12,169,198,367,False,1,1
27791,13,222,213,435,False,1,1
27792,14,183,279,462,False,1,1
27793,15,188,274,462,False,1,1
27794,16,159,169,328,False,1,1
27795,17,171,143,314,False,1,1
27796,18,122,114,236,False,1,1
27797,19,99,111,210,False,1,1
27798,20,61,83,144,False,1,1
27799,21,48,76,124,False,1,1
27800,22,26,71,97,False,1,1
27801,23,17,40,57,False,1,1
27802,0,12,30,42,False,2,1
27803,1,7,8,15,False,2,1
27804,2,5,19,24,False,2,1
27805,3,5,10,15,False,2,1
27806,4,17,6,23,False,2,1
27807,5,104,50,154,False,2,1
27808,6,212,115,327,False,2,1
27809,7,270,157,427,False,2,1
27810,8,227,128,355,False,2,1
27811,9,190,162,352,False,2,1
27812,10,199,160,359,False,2,1
27813,11,207,157,364,False,2,1
27814,12,183,204,387,False,2,1
27815,13,176,230,406,False,2,1
27816,14,202,235,437,False,2,1
27817,15,175,279,454,False,2,1
27818,16,146,133,279,False,2,1
27819,17,151,157,308,False,2,1
27820,18,109,106,215,False,2,1
27821,19,89,107,196,False,2,1
27822,20,52,95,147,False,2,1
27823,21,55,68,123,False,2,1
27824,22,33,40,73,False,2,1
27825,23,16,28,44,False,2,1
27826,0,13,20,33,False,3,1
27827,1,3,14,17,False,3,1
27828,2,9,14,23,False,3,1
27829,3,12,10,22,False,3,1
27830,4,17,11,28,False,3,1
27831,5,99,51,150,False,3,1
27832,6,211,119,330,False,3,1
27833,7,267,133,400,False,3,1
27834,8,225,124,349,False,3,1
27835,9,179,148,327,False,3,1
27836,10,182,168,350,False,3,1
27837,11,167,200,367,False,3,1
27838,12,172,182,354,False,3,1
27839,13,165,211,376,False,3,1
27840,14,232,261,493,False,3,1
27841,15,172,275,447,False,3,1
27842,16,134,164,298,False,3,1
27843,17,138,130,268,False,3,1
27844,18,119,105,224,False,3,1
27845,19,76,113,189,False,3,1
27846,20,75,88,163,False,3,1
27847,21,51,75,126,False,3,1
27848,22,24,36,60,False,3,1
27849,23,21,21,42,False,3,1
27850,0,7,16,23,False,4,2
27851,1,14,23,37,False,4,2
27852,2,8,25,33,False,4,2
27853,3,7,14,21,False,4,2
27854,4,17,8,25,False,4,2
27855,5,94,48,142,False,4,2
27856,6,190,117,307,False,4,2
27857,7,261,129,390,False,4,2
27858,8,185,115,300,False,4,2
27859,9,165,146,311,False,4,2
27860,10,160,142,302,False,4,2
27861,11,189,196,385,False,4,2
27862,12,176,165,341,False,4,2
27863,13,204,216,420,False,4,2
27864,14,191,246,437,False,4,2
27865,15,161,230,391,False,4,2
27866,16,145,160,305,False,4,2
27867,17,118,154,272,False,4,2
27868,18,102,104,206,False,4,2
27869,19,79,109,188,False,4,2
27870,20,66,80,146,False,4,2
27871,21,54,60,114,False,4,2
27872,22,35,59,94,False,4,2
27873,23,27,45,72,False,4,2
27874,0,20,21,41,False,5,2
27875,1,17,38,55,False,5,2
27876,2,22,34,56,False,5,2
27877,3,13,25,38,False,5,2
27878,4,12,7,19,False,5,2
27879,5,18,19,37,False,5,2
27880,6,24,25,49,False,5,2
27881,7,37,25,62,False,5,2
27882,8,43,40,83,False,5,2
27883,9,78,56,134,False,5,2
27884,10,99,92,191,False,5,2
27885,11,136,128,264,False,5,2
27886,12,115,128,243,False,5,2
27887,13,130,167,297,False,5,2
27888,14,111,138,249,False,5,2
27889,15,119,129,248,False,5,2
27890,16,100,130,230,False,5,2
27891,17,104,122,226,False,5,2
27892,18,104,106,210,False,5,2
27893,19,71,74,145,False,5,2
27894,20,44,66,110,False,5,2
27895,21,35,63,98,False,5,2
27896,22,44,52,96,False,5,2
27897,23,35,48,83,False,5,2
27898,0,24,37,61,True,6,2
27899,1,27,46,73,True,6,2
27900,2,28,40,68,True,6,2
27901,3,19,31,50,True,6,2
27902,4,9,18,27,True,6,2
27903,5,17,13,30,True,6,2
27904,6,12,12,24,True,6,2
27905,7,20,14,34,True,6,2
27906,8,42,34,76,True,6,2
27907,9,89,55,144,True,6,2
27908,10,78,65,143,True,6,2
27909,11,125,121,246,True,6,2
27910,12,117,130,247,True,6,2
27911,13,154,156,310,True,6,2
27912,14,108,153,261,True,6,2
27913,15,121,191,312,True,6,2
27914,16,123,126,249,True,6,2
27915,17,129,128,257,True,6,2
27916,18,140,128,268,True,6,2
27917,19,107,121,228,True,6,2
27918,20,61,91,152,True,6,2
27919,21,49,60,109,True,6,2
27920,22,21,36,57,True,6,2
27921,23,17,17,34,True,6,2
27922,0,5,20,25,False,0,2
27923,1,3,7,10,False,0,2
27924,2,2,9,11,False,0,2
27925,3,9,7,16,False,0,2
27926,4,20,14,34,False,0,2
27927,5,116,52,168,False,0,2
27928,6,222,160,382,False,0,2
27929,7,399,194,593,False,0,2
27930,8,240,153,393,False,0,2
27931,9,197,163,360,False,0,2
27932,10,187,163,350,False,0,2
27933,11,179,171,350,False,0,2
27934,12,217,224,441,False,0,2
27935,13,202,232,434,False,0,2
27936,14,237,338,575,False,0,2
27937,15,234,292,526,False,0,2
27938,16,201,232,433,False,0,2
27939,17,163,151,314,False,0,2
27940,18,116,145,261,False,0,2
27941,19,108,123,231,False,0,2
27942,20,65,116,181,False,0,2
27943,21,46,67,113,False,0,2
27944,22,25,38,63,False,0,2
27945,23,22,22,44,False,0,2
27946,0,10,14,24,False,1,2
27947,1,5,7,12,False,1,2
27948,2,3,22,25,False,1,2
27949,3,12,10,22,False,1,2
27950,4,25,12,37,False,1,2
27951,5,125,40,165,False,1,2
27952,6,222,138,360,False,1,2
27953,7,400,190,590,False,1,2
27954,8,240,168,408,False,1,2
27955,9,222,170,392,False,1,2
27956,10,229,181,410,False,1,2
27957,11,217,195,412,False,1,2
27958,12,196,220,416,False,1,2
27959,13,219,240,459,False,1,2
27960,14,233,337,570,False,1,2
27961,15,199,516,715,False,1,2
27962,16,173,312,485,False,1,2
27963,17,174,165,339,False,1,2
27964,18,129,121,250,False,1,2
27965,19,92,127,219,False,1,2
27966,20,74,116,190,False,1,2
27967,21,49,91,140,False,1,2
27968,22,43,44,87,False,1,2
27969,23,13,19,32,False,1,2
27970,0,10,20,30,False,2,2
27971,1,6,15,21,False,2,2
27972,2,5,12,17,False,2,2
27973,3,9,6,15,False,2,2
27974,4,17,9,26,False,2,2
27975,5,114,41,155,False,2,2
27976,6,241,134,375,False,2,2
27977,7,407,184,591,False,2,2
27978,8,226,154,380,False,2,2
27979,9,221,128,349,False,2,2
27980,10,218,165,383,False,2,2
27981,11,200,202,402,False,2,2
27982,12,200,227,427,False,2,2
27983,13,222,273,495,False,2,2
27984,14,253,315,568,False,2,2
27985,15,225,325,550,False,2,2
27986,16,203,212,415,False,2,2
27987,17,183,174,357,False,2,2
27988,18,117,160,277,False,2,2
27989,19,103,136,239,False,2,2
27990,20,72,130,202,False,2,2
27991,21,63,56,119,False,2,2
27992,22,41,60,101,False,2,2
27993,23,21,29,50,False,2,2
27994,0,5,12,17,False,3,2
27995,1,5,15,20,False,3,2
27996,2,6,20,26,False,3,2
27997,3,18,8,26,False,3,2
27998,4,19,8,27,False,3,2
27999,5,111,41,152,False,3,2
28000,6,232,148,380,False,3,2
28001,7,403,200,603,False,3,2
28002,8,273,163,436,False,3,2
28003,9,203,159,362,False,3,2
28004,10,204,173,377,False,3,2
28005,11,207,200,407,False,3,2
28006,12,212,217,429,False,3,2
28007,13,191,222,413,False,3,2
28008,14,240,325,565,False,3,2
28009,15,213,302,515,False,3,2
28010,16,189,206,395,False,3,2
28011,17,189,187,376,False,3,2
28012,18,123,157,280,False,3,2
28013,19,87,123,210,False,3,2
28014,20,74,106,180,False,3,2
28015,21,60,237,297,False,3,2
28016,22,33,169,202,False,3,2
28017,23,19,51,70,False,3,2
28018,0,8,36,44,False,4,2
28019,1,12,44,56,False,4,2
28020,2,10,40,50,False,4,2
28021,3,9,30,39,False,4,2
28022,4,22,31,53,False,4,2
28023,5,130,51,181,False,4,2
28024,6,253,146,399,False,4,2
28025,7,399,190,589,False,4,2
28026,8,230,152,382,False,4,2
28027,9,200,156,356,False,4,2
28028,10,216,188,404,False,4,2
28029,11,224,213,437,False,4,2
28030,12,245,241,486,False,4,2
28031,13,207,270,477,False,4,2
28032,14,265,369,634,False,4,2
28033,15,196,306,502,False,4,2
28034,16,168,177,345,False,4,2
28035,17,138,148,286,False,4,2
28036,18,125,136,261,False,4,2
28037,19,77,105,182,False,4,2
28038,20,73,75,148,False,4,2
28039,21,56,70,126,False,4,2
28040,22,51,58,109,False,4,2
28041,23,29,52,81,False,4,2
28042,0,19,41,60,False,5,2
28043,1,19,41,60,False,5,2
28044,2,18,40,58,False,5,2
28045,3,11,20,31,False,5,2
28046,4,9,20,29,False,5,2
28047,5,20,10,30,False,5,2
28048,6,25,30,55,False,5,2
28049,7,33,25,58,False,5,2
28050,8,74,54,128,False,5,2
28051,9,93,67,160,False,5,2
28052,10,109,107,216,False,5,2
28053,11,142,135,277,False,5,2
28054,12,148,135,283,False,5,2
28055,13,125,160,285,False,5,2
28056,14,132,164,296,False,5,2
28057,15,135,172,307,False,5,2
28058,16,123,144,267,False,5,2
28059,17,111,127,238,False,5,2
28060,18,101,103,204,False,5,2
28061,19,76,97,173,False,5,2
28062,20,51,77,128,False,5,2
28063,21,41,63,104,False,5,2
28064,22,35,70,105,False,5,2
28065,23,49,67,116,False,5,2
28066,0,33,48,81,True,6,2
28067,1,30,60,90,True,6,2
28068,2,26,64,90,True,6,2
28069,3,13,35,48,True,6,2
28070,4,13,17,30,True,6,2
28071,5,14,10,24,True,6,2
28072,6,19,13,32,True,6,2
28073,7,30,21,51,True,6,2
28074,8,58,31,89,True,6,2
28075,9,86,43,129,True,6,2
28076,10,122,68,190,True,6,2
28077,11,161,154,315,True,6,2
28078,12,127,158,285,True,6,2
28079,13,157,199,356,True,6,2
28080,14,137,198,335,True,6,2
28081,15,149,205,354,True,6,2
28082,16,156,150,306,True,6,2
28083,17,120,133,253,True,6,2
28084,18,113,158,271,True,6,2
28085,19,119,120,239,True,6,2
28086,20,66,87,153,True,6,2
28087,21,55,74,129,True,6,2
28088,22,25,41,66,True,6,2
28089,23,14,14,28,True,6,2
28090,0,8,21,29,False,0,2
28091,1,7,2,9,False,0,2
28092,2,5,8,13,False,0,2
28093,3,8,4,12,False,0,2
28094,4,17,16,33,False,0,2
28095,5,128,49,177,False,0,2
28096,6,228,149,377,False,0,2
28097,7,397,213,610,False,0,2
28098,8,265,158,423,False,0,2
28099,9,200,136,336,False,0,2
28100,10,171,181,352,False,0,2
28101,11,205,201,406,False,0,2
28102,12,190,203,393,False,0,2
28103,13,171,238,409,False,0,2
28104,14,243,303,546,False,0,2
28105,15,188,327,515,False,0,2
28106,16,187,187,374,False,0,2
28107,17,182,178,360,False,0,2
28108,18,161,149,310,False,0,2
28109,19,102,131,233,False,0,2
28110,20,69,99,168,False,0,2
28111,21,55,72,127,False,0,2
28112,22,22,39,61,False,0,2
28113,23,17,21,38,False,0,2
28114,0,12,14,26,False,1,2
28115,1,3,8,11,False,1,2
28116,2,1,16,17,False,1,2
28117,3,6,21,27,False,1,2
28118,4,22,32,54,False,1,2
28119,5,118,58,176,False,1,2
28120,6,234,148,382,False,1,2
28121,7,454,202,656,False,1,2
28122,8,247,159,406,False,1,2
28123,9,199,167,366,False,1,2
28124,10,162,163,325,False,1,2
28125,11,222,196,418,False,1,2
28126,12,194,190,384,False,1,2
28127,13,209,250,459,False,1,2
28128,14,251,361,612,False,1,2
28129,15,254,329,583,False,1,2
28130,16,198,195,393,False,1,2
28131,17,213,141,354,False,1,2
28132,18,125,137,262,False,1,2
28133,19,88,146,234,False,1,2
28134,20,59,136,195,False,1,2
28135,21,42,82,124,False,1,2
28136,22,31,37,68,False,1,2
28137,23,11,13,24,False,1,2
28138,0,9,10,19,False,2,2
28139,1,3,9,12,False,2,2
28140,2,11,14,25,False,2,2
28141,3,9,7,16,False,2,2
28142,4,18,16,34,False,2,2
28143,5,109,45,154,False,2,2
28144,6,244,159,403,False,2,2
28145,7,430,186,616,False,2,2
28146,8,251,156,407,False,2,2
28147,9,210,162,372,False,2,2
28148,10,224,194,418,False,2,2
28149,11,219,217,436,False,2,2
28150,12,221,251,472,False,2,2
28151,13,179,262,441,False,2,2
28152,14,224,348,572,False,2,2
28153,15,233,304,537,False,2,2
28154,16,181,198,379,False,2,2
28155,17,182,181,363,False,2,2
28156,18,123,150,273,False,2,2
28157,19,140,144,284,False,2,2
28158,20,64,127,191,False,2,2
28159,21,62,76,138,False,2,2
28160,22,24,59,83,False,2,2
28161,23,15,30,45,False,2,2
28162,0,10,15,25,False,3,2
28163,1,17,14,31,False,3,2
28164,2,6,15,21,False,3,2
28165,3,11,10,21,False,3,2
28166,4,20,6,26,False,3,2
28167,5,112,58,170,False,3,2
28168,6,241,153,394,False,3,2
28169,7,435,159,594,False,3,2
28170,8,246,184,430,False,3,2
28171,9,198,163,361,False,3,2
28172,10,219,169,388,False,3,2
28173,11,184,194,378,False,3,2
28174,12,205,222,427,False,3,2
28175,13,211,238,449,False,3,2
28176,14,221,326,547,False,3,2
28177,15,219,304,523,False,3,2
28178,16,188,178,366,False,3,2
28179,17,196,149,345,False,3,2
28180,18,142,141,283,False,3,2
28181,19,97,133,230,False,3,2
28182,20,71,112,183,False,3,2
28183,21,49,101,150,False,3,2
28184,22,31,54,85,False,3,2
28185,23,9,28,37,False,3,2
28186,0,12,27,39,False,4,2
28187,1,16,29,45,False,4,2
28188,2,12,22,34,False,4,2
28189,3,6,10,16,False,4,2
28190,4,17,8,25,False,4,2
28191,5,110,53,163,False,4,2
28192,6,224,164,388,False,4,2
28193,7,406,194,600,False,4,2
28194,8,255,155,410,False,4,2
28195,9,203,177,380,False,4,2
28196,10,237,155,392,False,4,2
28197,11,220,222,442,False,4,2
28198,12,204,232,436,False,4,2
28199,13,213,281,494,False,4,2
28200,14,258,329,587,False,4,2
28201,15,179,289,468,False,4,2
28202,16,151,171,322,False,4,2
28203,17,145,137,282,False,4,2
28204,18,102,118,220,False,4,2
28205,19,88,110,198,False,4,2
28206,20,67,105,172,False,4,2
28207,21,60,69,129,False,4,2
28208,22,30,62,92,False,4,2
28209,23,17,33,50,False,4,2
28210,0,25,44,69,False,5,2
28211,1,24,38,62,False,5,2
28212,2,15,43,58,False,5,2
28213,3,15,30,45,False,5,2
28214,4,6,5,11,False,5,2
28215,5,27,19,46,False,5,2
28216,6,27,22,49,False,5,2
28217,7,48,33,81,False,5,2
28218,8,72,53,125,False,5,2
28219,9,125,93,218,False,5,2
28220,10,134,103,237,False,5,2
28221,11,140,142,282,False,5,2
28222,12,158,158,316,False,5,2
28223,13,120,173,293,False,5,2
28224,14,154,154,308,False,5,2
28225,15,155,163,318,False,5,2
28226,16,123,150,273,False,5,2
28227,17,134,135,269,False,5,2
28228,18,128,130,258,False,5,2
28229,19,81,96,177,False,5,2
28230,20,60,67,127,False,5,2
28231,21,37,68,105,False,5,2
28232,22,48,76,124,False,5,2
28233,23,44,72,116,False,5,2
28234,0,35,59,94,True,6,2
28235,1,25,67,92,True,6,2
28236,2,33,75,108,True,6,2
28237,3,13,44,57,True,6,2
28238,4,14,14,28,True,6,2
28239,5,16,18,34,True,6,2
28240,6,22,15,37,True,6,2
28241,7,30,24,54,True,6,2
28242,8,53,43,96,True,6,2
28243,9,100,53,153,True,6,2
28244,10,118,88,206,True,6,2
28245,11,143,155,298,True,6,2
28246,12,128,179,307,True,6,2
28247,13,188,197,385,True,6,2
28248,14,174,198,372,True,6,2
28249,15,126,208,334,True,6,2
28250,16,138,176,314,True,6,2
28251,17,150,137,287,True,6,2
28252,18,130,137,267,True,6,2
28253,19,118,134,252,True,6,2
28254,20,63,78,141,True,6,2
28255,21,49,57,106,True,6,2
28256,22,28,38,66,True,6,2
28257,23,14,20,34,True,6,2
28258,0,9,12,21,False,0,2
28259,1,6,12,18,False,0,2
28260,2,3,7,10,False,0,2
28261,3,6,12,18,False,0,2
28262,4,23,7,30,False,0,2
28263,5,98,51,149,False,0,2
28264,6,242,147,389,False,0,2
28265,7,408,207,615,False,0,2
28266,8,244,129,373,False,0,2
28267,9,190,158,348,False,0,2
28268,10,185,165,350,False,0,2
28269,11,203,195,398,False,0,2
28270,12,182,202,384,False,0,2
28271,13,202,226,428,False,0,2
28272,14,220,310,530,False,0,2
28273,15,191,293,484,False,0,2
28274,16,206,201,407,False,0,2
28275,17,184,170,354,False,0,2
28276,18,128,136,264,False,0,2
28277,19,109,137,246,False,0,2
28278,20,73,109,182,False,0,2
28279,21,47,88,135,False,0,2
28280,22,23,30,53,False,0,2
28281,23,18,18,36,False,0,2
28282,0,9,16,25,False,1,2
28283,1,6,6,12,False,1,2
28284,2,3,8,11,False,1,2
28285,3,8,9,17,False,1,2
28286,4,18,10,28,False,1,2
28287,5,107,51,158,False,1,2
28288,6,276,147,423,False,1,2
28289,7,417,233,650,False,1,2
28290,8,254,167,421,False,1,2
28291,9,260,202,462,False,1,2
28292,10,226,180,406,False,1,2
28293,11,205,201,406,False,1,2
28294,12,194,218,412,False,1,2
28295,13,229,221,450,False,1,2
28296,14,253,313,566,False,1,2
28297,15,213,296,509,False,1,2
28298,16,191,191,382,False,1,2
28299,17,215,173,388,False,1,2
28300,18,120,152,272,False,1,2
28301,19,91,127,218,False,1,2
28302,20,73,126,199,False,1,2
28303,21,56,74,130,False,1,2
28304,22,26,35,61,False,1,2
28305,23,11,24,35,False,1,2
28306,0,15,22,37,False,2,2
28307,1,6,16,22,False,2,2
28308,2,2,12,14,False,2,2
28309,3,9,7,16,False,2,2
28310,4,24,17,41,False,2,2
28311,5,93,59,152,False,2,2
28312,6,249,152,401,False,2,2
28313,7,412,204,616,False,2,2
28314,8,285,178,463,False,2,2
28315,9,205,164,369,False,2,2
28316,10,200,188,388,False,2,2
28317,11,218,219,437,False,2,2
28318,12,217,202,419,False,2,2
28319,13,197,223,420,False,2,2
28320,14,243,316,559,False,2,2
28321,15,219,302,521,False,2,2
28322,16,209,205,414,False,2,2
28323,17,164,166,330,False,2,2
28324,18,121,163,284,False,2,2
28325,19,97,121,218,False,2,2
28326,20,85,102,187,False,2,2
28327,21,49,75,124,False,2,2
28328,22,25,85,110,False,2,2
28329,23,16,26,42,False,2,2
28330,0,13,15,28,False,3,2
28331,1,5,20,25,False,3,2
28332,2,7,13,20,False,3,2
28333,3,9,13,22,False,3,2
28334,4,18,7,25,False,3,2
28335,5,102,61,163,False,3,2
28336,6,264,141,405,False,3,2
28337,7,411,201,612,False,3,2
28338,8,280,159,439,False,3,2
28339,9,193,177,370,False,3,2
28340,10,218,163,381,False,3,2
28341,11,204,182,386,False,3,2
28342,12,195,202,397,False,3,2
28343,13,218,261,479,False,3,2
28344,14,251,297,548,False,3,2
28345,15,208,425,633,False,3,2
28346,16,214,235,449,False,3,2
28347,17,181,173,354,False,3,2
28348,18,132,149,281,False,3,2
28349,19,104,122,226,False,3,2
28350,20,80,109,189,False,3,2
28351,21,61,106,167,False,3,2
28352,22,24,47,71,False,3,2
28353,23,15,30,45,False,3,2
28354,0,11,35,46,False,4,2
28355,1,14,25,39,False,4,2
28356,2,7,25,32,False,4,2
28357,3,10,13,23,False,4,2
28358,4,19,14,33,False,4,2
28359,5,110,43,153,False,4,2
28360,6,257,142,399,False,4,2
28361,7,373,193,566,False,4,2
28362,8,260,151,411,False,4,2
28363,9,243,177,420,False,4,2
28364,10,229,212,441,False,4,2
28365,11,221,222,443,False,4,2
28366,12,216,211,427,False,4,2
28367,13,237,286,523,False,4,2
28368,14,267,338,605,False,4,2
28369,15,215,296,511,False,4,2
28370,16,144,186,330,False,4,2
28371,17,131,140,271,False,4,2
28372,18,121,138,259,False,4,2
28373,19,101,104,205,False,4,2
28374,20,61,106,167,False,4,2
28375,21,46,79,125,False,4,2
28376,22,36,61,97,False,4,2
28377,23,32,33,65,False,4,2
28378,0,21,36,57,False,5,2
28379,1,22,36,58,False,5,2
28380,2,13,32,45,False,5,2
28381,3,9,25,34,False,5,2
28382,4,10,14,24,False,5,2
28383,5,25,17,42,False,5,2
28384,6,22,21,43,False,5,2
28385,7,44,35,79,False,5,2
28386,8,60,56,116,False,5,2
28387,9,100,83,183,False,5,2
28388,10,98,97,195,False,5,2
28389,11,153,127,280,False,5,2
28390,12,143,158,301,False,5,2
28391,13,168,174,342,False,5,2
28392,14,151,177,328,False,5,2
28393,15,127,165,292,False,5,2
28394,16,115,140,255,False,5,2
28395,17,127,151,278,False,5,2
28396,18,113,124,237,False,5,2
28397,19,73,83,156,False,5,2
28398,20,56,74,130,False,5,2
28399,21,48,61,109,False,5,2
28400,22,52,76,128,False,5,2
28401,23,31,56,87,False,5,2
28402,0,35,50,85,True,6,2
28403,1,19,44,63,True,6,2
28404,2,23,53,76,True,6,2
28405,3,22,44,66,True,6,2
28406,4,6,19,25,True,6,2
28407,5,12,20,32,True,6,2
28408,6,26,15,41,True,6,2
28409,7,31,25,56,True,6,2
28410,8,42,33,75,True,6,2
28411,9,109,60,169,True,6,2
28412,10,129,102,231,True,6,2
28413,11,163,154,317,True,6,2
28414,12,135,176,311,True,6,2
28415,13,157,171,328,True,6,2
28416,14,166,183,349,True,6,2
28417,15,137,210,347,True,6,2
28418,16,156,179,335,True,6,2
28419,17,152,137,289,True,6,2
28420,18,121,133,254,True,6,2
28421,19,121,131,252,True,6,2
28422,20,88,111,199,True,6,2
28423,21,35,73,108,True,6,2
28424,22,35,36,71,True,6,2
28425,23,17,19,36,True,6,2
28426,0,8,9,17,False,0,2
28427,1,7,9,16,False,0,2
28428,2,5,9,14,False,0,2
28429,3,7,6,13,False,0,2
28430,4,25,13,38,False,0,2
28431,5,115,57,172,False,0,2
28432,6,237,148,385,False,0,2
28433,7,386,195,581,False,0,2
28434,8,244,149,393,False,0,2
28435,9,216,173,389,False,0,2
28436,10,207,181,388,False,0,2
28437,11,191,207,398,False,0,2
28438,12,183,201,384,False,0,2
28439,13,188,257,445,False,0,2
28440,14,207,303,510,False,0,2
28441,15,210,303,513,False,0,2
28442,16,221,190,411,False,0,2
28443,17,162,169,331,False,0,2
28444,18,118,142,260,False,0,2
28445,19,104,156,260,False,0,2
28446,20,72,103,175,False,0,2
28447,21,57,74,131,False,0,2
28448,22,27,43,70,False,0,2
28449,23,13,19,32,False,0,2
28450,0,8,13,21,False,1,2
28451,1,4,14,18,False,1,2
28452,2,5,9,14,False,1,2
28453,3,9,7,16,False,1,2
28454,4,24,7,31,False,1,2
28455,5,120,51,171,False,1,2
28456,6,251,156,407,False,1,2
28457,7,434,180,614,False,1,2
28458,8,243,157,400,False,1,2
28459,9,193,165,358,False,1,2
28460,10,206,173,379,False,1,2
28461,11,193,201,394,False,1,2
28462,12,168,193,361,False,1,2
28463,13,199,268,467,False,1,2
28464,14,244,333,577,False,1,2
28465,15,211,318,529,False,1,2
28466,16,212,191,403,False,1,2
28467,17,187,151,338,False,1,2
28468,18,149,139,288,False,1,2
28469,19,102,114,216,False,1,2
28470,20,66,121,187,False,1,2
28471,21,58,337,395,False,1,2
28472,22,35,174,209,False,1,2
28473,23,11,76,87,False,1,2
28474,0,8,50,58,False,2,2
28475,1,7,31,38,False,2,2
28476,2,3,32,35,False,2,2
28477,3,4,36,40,False,2,2
28478,4,22,35,57,False,2,2
28479,5,112,54,166,False,2,2
28480,6,260,142,402,False,2,2
28481,7,413,191,604,False,2,2
28482,8,248,173,421,False,2,2
28483,9,236,167,403,False,2,2
28484,10,206,169,375,False,2,2
28485,11,224,201,425,False,2,2
28486,12,217,222,439,False,2,2
28487,13,196,259,455,False,2,2
28488,14,223,329,552,False,2,2
28489,15,256,307,563,False,2,2
28490,16,192,208,400,False,2,2
28491,17,153,188,341,False,2,2
28492,18,137,159,296,False,2,2
28493,19,116,117,233,False,2,2
28494,20,82,108,190,False,2,2
28495,21,85,86,171,False,2,2
28496,22,48,52,100,False,2,2
28497,23,18,14,32,False,2,2
28498,0,15,17,32,False,3,2
28499,1,4,13,17,False,3,2
28500,2,9,14,23,False,3,2
28501,3,13,11,24,False,3,2
28502,4,22,12,34,False,3,2
28503,5,119,46,165,False,3,2
28504,6,253,129,382,False,3,2
28505,7,462,198,660,False,3,2
28506,8,263,174,437,False,3,2
28507,9,205,168,373,False,3,2
28508,10,196,177,373,False,3,2
28509,11,225,205,430,False,3,2
28510,12,195,221,416,False,3,2
28511,13,194,262,456,False,3,2
28512,14,271,339,610,False,3,2
28513,15,215,309,524,False,3,2
28514,16,202,203,405,False,3,2
28515,17,175,164,339,False,3,2
28516,18,155,166,321,False,3,2
28517,19,96,137,233,False,3,2
28518,20,77,119,196,False,3,2
28519,21,61,98,159,False,3,2
28520,22,27,47,74,False,3,2
28521,23,21,27,48,False,3,2
28522,0,11,24,35,False,4,2
28523,1,15,24,39,False,4,2
28524,2,6,25,31,False,4,2
28525,3,10,11,21,False,4,2
28526,4,23,6,29,False,4,2
28527,5,119,49,168,False,4,2
28528,6,248,150,398,False,4,2
28529,7,360,168,528,False,4,2
28530,8,255,158,413,False,4,2
28531,9,229,165,394,False,4,2
28532,10,234,199,433,False,4,2
28533,11,221,208,429,False,4,2
28534,12,192,211,403,False,4,2
28535,13,249,282,531,False,4,2
28536,14,278,345,623,False,4,2
28537,15,198,315,513,False,4,2
28538,16,153,158,311,False,4,2
28539,17,134,166,300,False,4,2
28540,18,144,138,282,False,4,2
28541,19,91,92,183,False,4,2
28542,20,59,82,141,False,4,2
28543,21,56,73,129,False,4,2
28544,22,36,54,90,False,4,2
28545,23,30,49,79,False,4,2
28546,0,18,42,60,False,5,2
28547,1,13,30,43,False,5,2
28548,2,15,40,55,False,5,2
28549,3,11,25,36,False,5,2
28550,4,10,15,25,False,5,2
28551,5,19,12,31,False,5,2
28552,6,29,31,60,False,5,2
28553,7,46,25,71,False,5,2
28554,8,94,43,137,False,5,2
28555,9,125,92,217,False,5,2
28556,10,147,130,277,False,5,2
28557,11,166,164,330,False,5,2
28558,12,146,178,324,False,5,2
28559,13,159,165,324,False,5,2
28560,14,165,212,377,False,5,2
28561,15,117,174,291,False,5,2
28562,16,120,146,266,False,5,2
28563,17,138,153,291,False,5,2
28564,18,89,118,207,False,5,2
28565,19,83,90,173,False,5,2
28566,20,62,63,125,False,5,2
28567,21,40,69,109,False,5,2
28568,22,50,67,117,False,5,2
28569,23,37,68,105,False,5,2
28570,0,33,44,77,True,6,2
28571,1,33,55,88,True,6,2
28572,2,18,53,71,True,6,2
28573,3,18,32,50,True,6,2
28574,4,12,9,21,True,6,2
28575,5,19,17,36,True,6,2
28576,6,22,21,43,True,6,2
28577,7,34,34,68,True,6,2
28578,8,88,53,141,True,6,2
28579,9,112,82,194,True,6,2
28580,10,160,135,295,True,6,2
28581,11,149,188,337,True,6,2
28582,12,182,194,376,True,6,2
28583,13,164,193,357,True,6,2
28584,14,152,228,380,True,6,2
28585,15,145,150,295,True,6,2
28586,16,123,148,271,True,6,2
28587,17,128,126,254,True,6,2
28588,18,110,153,263,True,6,2
28589,19,77,110,187,True,6,2
28590,20,61,80,141,True,6,2
28591,21,34,42,76,True,6,2
28592,22,14,18,32,True,6,2
28593,23,15,11,26,True,6,2
28594,0,10,14,24,False,0,3
28595,1,12,12,24,False,0,3
28596,2,6,7,13,False,0,3
28597,3,24,11,35,False,0,3
28598,4,101,60,161,False,0,3
28599,5,248,147,395,False,0,3
28600,6,400,193,593,False,0,3
28601,7,256,165,421,False,0,3
28602,8,201,153,354,False,0,3
28603,9,190,170,360,False,0,3
28604,10,187,157,344,False,0,3
28605,11,211,211,422,False,0,3
28606,12,221,253,474,False,0,3
28607,13,205,313,518,False,0,3
28608,14,198,281,479,False,0,3
28609,15,171,191,362,False,0,3
28610,16,169,170,339,False,0,3
28611,17,147,166,313,False,0,3
28612,18,99,142,241,False,0,3
28613,19,93,108,201,False,0,3
28614,20,52,65,117,False,0,3
28615,21,30,34,64,False,0,3
28616,22,13,14,27,False,0,3
28617,23,6,14,20,False,0,3
28618,0,8,7,15,False,1,3
28619,1,3,12,15,False,1,3
28620,2,9,5,14,False,1,3
28621,3,16,8,24,False,1,3
28622,4,100,53,153,False,1,3
28623,5,230,151,381,False,1,3
28624,6,370,174,544,False,1,3
28625,7,243,191,434,False,1,3
28626,8,227,181,408,False,1,3
28627,9,266,173,439,False,1,3
28628,10,198,197,395,False,1,3
28629,11,211,221,432,False,1,3
28630,12,210,245,455,False,1,3
28631,13,237,311,548,False,1,3
28632,14,231,322,553,False,1,3
28633,15,198,209,407,False,1,3
28634,16,171,152,323,False,1,3
28635,17,141,155,296,False,1,3
28636,18,107,161,268,False,1,3
28637,19,85,87,172,False,1,3
28638,20,43,102,145,False,1,3
28639,21,31,36,67,False,1,3
28640,22,12,19,31,False,1,3
28641,23,5,16,21,False,1,3
28642,0,8,10,18,False,2,3
28643,1,7,15,22,False,2,3
28644,2,4,3,7,False,2,3
28645,3,19,8,27,False,2,3
28646,4,111,52,163,False,2,3
28647,5,246,133,379,False,2,3
28648,6,416,202,618,False,2,3
28649,7,248,149,397,False,2,3
28650,8,226,152,378,False,2,3
28651,9,216,166,382,False,2,3
28652,10,221,212,433,False,2,3
28653,11,235,175,410,False,2,3
28654,12,211,262,473,False,2,3
28655,13,246,302,548,False,2,3
28656,14,211,328,539,False,2,3
28657,15,193,195,388,False,2,3
28658,16,136,159,295,False,2,3
28659,17,134,155,289,False,2,3
28660,18,96,117,213,False,2,3
28661,19,71,113,184,False,2,3
28662,20,66,88,154,False,2,3
28663,21,40,64,104,False,2,3
28664,22,23,16,39,False,2,3
28665,23,14,17,31,False,2,3
28666,0,10,13,23,False,3,3
28667,1,6,24,30,False,3,3
28668,2,12,11,23,False,3,3
28669,3,16,12,28,False,3,3
28670,4,96,46,142,False,3,3
28671,5,219,137,356,False,3,3
28672,6,416,204,620,False,3,3
28673,7,269,162,431,False,3,3
28674,8,252,175,427,False,3,3
28675,9,192,182,374,False,3,3
28676,10,196,222,418,False,3,3
28677,11,202,217,419,False,3,3
28678,12,242,248,490,False,3,3
28679,13,234,343,577,False,3,3
28680,14,214,277,491,False,3,3
28681,15,168,181,349,False,3,3
28682,16,157,179,336,False,3,3
28683,17,128,165,293,False,3,3
28684,18,117,133,250,False,3,3
28685,19,81,118,199,False,3,3
28686,20,62,93,155,False,3,3
28687,21,39,46,85,False,3,3
28688,22,13,27,40,False,3,3
28689,23,17,18,35,False,3,3
28690,0,4,29,33,False,4,3
28691,1,3,21,24,False,4,3
28692,2,6,13,19,False,4,3
28693,3,22,11,33,False,4,3
28694,4,97,41,138,False,4,3
28695,5,221,137,358,False,4,3
28696,6,389,174,563,False,4,3
28697,7,211,136,347,False,4,3
28698,8,210,151,361,False,4,3
28699,9,192,165,357,False,4,3
28700,10,206,214,420,False,4,3
28701,11,233,229,462,False,4,3
28702,12,233,300,533,False,4,3
28703,13,264,336,600,False,4,3
28704,14,194,262,456,False,4,3
28705,15,138,196,334,False,4,3
28706,16,161,149,310,False,4,3
28707,17,130,137,267,False,4,3
28708,18,91,113,204,False,4,3
28709,19,69,71,140,False,4,3
28710,20,62,67,129,False,4,3
28711,21,50,52,102,False,4,3
28712,22,37,37,74,False,4,3
28713,23,27,41,68,False,4,3
28714,0,22,35,57,False,5,3
28715,1,13,44,57,False,5,3
28716,2,7,16,23,False,5,3
28717,3,11,18,29,False,5,3
28718,4,20,9,29,False,5,3
28719,5,28,28,56,False,5,3
28720,6,57,43,100,False,5,3
28721,7,63,60,123,False,5,3
28722,8,86,79,165,False,5,3
28723,9,117,92,209,False,5,3
28724,10,163,117,280,False,5,3
28725,11,141,157,298,False,5,3
28726,12,173,168,341,False,5,3
28727,13,129,159,288,False,5,3
28728,14,145,161,306,False,5,3
28729,15,134,176,310,False,5,3
28730,16,110,148,258,False,5,3
28731,17,92,122,214,False,5,3
28732,18,96,101,197,False,5,3
28733,19,70,70,140,False,5,3
28734,20,47,75,122,False,5,3
28735,21,36,59,95,False,5,3
28736,22,25,50,75,False,5,3
28737,23,30,41,71,False,5,3
28738,0,25,54,79,True,6,3
28739,1,24,52,76,True,6,3
28740,2,19,37,56,True,6,3
28741,3,8,12,20,True,6,3
28742,4,10,14,24,True,6,3
28743,5,18,18,36,True,6,3
28744,6,36,17,53,True,6,3
28745,7,53,41,94,True,6,3
28746,8,97,71,168,True,6,3
28747,9,125,74,199,True,6,3
28748,10,146,124,270,True,6,3
28749,11,143,174,317,True,6,3
28750,12,170,152,322,True,6,3
28751,13,160,157,317,True,6,3
28752,14,155,232,387,True,6,3
28753,15,167,191,358,True,6,3
28754,16,138,170,308,True,6,3
28755,17,124,224,348,True,6,3
28756,18,100,137,237,True,6,3
28757,19,89,92,181,True,6,3
28758,20,120,74,194,True,6,3
28759,21,27,33,60,True,6,3
28760,22,18,20,38,True,6,3
28761,23,12,11,23,True,6,3
28762,0,4,10,14,False,0,3
28763,1,6,8,14,False,0,3
28764,2,3,9,12,False,0,3
28765,3,24,10,34,False,0,3
28766,4,111,50,161,False,0,3
28767,5,224,153,377,False,0,3
28768,6,380,190,570,False,0,3
28769,7,253,139,392,False,0,3
28770,8,209,144,353,False,0,3
28771,9,202,195,397,False,0,3
28772,10,202,214,416,False,0,3
28773,11,192,176,368,False,0,3
28774,12,194,270,464,False,0,3
28775,13,251,274,525,False,0,3
28776,14,284,337,621,False,0,3
28777,15,180,194,374,False,0,3
28778,16,159,156,315,False,0,3
28779,17,129,175,304,False,0,3
28780,18,108,140,248,False,0,3
28781,19,71,103,174,False,0,3
28782,20,67,110,177,False,0,3
28783,21,29,30,59,False,0,3
28784,22,16,24,40,False,0,3
28785,23,12,15,27,False,0,3
28786,0,10,5,15,False,1,3
28787,1,13,7,20,False,1,3
28788,2,13,14,27,False,1,3
28789,3,18,13,31,False,1,3
28790,4,116,33,149,False,1,3
28791,5,234,141,375,False,1,3
28792,6,418,192,610,False,1,3
28793,7,243,149,392,False,1,3
28794,8,226,201,427,False,1,3
28795,9,213,163,376,False,1,3
28796,10,192,226,418,False,1,3
28797,11,220,215,435,False,1,3
28798,12,208,272,480,False,1,3
28799,13,236,298,534,False,1,3
28800,14,202,297,499,False,1,3
28801,15,172,207,379,False,1,3
28802,16,211,165,376,False,1,3
28803,17,157,151,308,False,1,3
28804,18,121,161,282,False,1,3
28805,19,70,136,206,False,1,3
28806,20,66,83,149,False,1,3
28807,21,41,41,82,False,1,3
28808,22,15,18,33,False,1,3
28809,23,8,14,22,False,1,3
28810,0,7,12,19,False,2,3
28811,1,5,8,13,False,2,3
28812,2,2,5,7,False,2,3
28813,3,23,12,35,False,2,3
28814,4,112,49,161,False,2,3
28815,5,253,129,382,False,2,3
28816,6,372,169,541,False,2,3
28817,7,240,125,365,False,2,3
28818,8,231,165,396,False,2,3
28819,9,211,177,388,False,2,3
28820,10,227,189,416,False,2,3
28821,11,194,227,421,False,2,3
28822,12,227,286,513,False,2,3
28823,13,233,304,537,False,2,3
28824,14,209,285,494,False,2,3
28825,15,208,225,433,False,2,3
28826,16,153,150,303,False,2,3
28827,17,132,125,257,False,2,3
28828,18,145,134,279,False,2,3
28829,19,96,94,190,False,2,3
28830,20,47,60,107,False,2,3
28831,21,32,58,90,False,2,3
28832,22,18,14,32,False,2,3
28833,23,14,26,40,False,2,3
28834,0,13,12,25,False,3,3
28835,1,4,19,23,False,3,3
28836,2,9,14,23,False,3,3
28837,3,17,10,27,False,3,3
28838,4,110,52,162,False,3,3
28839,5,237,143,380,False,3,3
28840,6,404,194,598,False,3,3
28841,7,266,153,419,False,3,3
28842,8,205,175,380,False,3,3
28843,9,221,191,412,False,3,3
28844,10,198,207,405,False,3,3
28845,11,226,223,449,False,3,3
28846,12,214,246,460,False,3,3
28847,13,237,355,592,False,3,3
28848,14,214,298,512,False,3,3
28849,15,183,153,336,False,3,3
28850,16,178,182,360,False,3,3
28851,17,137,142,279,False,3,3
28852,18,94,147,241,False,3,3
28853,19,92,137,229,False,3,3
28854,20,78,94,172,False,3,3
28855,21,47,52,99,False,3,3
28856,22,18,20,38,False,3,3
28857,23,22,22,44,False,3,3
28858,0,15,28,43,False,4,3
28859,1,9,19,28,False,4,3
28860,2,19,10,29,False,4,3
28861,3,24,6,30,False,4,3
28862,4,95,47,142,False,4,3
28863,5,214,123,337,False,4,3
28864,6,399,208,607,False,4,3
28865,7,273,179,452,False,4,3
28866,8,224,184,408,False,4,3
28867,9,196,167,363,False,4,3
28868,10,240,233,473,False,4,3
28869,11,254,252,506,False,4,3
28870,12,257,288,545,False,4,3
28871,13,255,298,553,False,4,3
28872,14,194,273,467,False,4,3
28873,15,137,181,318,False,4,3
28874,16,143,144,287,False,4,3
28875,17,111,124,235,False,4,3
28876,18,94,90,184,False,4,3
28877,19,66,96,162,False,4,3
28878,20,62,68,130,False,4,3
28879,21,37,63,100,False,4,3
28880,22,28,37,65,False,4,3
28881,23,23,31,54,False,4,3
28882,0,14,30,44,False,5,3
28883,1,18,38,56,False,5,3
28884,2,15,25,40,False,5,3
28885,3,18,12,30,False,5,3
28886,4,22,19,41,False,5,3
28887,5,28,27,55,False,5,3
28888,6,38,35,73,False,5,3
28889,7,72,49,121,False,5,3
28890,8,81,79,160,False,5,3
28891,9,136,92,228,False,5,3
28892,10,127,116,243,False,5,3
28893,11,145,141,286,False,5,3
28894,12,132,126,258,False,5,3
28895,13,105,148,253,False,5,3
28896,14,124,136,260,False,5,3
28897,15,108,125,233,False,5,3
28898,16,101,115,216,False,5,3
28899,17,100,106,206,False,5,3
28900,18,69,85,154,False,5,3
28901,19,76,79,155,False,5,3
28902,20,41,67,108,False,5,3
28903,21,43,68,111,False,5,3
28904,22,26,41,67,False,5,3
28905,23,23,37,60,False,5,3
28906,0,32,54,86,True,6,3
28907,1,21,49,70,True,6,3
28908,2,7,30,37,True,6,3
28909,3,10,17,27,True,6,3
28910,4,15,12,27,True,6,3
28911,5,12,17,29,True,6,3
28912,6,41,10,51,True,6,3
28913,7,40,34,74,True,6,3
28914,8,69,51,120,True,6,3
28915,9,77,84,161,True,6,3
28916,10,118,102,220,True,6,3
28917,11,112,112,224,True,6,3
28918,12,138,133,271,True,6,3
28919,13,129,146,275,True,6,3
28920,14,110,160,270,True,6,3
28921,15,110,125,235,True,6,3
28922,16,111,124,235,True,6,3
28923,17,96,105,201,True,6,3
28924,18,104,121,225,True,6,3
28925,19,68,97,165,True,6,3
28926,20,39,65,104,True,6,3
28927,21,33,38,71,True,6,3
28928,22,24,33,57,True,6,3
28929,23,15,19,34,True,6,3
28930,0,11,16,27,False,0,3
28931,1,7,15,22,False,0,3
28932,2,9,9,18,False,0,3
28933,3,17,10,27,False,0,3
28934,4,58,42,100,False,0,3
28935,5,150,87,237,False,0,3
28936,6,179,117,296,False,0,3
28937,7,185,114,299,False,0,3
28938,8,158,124,282,False,0,3
28939,9,177,159,336,False,0,3
28940,10,151,147,298,False,0,3
28941,11,157,166,323,False,0,3
28942,12,173,194,367,False,0,3
28943,13,191,217,408,False,0,3
28944,14,133,181,314,False,0,3
28945,15,112,136,248,False,0,3
28946,16,103,130,233,False,0,3
28947,17,81,96,177,False,0,3
28948,18,80,98,178,False,0,3
28949,19,90,80,170,False,0,3
28950,20,47,57,104,False,0,3
28951,21,29,48,77,False,0,3
28952,22,19,22,41,False,0,3
28953,23,10,16,26,False,0,3
28954,0,8,10,18,False,1,3
28955,1,6,8,14,False,1,3
28956,2,9,20,29,False,1,3
28957,3,12,10,22,False,1,3
28958,4,63,39,102,False,1,3
28959,5,121,72,193,False,1,3
28960,6,176,92,268,False,1,3
28961,7,163,108,271,False,1,3
28962,8,137,134,271,False,1,3
28963,9,177,125,302,False,1,3
28964,10,126,164,290,False,1,3
28965,11,163,163,326,False,1,3
28966,12,152,163,315,False,1,3
28967,13,175,206,381,False,1,3
28968,14,134,181,315,False,1,3
28969,15,126,116,242,False,1,3
28970,16,107,101,208,False,1,3
28971,17,93,116,209,False,1,3
28972,18,79,80,159,False,1,3
28973,19,66,73,139,False,1,3
28974,20,38,140,178,False,1,3
28975,21,39,151,190,False,1,3
28976,22,20,63,83,False,1,3
28977,23,5,36,41,False,1,3
28978,0,14,12,26,False,2,3
28979,1,18,13,31,False,2,3
28980,2,11,7,18,False,2,3
28981,3,12,10,22,False,2,3
28982,4,52,22,74,False,2,3
28983,5,111,53,164,False,2,3
28984,6,110,61,171,False,2,3
28985,7,117,91,208,False,2,3
28986,8,124,104,228,False,2,3
28987,9,169,118,287,False,2,3
28988,10,162,168,330,False,2,3
28989,11,133,134,267,False,2,3
28990,12,129,132,261,False,2,3
28991,13,109,143,252,False,2,3
28992,14,105,118,223,False,2,3
28993,15,109,101,210,False,2,3
28994,16,100,102,202,False,2,3
28995,17,94,100,194,False,2,3
28996,18,68,75,143,False,2,3
28997,19,62,77,139,False,2,3
28998,20,33,43,76,False,2,3
28999,21,31,43,74,False,2,3
29000,22,22,35,57,False,2,3
29001,23,11,16,27,False,2,3
29002,0,11,21,32,True,3,3
29003,1,10,21,31,True,3,3
29004,2,2,16,18,True,3,3
29005,3,9,8,17,True,3,3
29006,4,8,9,17,True,3,3
29007,5,16,17,33,True,3,3
29008,6,19,20,39,True,3,3
29009,7,31,33,64,True,3,3
29010,8,44,40,84,True,3,3
29011,9,75,73,148,True,3,3
29012,10,84,89,173,True,3,3
29013,11,89,94,183,True,3,3
29014,12,82,115,197,True,3,3
29015,13,89,119,208,True,3,3
29016,14,89,107,196,True,3,3
29017,15,81,105,186,True,3,3
29018,16,97,75,172,True,3,3
29019,17,88,103,191,True,3,3
29020,18,67,87,154,True,3,3
29021,19,60,65,125,True,3,3
29022,20,39,47,86,True,3,3
29023,21,20,45,65,True,3,3
29024,22,17,30,47,True,3,3
29025,23,13,18,31,True,3,3
29026,0,13,25,38,True,4,3
29027,1,5,19,24,True,4,3
29028,2,5,21,26,True,4,3
29029,3,6,7,13,True,4,3
29030,4,9,8,17,True,4,3
29031,5,21,15,36,True,4,3
29032,6,18,19,37,True,4,3
29033,7,31,29,60,True,4,3
29034,8,55,37,92,True,4,3
29035,9,67,63,130,True,4,3
29036,10,78,73,151,True,4,3
29037,11,80,97,177,True,4,3
29038,12,109,107,216,True,4,3
29039,13,89,125,214,True,4,3
29040,14,108,115,223,True,4,3
29041,15,80,127,207,True,4,3
29042,16,95,106,201,True,4,3
29043,17,72,102,174,True,4,3
29044,18,75,87,162,True,4,3
29045,19,54,75,129,True,4,3
29046,20,54,72,126,True,4,3
29047,21,26,37,63,True,4,3
29048,22,22,30,52,True,4,3
29049,23,19,33,52,True,4,3
29050,0,12,29,41,False,5,3
29051,1,5,36,41,False,5,3
29052,2,11,13,24,False,5,3
29053,3,9,11,20,False,5,3
29054,4,13,11,24,False,5,3
29055,5,14,16,30,False,5,3
29056,6,27,17,44,False,5,3
29057,7,44,43,87,False,5,3
29058,8,96,72,168,False,5,3
29059,9,95,105,200,False,5,3
29060,10,77,95,172,False,5,3
29061,11,80,97,177,False,5,3
29062,12,79,107,186,False,5,3
29063,13,96,106,202,False,5,3
29064,14,68,98,166,False,5,3
29065,15,96,85,181,False,5,3
29066,16,84,92,176,False,5,3
29067,17,89,84,173,False,5,3
29068,18,71,91,162,False,5,3
29069,19,50,67,117,False,5,3
29070,20,34,57,91,False,5,3
29071,21,37,41,78,False,5,3
29072,22,24,56,80,False,5,3
29073,23,26,28,54,False,5,3
29074,0,19,24,43,True,6,3
29075,1,20,34,54,True,6,3
29076,2,7,17,24,True,6,3
29077,3,9,9,18,True,6,3
29078,4,12,10,22,True,6,3
29079,5,12,12,24,True,6,3
29080,6,23,14,37,True,6,3
29081,7,54,29,83,True,6,3
29082,8,57,69,126,True,6,3
29083,9,61,56,117,True,6,3
29084,10,70,88,158,True,6,3
29085,11,108,114,222,True,6,3
29086,12,108,118,226,True,6,3
29087,13,86,108,194,True,6,3
29088,14,93,125,218,True,6,3
29089,15,97,107,204,True,6,3
29090,16,105,99,204,True,6,3
29091,17,96,118,214,True,6,3
29092,18,101,102,203,True,6,3
29093,19,63,87,150,True,6,3
29094,20,46,79,125,True,6,3
29095,21,39,44,83,True,6,3
29096,22,21,43,64,True,6,3
29097,23,11,22,33,True,6,3
29098,0,7,19,26,True,0,3
29099,1,13,25,38,True,0,3
29100,2,4,11,15,True,0,3
29101,3,8,4,12,True,0,3
29102,4,11,9,20,True,0,3
29103,5,13,12,25,True,0,3
29104,6,22,19,41,True,0,3
29105,7,49,33,82,True,0,3
29106,8,75,51,126,True,0,3
29107,9,84,84,168,True,0,3
29108,10,126,113,239,True,0,3
29109,11,129,119,248,True,0,3
29110,12,136,139,275,True,0,3
29111,13,124,151,275,True,0,3
29112,14,134,136,270,True,0,3
29113,15,133,152,285,True,0,3
29114,16,140,155,295,True,0,3
29115,17,128,195,323,True,0,3
29116,18,106,125,231,True,0,3
29117,19,90,91,181,True,0,3
29118,20,127,83,210,True,0,3
29119,21,30,44,74,True,0,3
29120,22,18,17,35,True,0,3
29121,23,7,11,18,True,0,3
29122,0,6,20,26,False,1,3
29123,1,4,8,12,False,1,3
29124,2,7,4,11,False,1,3
29125,3,28,17,45,False,1,3
29126,4,100,42,142,False,1,3
29127,5,227,136,363,False,1,3
29128,6,397,179,576,False,1,3
29129,7,263,181,444,False,1,3
29130,8,201,158,359,False,1,3
29131,9,214,173,387,False,1,3
29132,10,195,177,372,False,1,3
29133,11,199,194,393,False,1,3
29134,12,241,256,497,False,1,3
29135,13,259,329,588,False,1,3
29136,14,277,430,707,False,1,3
29137,15,172,167,339,False,1,3
29138,16,197,174,371,False,1,3
29139,17,141,131,272,False,1,3
29140,18,105,143,248,False,1,3
29141,19,93,135,228,False,1,3
29142,20,59,217,276,False,1,3
29143,21,39,135,174,False,1,3
29144,22,31,17,48,False,1,3
29145,23,7,9,16,False,1,3
29146,0,5,5,10,False,2,3
29147,1,10,1,11,False,2,3
29148,2,7,5,12,False,2,3
29149,3,23,11,34,False,2,3
29150,4,103,48,151,False,2,3
29151,5,214,144,358,False,2,3
29152,6,382,156,538,False,2,3
29153,7,267,155,422,False,2,3
29154,8,233,173,406,False,2,3
29155,9,229,172,401,False,2,3
29156,10,218,208,426,False,2,3
29157,11,226,204,430,False,2,3
29158,12,199,244,443,False,2,3
29159,13,249,321,570,False,2,3
29160,14,215,331,546,False,2,3
29161,15,180,209,389,False,2,3
29162,16,170,156,326,False,2,3
29163,17,127,171,298,False,2,3
29164,18,129,120,249,False,2,3
29165,19,91,140,231,False,2,3
29166,20,61,76,137,False,2,3
29167,21,31,54,85,False,2,3
29168,22,22,25,47,False,2,3
29169,23,13,14,27,False,2,3
29170,0,4,12,16,False,3,3
29171,1,10,9,19,False,3,3
29172,2,8,13,21,False,3,3
29173,3,15,13,28,False,3,3
29174,4,119,52,171,False,3,3
29175,5,222,145,367,False,3,3
29176,6,377,224,601,False,3,3
29177,7,284,150,434,False,3,3
29178,8,204,165,369,False,3,3
29179,9,215,186,401,False,3,3
29180,10,184,194,378,False,3,3
29181,11,207,170,377,False,3,3
29182,12,206,260,466,False,3,3
29183,13,295,329,624,False,3,3
29184,14,212,308,520,False,3,3
29185,15,184,196,380,False,3,3
29186,16,173,163,336,False,3,3
29187,17,156,147,303,False,3,3
29188,18,133,130,263,False,3,3
29189,19,99,120,219,False,3,3
29190,20,60,86,146,False,3,3
29191,21,37,60,97,False,3,3
29192,22,21,37,58,False,3,3
29193,23,18,10,28,False,3,3
29194,0,14,10,24,False,4,3
29195,1,7,15,22,False,4,3
29196,2,18,11,29,False,4,3
29197,3,31,12,43,False,4,3
29198,4,103,44,147,False,4,3
29199,5,255,127,382,False,4,3
29200,6,358,178,536,False,4,3
29201,7,250,160,410,False,4,3
29202,8,238,157,395,False,4,3
29203,9,248,194,442,False,4,3
29204,10,227,199,426,False,4,3
29205,11,247,229,476,False,4,3
29206,12,265,364,629,False,4,3
29207,13,287,453,740,False,4,3
29208,14,245,279,524,False,4,3
29209,15,177,194,371,False,4,3
29210,16,165,162,327,False,4,3
29211,17,137,138,275,False,4,3
29212,18,115,101,216,False,4,3
29213,19,88,124,212,False,4,3
29214,20,48,80,128,False,4,3
29215,21,34,68,102,False,4,3
29216,22,31,29,60,False,4,3
29217,23,18,26,44,False,4,3
29218,0,19,20,39,False,5,3
29219,1,19,27,46,False,5,3
29220,2,13,9,22,False,5,3
29221,3,7,13,20,False,5,3
29222,4,32,15,47,False,5,3
29223,5,37,30,67,False,5,3
29224,6,62,37,99,False,5,3
29225,7,91,50,141,False,5,3
29226,8,97,55,152,False,5,3
29227,9,154,81,235,False,5,3
29228,10,122,88,210,False,5,3
29229,11,169,119,288,False,5,3
29230,12,172,119,291,False,5,3
29231,13,131,135,266,False,5,3
29232,14,144,134,278,False,5,3
29233,15,122,127,249,False,5,3
29234,16,127,150,277,False,5,3
29235,17,132,122,254,False,5,3
29236,18,75,76,151,False,5,3
29237,19,70,75,145,False,5,3
29238,20,59,59,118,False,5,3
29239,21,70,58,128,False,5,3
29240,22,49,47,96,False,5,3
29241,23,35,35,70,False,5,3
29242,0,25,25,50,True,6,3
29243,1,27,37,64,True,6,3
29244,2,9,24,33,True,6,3
29245,3,11,11,22,True,6,3
29246,4,13,8,21,True,6,3
29247,5,18,13,31,True,6,3
29248,6,35,14,49,True,6,3
29249,7,59,42,101,True,6,3
29250,8,100,59,159,True,6,3
29251,9,103,83,186,True,6,3
29252,10,186,136,322,True,6,3
29253,11,191,155,346,True,6,3
29254,12,206,180,386,True,6,3
29255,13,146,153,299,True,6,3
29256,14,207,213,420,True,6,3
29257,15,177,197,374,True,6,3
29258,16,145,188,333,True,6,3
29259,17,138,174,312,True,6,3
29260,18,112,151,263,True,6,3
29261,19,86,111,197,True,6,3
29262,20,63,84,147,True,6,3
29263,21,33,50,83,True,6,3
29264,22,14,25,39,True,6,3
29265,23,8,8,16,True,6,3
29266,0,7,13,20,False,0,3
29267,1,7,7,14,False,0,3
29268,2,9,6,15,False,0,3
29269,3,16,13,29,False,0,3
29270,4,110,51,161,False,0,3
29271,5,235,141,376,False,0,3
29272,6,401,208,609,False,0,3
29273,7,270,162,432,False,0,3
29274,8,229,151,380,False,0,3
29275,9,213,182,395,False,0,3
29276,10,210,227,437,False,0,3
29277,11,227,189,416,False,0,3
29278,12,212,248,460,False,0,3
29279,13,244,356,600,False,0,3
29280,14,246,364,610,False,0,3
29281,15,247,183,430,False,0,3
29282,16,166,177,343,False,0,3
29283,17,128,163,291,False,0,3
29284,18,118,144,262,False,0,3
29285,19,110,111,221,False,0,3
29286,20,68,89,157,False,0,3
29287,21,32,40,72,False,0,3
29288,22,23,37,60,False,0,3
29289,23,18,12,30,False,0,3
29290,0,12,6,18,False,1,3
29291,1,8,6,14,False,1,3
29292,2,7,7,14,False,1,3
29293,3,25,7,32,False,1,3
29294,4,114,51,165,False,1,3
29295,5,247,159,406,False,1,3
29296,6,385,206,591,False,1,3
29297,7,259,164,423,False,1,3
29298,8,232,170,402,False,1,3
29299,9,236,176,412,False,1,3
29300,10,244,200,444,False,1,3
29301,11,225,249,474,False,1,3
29302,12,229,276,505,False,1,3
29303,13,260,317,577,False,1,3
29304,14,249,320,569,False,1,3
29305,15,232,204,436,False,1,3
29306,16,185,169,354,False,1,3
29307,17,138,165,303,False,1,3
29308,18,120,142,262,False,1,3
29309,19,94,136,230,False,1,3
29310,20,77,62,139,False,1,3
29311,21,64,62,126,False,1,3
29312,22,40,35,75,False,1,3
29313,23,23,36,59,False,1,3
29314,0,27,31,58,True,2,4
29315,1,16,32,48,True,2,4
29316,2,14,16,30,True,2,4
29317,3,7,12,19,True,2,4
29318,4,20,8,28,True,2,4
29319,5,16,12,28,True,2,4
29320,6,30,16,46,True,2,4
29321,7,55,37,92,True,2,4
29322,8,87,64,151,True,2,4
29323,9,100,85,185,True,2,4
29324,10,134,120,254,True,2,4
29325,11,147,145,292,True,2,4
29326,12,144,136,280,True,2,4
29327,13,147,178,325,True,2,4
29328,14,157,154,311,True,2,4
29329,15,141,192,333,True,2,4
29330,16,130,145,275,True,2,4
29331,17,125,142,267,True,2,4
29332,18,115,125,240,True,2,4
29333,19,61,80,141,True,2,4
29334,20,39,63,102,True,2,4
29335,21,44,51,95,True,2,4
29336,22,16,20,36,True,2,4
29337,23,14,9,23,True,2,4
29338,0,5,8,13,False,3,4
29339,1,4,5,9,False,3,4
29340,2,10,7,17,False,3,4
29341,3,14,10,24,False,3,4
29342,4,93,46,139,False,3,4
29343,5,262,132,394,False,3,4
29344,6,405,226,631,False,3,4
29345,7,302,164,466,False,3,4
29346,8,205,145,350,False,3,4
29347,9,209,205,414,False,3,4
29348,10,214,216,430,False,3,4
29349,11,233,219,452,False,3,4
29350,12,205,251,456,False,3,4
29351,13,218,325,543,False,3,4
29352,14,226,334,560,False,3,4
29353,15,175,196,371,False,3,4
29354,16,156,168,324,False,3,4
29355,17,143,159,302,False,3,4
29356,18,119,137,256,False,3,4
29357,19,91,107,198,False,3,4
29358,20,64,74,138,False,3,4
29359,21,35,54,89,False,3,4
29360,22,17,17,34,False,3,4
29361,23,13,16,29,False,3,4
29362,0,9,17,26,False,4,4
29363,1,6,7,13,False,4,4
29364,2,8,6,14,False,4,4
29365,3,17,7,24,False,4,4
29366,4,101,51,152,False,4,4
29367,5,239,137,376,False,4,4
29368,6,379,197,576,False,4,4
29369,7,226,166,392,False,4,4
29370,8,208,145,353,False,4,4
29371,9,198,178,376,False,4,4
29372,10,223,219,442,False,4,4
29373,11,227,213,440,False,4,4
29374,12,242,251,493,False,4,4
29375,13,266,326,592,False,4,4
29376,14,199,259,458,False,4,4
29377,15,176,201,377,False,4,4
29378,16,161,152,313,False,4,4
29379,17,104,137,241,False,4,4
29380,18,93,135,228,False,4,4
29381,19,90,105,195,False,4,4
29382,20,63,62,125,False,4,4
29383,21,55,41,96,False,4,4
29384,22,29,35,64,False,4,4
29385,23,25,22,47,False,4,4
29386,0,18,19,37,False,5,4
29387,1,11,29,40,False,5,4
29388,2,7,12,19,False,5,4
29389,3,10,3,13,False,5,4
29390,4,24,10,34,False,5,4
29391,5,21,25,46,False,5,4
29392,6,39,36,75,False,5,4
29393,7,72,47,119,False,5,4
29394,8,102,72,174,False,5,4
29395,9,167,105,272,False,5,4
29396,10,166,141,307,False,5,4
29397,11,155,143,298,False,5,4
29398,12,188,185,373,False,5,4
29399,13,133,162,295,False,5,4
29400,14,136,188,324,False,5,4
29401,15,141,184,325,False,5,4
29402,16,116,122,238,False,5,4
29403,17,109,115,224,False,5,4
29404,18,85,137,222,False,5,4
29405,19,71,86,157,False,5,4
29406,20,51,60,111,False,5,4
29407,21,56,50,106,False,5,4
29408,22,41,54,95,False,5,4
29409,23,19,29,48,False,5,4
29410,0,27,21,48,True,6,4
29411,1,13,29,42,True,6,4
29412,2,13,23,36,True,6,4
29413,3,11,11,22,True,6,4
29414,4,15,5,20,True,6,4
29415,5,15,17,32,True,6,4
29416,6,33,21,54,True,6,4
29417,7,63,44,107,True,6,4
29418,8,95,79,174,True,6,4
29419,9,154,95,249,True,6,4
29420,10,163,168,331,True,6,4
29421,11,168,202,370,True,6,4
29422,12,245,202,447,True,6,4
29423,13,160,193,353,True,6,4
29424,14,177,232,409,True,6,4
29425,15,177,255,432,True,6,4
29426,16,148,151,299,True,6,4
29427,17,145,161,306,True,6,4
29428,18,164,195,359,True,6,4
29429,19,84,110,194,True,6,4
29430,20,55,63,118,True,6,4
29431,21,34,45,79,True,6,4
29432,22,19,30,49,True,6,4
29433,23,4,10,14,True,6,4
29434,0,6,6,12,False,0,4
29435,1,5,10,15,False,0,4
29436,2,8,4,12,False,0,4
29437,3,19,12,31,False,0,4
29438,4,120,53,173,False,0,4
29439,5,232,191,423,False,0,4
29440,6,414,203,617,False,0,4
29441,7,285,172,457,False,0,4
29442,8,105,69,174,False,0,4
29443,11,218,239,457,False,0,4
29444,12,227,235,462,False,0,4
29445,13,238,325,563,False,0,4
29446,14,191,295,486,False,0,4
29447,15,194,191,385,False,0,4
29448,16,166,178,344,False,0,4
29449,17,142,131,273,False,0,4
29450,18,105,137,242,False,0,4
29451,19,97,125,222,False,0,4
29452,20,45,104,149,False,0,4
29453,21,29,147,176,False,0,4
29454,22,18,32,50,False,0,4
29455,23,6,7,13,False,0,4
29456,0,8,10,18,False,1,4
29457,1,5,9,14,False,1,4
29458,2,8,6,14,False,1,4
29459,3,24,9,33,False,1,4
29460,4,116,52,168,False,1,4
29461,5,214,151,365,False,1,4
29462,6,385,192,577,False,1,4
29463,7,260,156,416,False,1,4
29464,8,208,167,375,False,1,4
29465,9,215,184,399,False,1,4
29466,10,226,188,414,False,1,4
29467,11,211,205,416,False,1,4
29468,12,233,238,471,False,1,4
29469,13,230,301,531,False,1,4
29470,14,218,315,533,False,1,4
29471,15,201,164,365,False,1,4
29472,16,182,167,349,False,1,4
29473,17,139,167,306,False,1,4
29474,18,103,138,241,False,1,4
29475,19,73,131,204,False,1,4
29476,20,37,74,111,False,1,4
29477,21,31,54,85,False,1,4
29478,22,12,20,32,False,1,4
29479,23,13,17,30,False,1,4
29480,0,8,12,20,False,2,4
29481,1,2,5,7,False,2,4
29482,2,9,8,17,False,2,4
29483,3,17,10,27,False,2,4
29484,4,106,52,158,False,2,4
29485,5,245,138,383,False,2,4
29486,6,390,165,555,False,2,4
29487,7,236,160,396,False,2,4
29488,8,230,182,412,False,2,4
29489,9,192,142,334,False,2,4
29490,10,188,207,395,False,2,4
29491,11,251,195,446,False,2,4
29492,12,211,256,467,False,2,4
29493,13,217,284,501,False,2,4
29494,14,182,290,472,False,2,4
29495,15,174,189,363,False,2,4
29496,16,154,147,301,False,2,4
29497,17,126,168,294,False,2,4
29498,18,98,134,232,False,2,4
29499,19,91,130,221,False,2,4
29500,20,67,91,158,False,2,4
29501,21,49,49,98,False,2,4
29502,22,19,20,39,False,2,4
29503,23,15,22,37,False,2,4
29504,0,11,14,25,False,3,4
29505,1,14,11,25,False,3,4
29506,2,21,9,30,False,3,4
29507,3,20,8,28,False,3,4
29508,4,116,53,169,False,3,4
29509,5,240,130,370,False,3,4
29510,6,393,210,603,False,3,4
29511,7,249,154,403,False,3,4
29512,8,232,158,390,False,3,4
29513,9,207,166,373,False,3,4
29514,10,239,183,422,False,3,4
29515,11,216,185,401,False,3,4
29516,12,219,229,448,False,3,4
29517,13,224,301,525,False,3,4
29518,14,265,307,572,False,3,4
29519,15,175,211,386,False,3,4
29520,16,172,145,317,False,3,4
29521,17,130,144,274,False,3,4
29522,18,119,118,237,False,3,4
29523,19,88,125,213,False,3,4
29524,20,65,89,154,False,3,4
29525,21,47,40,87,False,3,4
29526,22,22,25,47,False,3,4
29527,23,10,23,33,False,3,4
29528,0,10,14,24,False,4,4
29529,1,8,16,24,False,4,4
29530,2,14,10,24,False,4,4
29531,3,15,5,20,False,4,4
29532,4,103,57,160,False,4,4
29533,5,206,114,320,False,4,4
29534,6,399,180,579,False,4,4
29535,7,253,133,386,False,4,4
29536,8,205,183,388,False,4,4
29537,9,245,202,447,False,4,4
29538,10,213,242,455,False,4,4
29539,11,222,205,427,False,4,4
29540,12,241,263,504,False,4,4
29541,13,267,410,677,False,4,4
29542,14,239,321,560,False,4,4
29543,15,175,215,390,False,4,4
29544,16,162,181,343,False,4,4
29545,17,107,145,252,False,4,4
29546,18,86,103,189,False,4,4
29547,19,87,117,204,False,4,4
29548,20,44,68,112,False,4,4
29549,21,48,54,102,False,4,4
29550,22,21,43,64,False,4,4
29551,23,37,45,82,False,4,4
29552,0,28,25,53,False,5,4
29553,1,10,17,27,False,5,4
29554,2,10,15,25,False,5,4
29555,3,20,9,29,False,5,4
29556,4,23,11,34,False,5,4
29557,5,24,21,45,False,5,4
29558,6,45,39,84,False,5,4
29559,7,63,37,100,False,5,4
29560,8,98,78,176,False,5,4
29561,9,143,97,240,False,5,4
29562,10,144,135,279,False,5,4
29563,11,148,151,299,False,5,4
29564,12,148,164,312,False,5,4
29565,13,124,157,281,False,5,4
29566,14,139,150,289,False,5,4
29567,15,139,143,282,False,5,4
29568,16,132,265,397,False,5,4
29569,17,115,154,269,False,5,4
29570,18,73,95,168,False,5,4
29571,19,58,91,149,False,5,4
29572,20,58,54,112,False,5,4
29573,21,38,59,97,False,5,4
29574,22,30,45,75,False,5,4
29575,23,28,25,53,False,5,4
29576,0,17,14,31,True,6,4
29577,1,25,34,59,True,6,4
29578,2,16,31,47,True,6,4
29579,3,13,12,25,True,6,4
29580,4,18,10,28,True,6,4
29581,5,16,15,31,True,6,4
29582,6,39,16,55,True,6,4
29583,7,49,42,91,True,6,4
29584,8,107,63,170,True,6,4
29585,9,113,98,211,True,6,4
29586,10,162,145,307,True,6,4
29587,11,142,164,306,True,6,4
29588,12,151,174,325,True,6,4
29589,13,161,185,346,True,6,4
29590,14,126,159,285,True,6,4
29591,15,163,193,356,True,6,4
29592,16,163,143,306,True,6,4
29593,17,155,144,299,True,6,4
29594,18,99,146,245,True,6,4
29595,19,84,123,207,True,6,4
29596,20,59,61,120,True,6,4
29597,21,46,44,90,True,6,4
29598,22,24,29,53,True,6,4
29599,23,9,7,16,True,6,4
29600,0,10,8,18,False,0,4
29601,1,5,9,14,False,0,4
29602,2,9,3,12,False,0,4
29603,3,24,6,30,False,0,4
29604,4,102,48,150,False,0,4
29605,5,205,132,337,False,0,4
29606,6,374,184,558,False,0,4
29607,7,264,155,419,False,0,4
29608,8,213,147,360,False,0,4
29609,9,203,155,358,False,0,4
29610,10,208,212,420,False,0,4
29611,11,189,190,379,False,0,4
29612,12,204,249,453,False,0,4
29613,13,244,288,532,False,0,4
29614,14,176,292,468,False,0,4
29615,15,169,183,352,False,0,4
29616,16,150,172,322,False,0,4
29617,17,133,134,267,False,0,4
29618,18,115,137,252,False,0,4
29619,19,99,143,242,False,0,4
29620,20,63,69,132,False,0,4
29621,21,32,31,63,False,0,4
29622,22,17,28,45,False,0,4
29623,23,9,12,21,False,0,4
29624,0,5,12,17,False,1,4
29625,1,7,14,21,False,1,4
29626,2,5,4,9,False,1,4
29627,3,17,12,29,False,1,4
29628,4,109,56,165,False,1,4
29629,5,256,139,395,False,1,4
29630,6,387,195,582,False,1,4
29631,7,263,172,435,False,1,4
29632,8,220,198,418,False,1,4
29633,9,228,175,403,False,1,4
29634,10,217,198,415,False,1,4
29635,11,243,221,464,False,1,4
29636,12,228,248,476,False,1,4
29637,13,237,302,539,False,1,4
29638,14,228,308,536,False,1,4
29639,15,205,226,431,False,1,4
29640,16,158,177,335,False,1,4
29641,17,145,144,289,False,1,4
29642,18,107,139,246,False,1,4
29643,19,78,123,201,False,1,4
29644,20,52,99,151,False,1,4
29645,21,48,48,96,False,1,4
29646,22,26,28,54,False,1,4
29647,23,8,16,24,False,1,4
29648,0,4,14,18,False,2,4
29649,1,9,6,15,False,2,4
29650,2,14,7,21,False,2,4
29651,3,23,7,30,False,2,4
29652,4,109,48,157,False,2,4
29653,5,250,142,392,False,2,4
29654,6,399,201,600,False,2,4
29655,7,253,152,405,False,2,4
29656,8,209,155,364,False,2,4
29657,9,195,190,385,False,2,4
29658,10,239,209,448,False,2,4
29659,11,224,233,457,False,2,4
29660,12,235,227,462,False,2,4
29661,13,240,334,574,False,2,4
29662,14,225,333,558,False,2,4
29663,15,202,227,429,False,2,4
29664,16,189,168,357,False,2,4
29665,17,147,179,326,False,2,4
29666,18,127,133,260,False,2,4
29667,19,106,158,264,False,2,4
29668,20,79,245,324,False,2,4
29669,21,41,143,184,False,2,4
29670,22,25,61,86,False,2,4
29671,23,20,48,68,False,2,4
29672,0,17,50,67,False,3,4
29673,1,9,32,41,False,3,4
29674,2,6,34,40,False,3,4
29675,3,19,34,53,False,3,4
29676,4,112,47,159,False,3,4
29677,5,245,145,390,False,3,4
29678,6,408,199,607,False,3,4
29679,7,269,159,428,False,3,4
29680,8,241,174,415,False,3,4
29681,9,243,202,445,False,3,4
29682,10,255,236,491,False,3,4
29683,11,237,223,460,False,3,4
29684,12,262,292,554,False,3,4
29685,13,267,344,611,False,3,4
29686,14,245,422,667,False,3,4
29687,15,209,351,560,False,3,4
29688,16,160,208,368,False,3,4
29689,17,156,179,335,False,3,4
29690,18,188,141,329,False,3,4
29691,19,109,141,250,False,3,4
29692,20,87,100,187,False,3,4
29693,21,70,69,139,False,3,4
29694,22,35,41,76,False,3,4
29695,23,27,24,51,False,3,4
29696,0,26,20,46,True,4,4
29697,1,18,19,37,True,4,4
29698,2,6,13,19,True,4,4
29699,3,21,15,36,True,4,4
29700,4,32,28,60,True,4,4
29701,5,94,56,150,True,4,4
29702,6,152,140,292,True,4,4
29703,7,285,186,471,True,4,4
29704,8,575,148,723,True,4,4
29705,9,260,170,430,True,4,4
29706,10,118,256,374,True,4,4
29707,11,127,394,521,True,4,4
29708,12,116,286,402,True,4,4
29709,13,117,214,331,True,4,4
29710,14,80,157,237,True,4,4
29711,15,105,133,238,True,4,4
29712,16,131,123,254,True,4,4
29713,17,111,102,213,True,4,4
29714,18,101,108,209,True,4,4
29715,19,115,105,220,True,4,4
29716,20,126,87,213,True,4,4
29717,21,66,104,170,True,4,4
29718,22,38,57,95,True,4,4
29719,23,26,41,67,True,4,4
29720,0,36,30,66,False,5,4
29721,1,22,27,49,False,5,4
29722,2,20,21,41,False,5,4
29723,3,14,9,23,False,5,4
29724,4,15,10,25,False,5,4
29725,5,23,23,46,False,5,4
29726,6,27,18,45,False,5,4
29727,7,53,42,95,False,5,4
29728,8,67,55,122,False,5,4
29729,9,93,109,202,False,5,4
29730,10,133,105,238,False,5,4
29731,11,152,130,282,False,5,4
29732,12,140,173,313,False,5,4
29733,13,118,147,265,False,5,4
29734,14,126,178,304,False,5,4
29735,15,122,136,258,False,5,4
29736,16,99,123,222,False,5,4
29737,17,90,111,201,False,5,4
29738,18,79,87,166,False,5,4
29739,19,81,90,171,False,5,4
29740,20,47,59,106,False,5,4
29741,21,32,56,88,False,5,4
29742,22,35,41,76,False,5,4
29743,23,32,40,72,False,5,4
29744,0,20,19,39,True,6,4
29745,1,7,15,22,True,6,4
29746,2,7,9,16,True,6,4
29747,3,12,6,18,True,6,4
29748,4,11,4,15,True,6,4
29749,5,21,13,34,True,6,4
29750,6,40,19,59,True,6,4
29751,7,55,49,104,True,6,4
29752,8,112,69,181,True,6,4
29753,9,129,90,219,True,6,4
29754,10,124,118,242,True,6,4
29755,11,129,156,285,True,6,4
29756,12,171,158,329,True,6,4
29757,13,129,137,266,True,6,4
29758,14,116,177,293,True,6,4
29759,15,149,150,299,True,6,4
29760,16,162,175,337,True,6,4
29761,17,149,153,302,True,6,4
29762,18,110,155,265,True,6,4
29763,19,81,117,198,True,6,4
29764,20,63,94,157,True,6,4
29765,21,43,72,115,True,6,4
29766,22,24,52,76,True,6,4
29767,23,14,9,23,True,6,4
29768,0,8,12,20,False,0,4
29769,1,7,8,15,False,0,4
29770,2,6,7,13,False,0,4
29771,3,22,7,29,False,0,4
29772,4,105,48,153,False,0,4
29773,5,220,149,369,False,0,4
29774,6,358,187,545,False,0,4
29775,7,236,165,401,False,0,4
29776,8,212,177,389,False,0,4
29777,9,200,161,361,False,0,4
29778,10,191,186,377,False,0,4
29779,11,209,190,399,False,0,4
29780,12,227,257,484,False,0,4
29781,13,240,303,543,False,0,4
29782,14,171,279,450,False,0,4
29783,15,173,157,330,False,0,4
29784,16,159,159,318,False,0,4
29785,17,120,136,256,False,0,4
29786,18,107,123,230,False,0,4
29787,19,68,105,173,False,0,4
29788,20,67,96,163,False,0,4
29789,21,36,50,86,False,0,4
29790,22,17,19,36,False,0,4
29791,23,12,15,27,False,0,4
29792,0,7,7,14,False,1,4
29793,1,6,24,30,False,1,4
29794,2,8,37,45,False,1,4
29795,3,16,34,50,False,1,4
29796,4,111,50,161,False,1,4
29797,5,213,137,350,False,1,4
29798,6,358,194,552,False,1,4
29799,7,255,141,396,False,1,4
29800,8,182,194,376,False,1,4
29801,9,208,180,388,False,1,4
29802,10,216,200,416,False,1,4
29803,11,240,187,427,False,1,4
29804,12,206,235,441,False,1,4
29805,13,261,327,588,False,1,4
29806,14,189,303,492,False,1,4
29807,15,175,164,339,False,1,4
29808,16,134,172,306,False,1,4
29809,17,136,151,287,False,1,4
29810,18,131,122,253,False,1,4
29811,19,95,102,197,False,1,4
29812,20,72,87,159,False,1,4
29813,21,48,58,106,False,1,4
29814,22,15,27,42,False,1,4
29815,23,12,20,32,False,1,4
29816,0,10,6,16,False,2,4
29817,1,12,7,19,False,2,4
29818,2,10,5,15,False,2,4
29819,3,19,4,23,False,2,4
29820,4,111,53,164,False,2,4
29821,5,249,127,376,False,2,4
29822,6,405,204,609,False,2,4
29823,7,239,157,396,False,2,4
29824,8,223,164,387,False,2,4
29825,9,238,158,396,False,2,4
29826,10,199,150,349,False,2,4
29827,11,241,156,397,False,2,4
29828,12,234,278,512,False,2,4
29829,13,243,318,561,False,2,4
29830,14,218,291,509,False,2,4
29831,15,174,202,376,False,2,4
29832,16,182,169,351,False,2,4
29833,17,125,146,271,False,2,4
29834,18,108,135,243,False,2,4
29835,19,87,109,196,False,2,4
29836,20,48,344,392,False,2,4
29837,21,44,203,247,False,2,4
29838,22,17,79,96,False,2,4
29839,23,13,47,60,False,2,4
29840,0,7,38,45,False,3,4
29841,1,2,30,32,False,3,4
29842,2,7,36,43,False,3,4
29843,3,19,28,47,False,3,4
29844,4,112,52,164,False,3,4
29845,5,222,150,372,False,3,4
29846,6,399,196,595,False,3,4
29847,7,238,149,387,False,3,4
29848,8,212,152,364,False,3,4
29849,9,207,152,359,False,3,4
29850,10,207,192,399,False,3,4
29851,11,213,227,440,False,3,4
29852,12,225,238,463,False,3,4
29853,13,240,320,560,False,3,4
29854,14,230,299,529,False,3,4
29855,15,196,207,403,False,3,4
29856,16,166,154,320,False,3,4
29857,17,154,132,286,False,3,4
29858,18,136,119,255,False,3,4
29859,19,89,120,209,False,3,4
29860,20,62,100,162,False,3,4
29861,21,41,42,83,False,3,4
29862,22,25,33,58,False,3,4
29863,23,13,14,27,False,3,4
29864,0,11,14,25,False,4,4
29865,1,6,6,12,False,4,4
29866,2,8,10,18,False,4,4
29867,3,16,10,26,False,4,4
29868,4,116,57,173,False,4,4
29869,5,260,161,421,False,4,4
29870,6,372,178,550,False,4,4
29871,7,232,153,385,False,4,4
29872,8,220,180,400,False,4,4
29873,9,207,182,389,False,4,4
29874,10,222,225,447,False,4,4
29875,11,243,232,475,False,4,4
29876,12,234,280,514,False,4,4
29877,13,229,308,537,False,4,4
29878,14,204,255,459,False,4,4
29879,15,153,215,368,False,4,4
29880,16,158,186,344,False,4,4
29881,17,128,118,246,False,4,4
29882,18,115,114,229,False,4,4
29883,19,83,109,192,False,4,4
29884,20,72,80,152,False,4,4
29885,21,35,60,95,False,4,4
29886,22,31,36,67,False,4,4
29887,23,19,29,48,False,4,4
29888,0,19,23,42,False,5,4
29889,1,15,22,37,False,5,4
29890,2,14,15,29,False,5,4
29891,3,14,7,21,False,5,4
29892,4,19,13,32,False,5,4
29893,5,27,16,43,False,5,4
29894,6,36,34,70,False,5,4
29895,7,62,51,113,False,5,4
29896,8,116,74,190,False,5,4
29897,9,120,102,222,False,5,4
29898,10,171,133,304,False,5,4
29899,11,144,151,295,False,5,4
29900,12,152,144,296,False,5,4
29901,13,145,195,340,False,5,4
29902,14,134,167,301,False,5,4
29903,15,129,145,274,False,5,4
29904,16,121,127,248,False,5,4
29905,17,87,105,192,False,5,4
29906,18,87,65,152,False,5,4
29907,19,66,90,156,False,5,4
29908,20,47,68,115,False,5,4
29909,21,45,58,103,False,5,4
29910,22,35,48,83,False,5,4
29911,23,32,31,63,False,5,4
29912,0,26,33,59,True,6,4
29913,1,22,27,49,True,6,4
29914,2,15,16,31,True,6,4
29915,3,14,10,24,True,6,4
29916,4,16,7,23,True,6,4
29917,5,15,14,29,True,6,4
29918,6,47,26,73,True,6,4
29919,7,63,47,110,True,6,4
29920,8,107,67,174,True,6,4
29921,9,120,81,201,True,6,4
29922,10,146,127,273,True,6,4
29923,11,137,189,326,True,6,4
29924,12,146,166,312,True,6,4
29925,13,146,189,335,True,6,4
29926,14,150,197,347,True,6,4
29927,15,160,173,333,True,6,4
29928,16,183,208,391,True,6,4
29929,17,159,231,390,True,6,4
29930,18,91,131,222,True,6,4
29931,19,95,102,197,True,6,4
29932,20,165,78,243,True,6,4
29933,21,46,41,87,True,6,4
29934,22,18,34,52,True,6,4
29935,23,12,15,27,True,6,4
29936,0,4,11,15,False,0,4
29937,1,9,6,15,False,0,4
29938,2,3,7,10,False,0,4
29939,3,25,9,34,False,0,4
29940,4,126,54,180,False,0,4
29941,5,238,155,393,False,0,4
29942,6,376,182,558,False,0,4
29943,7,266,168,434,False,0,4
29944,8,214,151,365,False,0,4
29945,9,187,162,349,False,0,4
29946,10,196,207,403,False,0,4
29947,11,250,218,468,False,0,4
29948,12,243,265,508,False,0,4
29949,13,229,306,535,False,0,4
29950,14,196,248,444,False,0,4
29951,15,169,200,369,False,0,4
29952,16,171,165,336,False,0,4
29953,17,152,152,304,False,0,4
29954,18,125,123,248,False,0,4
29955,19,92,160,252,False,0,4
29956,20,63,363,426,False,0,4
29957,21,36,223,259,False,0,4
29958,22,20,82,102,False,0,4
29959,23,9,34,43,False,0,4
29960,0,4,20,24,False,1,4
29961,1,10,21,31,False,1,4
29962,2,10,20,30,False,1,4
29963,3,17,28,45,False,1,4
29964,4,104,51,155,False,1,4
29965,5,253,134,387,False,1,4
29966,6,417,182,599,False,1,4
29967,7,247,141,388,False,1,4
29968,8,206,181,387,False,1,4
29969,9,233,175,408,False,1,4
29970,10,194,220,414,False,1,4
29971,11,212,205,417,False,1,4
29972,12,234,276,510,False,1,4
29973,13,236,318,554,False,1,4
29974,14,220,315,535,False,1,4
29975,15,166,206,372,False,1,4
29976,16,182,147,329,False,1,4
29977,17,138,142,280,False,1,4
29978,18,140,136,276,False,1,4
29979,19,101,145,246,False,1,4
29980,20,78,102,180,False,1,4
29981,21,50,50,100,False,1,4
29982,22,23,21,44,False,1,4
29983,23,11,12,23,False,1,4
29984,0,13,8,21,False,2,4
29985,1,8,12,20,False,2,4
29986,2,14,13,27,False,2,4
29987,3,20,6,26,False,2,4
29988,4,109,52,161,False,2,4
29989,5,229,127,356,False,2,4
29990,6,420,209,629,False,2,4
29991,7,278,162,440,False,2,4
29992,8,248,186,434,False,2,4
29993,9,230,190,420,False,2,4
29994,10,206,192,398,False,2,4
29995,11,222,253,475,False,2,4
29996,12,265,251,516,False,2,4
29997,13,263,319,582,False,2,4
29998,14,238,363,601,False,2,4
29999,15,163,214,377,False,2,4
30000,16,144,154,298,False,2,4
30001,17,146,142,288,False,2,4
30002,18,116,118,234,False,2,4
30003,19,103,104,207,False,2,4
30004,20,64,74,138,False,2,4
30005,21,45,131,176,False,2,4
30006,22,34,55,89,False,2,4
30007,23,32,27,59,False,2,4
30008,0,22,19,41,True,3,4
30009,1,18,26,44,True,3,4
30010,2,10,16,26,True,3,4
30011,3,10,7,17,True,3,4
30012,4,19,10,29,True,3,4
30013,5,32,20,52,True,3,4
30014,6,43,28,71,True,3,4
30015,7,59,50,109,True,3,4
30016,8,107,63,170,True,3,4
30017,9,130,87,217,True,3,4
30018,10,160,141,301,True,3,4
30019,11,154,139,293,True,3,4
30020,12,163,166,329,True,3,4
30021,13,141,161,302,True,3,4
30022,14,146,220,366,True,3,4
30023,15,135,173,308,True,3,4
30024,16,153,170,323,True,3,4
30025,17,123,147,270,True,3,4
30026,18,109,132,241,True,3,4
30027,19,89,119,208,True,3,4
30028,20,68,89,157,True,3,4
30029,21,43,64,107,True,3,4
30030,22,21,26,47,True,3,4
30031,23,18,28,46,True,3,4
30032,0,14,18,32,False,4,4
30033,1,7,13,20,False,4,4
30034,2,14,9,23,False,4,4
30035,3,15,7,22,False,4,4
30036,4,75,35,110,False,4,4
30037,5,162,101,263,False,4,4
30038,6,195,113,308,False,4,4
30039,7,189,101,290,False,4,4
30040,8,196,137,333,False,4,4
30041,9,246,165,411,False,4,4
30042,10,246,177,423,False,4,4
30043,11,190,224,414,False,4,4
30044,12,204,224,428,False,4,4
30045,13,215,235,450,False,4,4
30046,14,196,232,428,False,4,4
30047,15,152,168,320,False,4,4
30048,16,131,138,269,False,4,4
30049,17,114,131,245,False,4,4
30050,18,89,94,183,False,4,4
30051,19,90,118,208,False,4,4
30052,20,70,80,150,False,4,4
30053,21,51,60,111,False,4,4
30054,22,31,36,67,False,4,4
30055,23,27,47,74,False,4,4
30056,0,20,17,37,False,5,5
30057,1,14,18,32,False,5,5
30058,2,15,17,32,False,5,5
30059,3,12,12,24,False,5,5
30060,4,24,10,34,False,5,5
30061,5,19,73,92,False,5,5
30062,6,46,34,80,False,5,5
30063,7,66,56,122,False,5,5
30064,8,110,66,176,False,5,5
30065,9,114,88,202,False,5,5
30066,10,157,119,276,False,5,5
30067,11,151,141,292,False,5,5
30068,12,153,139,292,False,5,5
30069,13,149,191,340,False,5,5
30070,14,119,144,263,False,5,5
30071,15,113,142,255,False,5,5
30072,16,137,152,289,False,5,5
30073,17,97,113,210,False,5,5
30074,18,109,99,208,False,5,5
30075,19,51,69,120,False,5,5
30076,20,37,55,92,False,5,5
30077,21,57,64,121,False,5,5
30078,22,42,44,86,False,5,5
30079,23,20,27,47,False,5,5
30080,0,19,33,52,True,6,5
30081,1,14,26,40,True,6,5
30082,2,14,9,23,True,6,5
30083,3,18,15,33,True,6,5
30084,4,17,8,25,True,6,5
30085,5,28,15,43,True,6,5
30086,6,30,19,49,True,6,5
30087,7,45,32,77,True,6,5
30088,8,70,56,126,True,6,5
30089,9,145,83,228,True,6,5
30090,10,145,147,292,True,6,5
30091,11,167,180,347,True,6,5
30092,12,188,164,352,True,6,5
30093,13,154,192,346,True,6,5
30094,14,136,183,319,True,6,5
30095,15,148,160,308,True,6,5
30096,16,130,142,272,True,6,5
30097,17,152,139,291,True,6,5
30098,18,99,154,253,True,6,5
30099,19,92,110,202,True,6,5
30100,20,63,79,142,True,6,5
30101,21,38,42,80,True,6,5
30102,22,26,24,50,True,6,5
30103,23,7,16,23,True,6,5
30104,0,12,7,19,False,0,5
30105,1,7,13,20,False,0,5
30106,2,10,9,19,False,0,5
30107,3,21,7,28,False,0,5
30108,4,121,54,175,False,0,5
30109,5,238,132,370,False,0,5
30110,6,419,198,617,False,0,5
30111,7,267,169,436,False,0,5
30112,8,192,150,342,False,0,5
30113,9,211,204,415,False,0,5
30114,10,187,188,375,False,0,5
30115,11,212,227,439,False,0,5
30116,12,227,224,451,False,0,5
30117,13,265,306,571,False,0,5
30118,14,221,296,517,False,0,5
30119,15,168,199,367,False,0,5
30120,16,176,162,338,False,0,5
30121,17,123,125,248,False,0,5
30122,18,108,147,255,False,0,5
30123,19,107,121,228,False,0,5
30124,20,60,82,142,False,0,5
30125,21,28,42,70,False,0,5
30126,22,26,25,51,False,0,5
30127,23,11,18,29,False,0,5
30128,0,12,9,21,False,1,5
30129,1,5,12,17,False,1,5
30130,2,11,8,19,False,1,5
30131,3,18,8,26,False,1,5
30132,4,113,62,175,False,1,5
30133,5,228,140,368,False,1,5
30134,6,391,190,581,False,1,5
30135,7,247,141,388,False,1,5
30136,8,204,151,355,False,1,5
30137,9,242,192,434,False,1,5
30138,10,225,217,442,False,1,5
30139,11,231,220,451,False,1,5
30140,12,246,262,508,False,1,5
30141,13,284,312,596,False,1,5
30142,14,218,259,477,False,1,5
30143,15,200,180,380,False,1,5
30144,16,171,149,320,False,1,5
30145,17,148,128,276,False,1,5
30146,18,105,136,241,False,1,5
30147,19,71,114,185,False,1,5
30148,20,68,86,154,False,1,5
30149,21,60,152,212,False,1,5
30150,22,28,25,53,False,1,5
30151,23,9,16,25,False,1,5
30152,0,13,34,47,False,2,5
30153,1,14,29,43,False,2,5
30154,2,11,21,32,False,2,5
30155,3,19,14,33,False,2,5
30156,4,99,50,149,False,2,5
30157,5,223,139,362,False,2,5
30158,6,403,194,597,False,2,5
30159,7,261,157,418,False,2,5
30160,8,231,165,396,False,2,5
30161,9,223,187,410,False,2,5
30162,10,210,193,403,False,2,5
30163,11,226,206,432,False,2,5
30164,12,234,263,497,False,2,5
30165,13,245,333,578,False,2,5
30166,14,217,290,507,False,2,5
30167,15,329,219,548,False,2,5
30168,16,220,175,395,False,2,5
30169,17,146,234,380,False,2,5
30170,18,133,223,356,False,2,5
30171,19,79,121,200,False,2,5
30172,20,56,102,158,False,2,5
30173,21,28,50,78,False,2,5
30174,22,23,71,94,False,2,5
30175,23,12,38,50,False,2,5
30176,0,12,36,48,False,3,5
30177,1,8,24,32,False,3,5
30178,2,12,28,40,False,3,5
30179,3,22,17,39,False,3,5
30180,4,105,58,163,False,3,5
30181,5,210,145,355,False,3,5
30182,6,361,187,548,False,3,5
30183,7,213,140,353,False,3,5
30184,8,243,146,389,False,3,5
30185,9,242,177,419,False,3,5
30186,10,208,201,409,False,3,5
30187,11,235,238,473,False,3,5
30188,12,232,268,500,False,3,5
30189,13,286,325,611,False,3,5
30190,14,230,289,519,False,3,5
30191,15,201,171,372,False,3,5
30192,16,172,192,364,False,3,5
30193,17,125,144,269,False,3,5
30194,18,99,104,203,False,3,5
30195,19,98,102,200,False,3,5
30196,20,88,89,177,False,3,5
30197,21,50,52,102,False,3,5
30198,22,25,29,54,False,3,5
30199,23,20,20,40,False,3,5
30200,0,19,26,45,False,4,5
30201,1,14,14,28,False,4,5
30202,2,8,5,13,False,4,5
30203,3,21,11,32,False,4,5
30204,4,106,56,162,False,4,5
30205,5,241,141,382,False,4,5
30206,6,394,191,585,False,4,5
30207,7,244,175,419,False,4,5
30208,8,218,183,401,False,4,5
30209,9,216,191,407,False,4,5
30210,10,219,214,433,False,4,5
30211,11,235,233,468,False,4,5
30212,12,265,292,557,False,4,5
30213,13,317,403,720,False,4,5
30214,14,236,297,533,False,4,5
30215,15,170,164,334,False,4,5
30216,16,152,151,303,False,4,5
30217,17,119,134,253,False,4,5
30218,18,112,129,241,False,4,5
30219,19,81,74,155,False,4,5
30220,20,60,77,137,False,4,5
30221,21,34,63,97,False,4,5
30222,22,31,42,73,False,4,5
30223,23,36,28,64,False,4,5
30224,0,27,27,54,False,5,5
30225,1,14,22,36,False,5,5
30226,2,10,14,24,False,5,5
30227,3,14,11,25,False,5,5
30228,4,25,14,39,False,5,5
30229,5,19,23,42,False,5,5
30230,6,31,37,68,False,5,5
30231,7,54,43,97,False,5,5
30232,8,97,66,163,False,5,5
30233,9,115,93,208,False,5,5
30234,10,172,144,316,False,5,5
30235,11,157,130,287,False,5,5
30236,12,169,174,343,False,5,5
30237,13,141,163,304,False,5,5
30238,14,128,184,312,False,5,5
30239,15,161,174,335,False,5,5
30240,16,118,149,267,False,5,5
30241,17,99,107,206,False,5,5
30242,18,100,99,199,False,5,5
30243,19,64,65,129,False,5,5
30244,20,50,58,108,False,5,5
30245,21,39,76,115,False,5,5
30246,22,39,40,79,False,5,5
30247,23,33,30,63,False,5,5
30248,0,11,34,45,True,6,5
30249,1,19,29,48,True,6,5
30250,2,15,17,32,True,6,5
30251,3,17,9,26,True,6,5
30252,4,20,14,34,True,6,5
30253,5,17,10,27,True,6,5
30254,6,34,13,47,True,6,5
30255,7,58,25,83,True,6,5
30256,8,87,39,126,True,6,5
30257,9,103,89,192,True,6,5
30258,10,166,118,284,True,6,5
30259,11,143,134,277,True,6,5
30260,12,165,167,332,True,6,5
30261,13,115,178,293,True,6,5
30262,14,117,178,295,True,6,5
30263,15,138,155,293,True,6,5
30264,16,144,135,279,True,6,5
30265,17,104,137,241,True,6,5
30266,18,99,147,246,True,6,5
30267,19,74,89,163,True,6,5
30268,20,48,69,117,True,6,5
30269,21,44,64,108,True,6,5
30270,22,23,37,60,True,6,5
30271,23,10,20,30,True,6,5
30272,0,12,11,23,True,0,5
30273,1,7,18,25,True,0,5
30274,2,5,10,15,True,0,5
30275,3,8,5,13,True,0,5
30276,4,19,13,32,True,0,5
30277,5,24,15,39,True,0,5
30278,6,30,23,53,True,0,5
30279,7,55,39,94,True,0,5
30280,8,99,66,165,True,0,5
30281,9,106,75,181,True,0,5
30282,10,146,130,276,True,0,5
30283,11,165,163,328,True,0,5
30284,12,152,176,328,True,0,5
30285,13,170,163,333,True,0,5
30286,14,183,173,356,True,0,5
30287,15,166,172,338,True,0,5
30288,16,139,151,290,True,0,5
30289,17,134,160,294,True,0,5
30290,18,107,125,232,True,0,5
30291,19,102,110,212,True,0,5
30292,20,67,86,153,True,0,5
30293,21,40,71,111,True,0,5
30294,22,29,37,66,True,0,5
30295,23,16,22,38,True,0,5
30296,0,13,12,25,False,1,5
30297,1,8,6,14,False,1,5
30298,2,9,9,18,False,1,5
30299,3,22,8,30,False,1,5
30300,4,103,60,163,False,1,5
30301,5,233,149,382,False,1,5
30302,6,406,184,590,False,1,5
30303,7,274,173,447,False,1,5
30304,8,229,184,413,False,1,5
30305,9,211,162,373,False,1,5
30306,10,233,216,449,False,1,5
30307,11,236,207,443,False,1,5
30308,12,190,246,436,False,1,5
30309,13,250,333,583,False,1,5
30310,14,233,294,527,False,1,5
30311,15,175,191,366,False,1,5
30312,16,158,150,308,False,1,5
30313,17,135,153,288,False,1,5
30314,18,105,110,215,False,1,5
30315,19,94,135,229,False,1,5
30316,20,68,78,146,False,1,5
30317,21,33,48,81,False,1,5
30318,22,30,29,59,False,1,5
30319,23,20,21,41,False,1,5
30320,0,12,15,27,False,2,5
30321,1,8,9,17,False,2,5
30322,2,9,4,13,False,2,5
30323,3,15,6,21,False,2,5
30324,4,102,54,156,False,2,5
30325,5,218,126,344,False,2,5
30326,6,384,187,571,False,2,5
30327,7,246,158,404,False,2,5
30328,8,187,167,354,False,2,5
30329,9,216,163,379,False,2,5
30330,10,229,206,435,False,2,5
30331,11,185,204,389,False,2,5
30332,12,236,241,477,False,2,5
30333,13,266,340,606,False,2,5
30334,14,205,275,480,False,2,5
30335,15,196,176,372,False,2,5
30336,16,159,154,313,False,2,5
30337,17,127,146,273,False,2,5
30338,18,111,145,256,False,2,5
30339,19,101,112,213,False,2,5
30340,20,79,155,234,False,2,5
30341,21,58,87,145,False,2,5
30342,22,33,35,68,False,2,5
30343,23,15,25,40,False,2,5
30344,0,16,12,28,False,3,5
30345,1,17,11,28,False,3,5
30346,2,21,3,24,False,3,5
30347,3,12,16,28,False,3,5
30348,4,116,53,169,False,3,5
30349,5,215,133,348,False,3,5
30350,6,372,238,610,False,3,5
30351,7,320,190,510,False,3,5
30352,8,225,179,404,False,3,5
30353,9,213,171,384,False,3,5
30354,10,214,205,419,False,3,5
30355,11,208,220,428,False,3,5
30356,12,268,283,551,False,3,5
30357,13,280,313,593,False,3,5
30358,14,258,265,523,False,3,5
30359,15,164,193,357,False,3,5
30360,16,282,192,474,False,3,5
30361,17,118,153,271,False,3,5
30362,18,119,126,245,False,3,5
30363,19,103,124,227,False,3,5
30364,20,81,89,170,False,3,5
30365,21,56,69,125,False,3,5
30366,22,43,65,108,False,3,5
30367,23,22,67,89,False,3,5
30368,0,18,74,92,False,4,5
30369,1,13,58,71,False,4,5
30370,2,16,40,56,False,4,5
30371,3,22,34,56,False,4,5
30372,4,104,57,161,False,4,5
30373,5,225,114,339,False,4,5
30374,6,379,186,565,False,4,5
30375,7,263,157,420,False,4,5
30376,8,242,153,395,False,4,5
30377,9,221,183,404,False,4,5
30378,10,240,223,463,False,4,5
30379,11,253,251,504,False,4,5
30380,12,234,268,502,False,4,5
30381,13,267,307,574,False,4,5
30382,14,202,245,447,False,4,5
30383,15,165,178,343,False,4,5
30384,16,138,151,289,False,4,5
30385,17,107,128,235,False,4,5
30386,18,108,116,224,False,4,5
30387,19,73,91,164,False,4,5
30388,20,64,81,145,False,4,5
30389,21,54,71,125,False,4,5
30390,22,40,53,93,False,4,5
30391,23,22,35,57,False,4,5
30392,0,26,22,48,False,5,5
30393,1,14,24,38,False,5,5
30394,2,7,16,23,False,5,5
30395,3,10,4,14,False,5,5
30396,4,31,17,48,False,5,5
30397,5,27,24,51,False,5,5
30398,6,34,44,78,False,5,5
30399,7,69,48,117,False,5,5
30400,8,100,89,189,False,5,5
30401,9,126,112,238,False,5,5
30402,10,129,116,245,False,5,5
30403,11,147,131,278,False,5,5
30404,12,173,157,330,False,5,5
30405,13,123,164,287,False,5,5
30406,14,116,146,262,False,5,5
30407,15,134,153,287,False,5,5
30408,16,112,149,261,False,5,5
30409,17,99,115,214,False,5,5
30410,18,96,105,201,False,5,5
30411,19,71,84,155,False,5,5
30412,20,55,70,125,False,5,5
30413,21,34,48,82,False,5,5
30414,22,41,46,87,False,5,5
30415,23,30,45,75,False,5,5
30416,0,31,34,65,True,6,5
30417,1,26,38,64,True,6,5
30418,2,19,16,35,True,6,5
30419,3,13,22,35,True,6,5
30420,4,15,13,28,True,6,5
30421,5,14,12,26,True,6,5
30422,6,47,19,66,True,6,5
30423,7,47,46,93,True,6,5
30424,8,64,44,108,True,6,5
30425,9,107,91,198,True,6,5
30426,10,133,133,266,True,6,5
30427,11,186,150,336,True,6,5
30428,12,207,171,378,True,6,5
30429,13,164,193,357,True,6,5
30430,14,172,208,380,True,6,5
30431,15,168,188,356,True,6,5
30432,16,193,171,364,True,6,5
30433,17,174,167,341,True,6,5
30434,18,122,147,269,True,6,5
30435,19,82,141,223,True,6,5
30436,20,57,79,136,True,6,5
30437,21,41,41,82,True,6,5
30438,22,19,29,48,True,6,5
30439,23,16,19,35,True,6,5
30440,0,9,12,21,False,0,5
30441,1,2,8,10,False,0,5
30442,2,7,8,15,False,0,5
30443,3,21,7,28,False,0,5
30444,4,111,53,164,False,0,5
30445,5,249,144,393,False,0,5
30446,6,375,195,570,False,0,5
30447,7,247,158,405,False,0,5
30448,8,226,165,391,False,0,5
30449,9,241,191,432,False,0,5
30450,10,227,201,428,False,0,5
30451,11,208,218,426,False,0,5
30452,12,232,257,489,False,0,5
30453,13,243,329,572,False,0,5
30454,14,214,276,490,False,0,5
30455,15,175,188,363,False,0,5
30456,16,140,173,313,False,0,5
30457,17,116,129,245,False,0,5
30458,18,114,127,241,False,0,5
30459,19,99,106,205,False,0,5
30460,20,52,70,122,False,0,5
30461,21,36,45,81,False,0,5
30462,22,15,24,39,False,0,5
30463,23,13,12,25,False,0,5
30464,0,13,7,20,False,1,5
30465,1,3,9,12,False,1,5
30466,2,7,5,12,False,1,5
30467,3,17,9,26,False,1,5
30468,4,109,58,167,False,1,5
30469,5,254,127,381,False,1,5
30470,6,367,173,540,False,1,5
30471,7,279,158,437,False,1,5
30472,8,207,179,386,False,1,5
30473,9,218,153,371,False,1,5
30474,10,202,192,394,False,1,5
30475,11,209,211,420,False,1,5
30476,12,241,250,491,False,1,5
30477,13,265,304,569,False,1,5
30478,14,221,279,500,False,1,5
30479,15,149,169,318,False,1,5
30480,16,189,173,362,False,1,5
30481,17,157,157,314,False,1,5
30482,18,120,143,263,False,1,5
30483,19,91,112,203,False,1,5
30484,20,78,100,178,False,1,5
30485,21,42,54,96,False,1,5
30486,22,21,26,47,False,1,5
30487,23,17,17,34,False,1,5
30488,0,9,16,25,False,2,5
30489,1,10,9,19,False,2,5
30490,2,12,12,24,False,2,5
30491,3,17,10,27,False,2,5
30492,4,111,48,159,False,2,5
30493,5,227,123,350,False,2,5
30494,6,355,171,526,False,2,5
30495,7,249,153,402,False,2,5
30496,8,180,162,342,False,2,5
30497,9,229,168,397,False,2,5
30498,10,213,186,399,False,2,5
30499,11,226,233,459,False,2,5
30500,12,241,253,494,False,2,5
30501,13,224,350,574,False,2,5
30502,14,224,257,481,False,2,5
30503,15,193,205,398,False,2,5
30504,16,153,145,298,False,2,5
30505,17,152,144,296,False,2,5
30506,18,132,133,265,False,2,5
30507,19,93,122,215,False,2,5
30508,20,61,82,143,False,2,5
30509,21,36,43,79,False,2,5
30510,22,24,31,55,False,2,5
30511,23,19,11,30,False,2,5
30512,0,10,13,23,False,3,5
30513,1,6,7,13,False,3,5
30514,2,7,8,15,False,3,5
30515,3,11,7,18,False,3,5
30516,4,115,48,163,False,3,5
30517,5,226,119,345,False,3,5
30518,6,351,185,536,False,3,5
30519,7,259,161,420,False,3,5
30520,8,227,171,398,False,3,5
30521,9,216,169,385,False,3,5
30522,10,203,186,389,False,3,5
30523,11,230,214,444,False,3,5
30524,12,255,244,499,False,3,5
30525,13,277,310,587,False,3,5
30526,14,194,270,464,False,3,5
30527,15,182,195,377,False,3,5
30528,16,200,180,380,False,3,5
30529,17,136,127,263,False,3,5
30530,18,107,140,247,False,3,5
30531,19,79,121,200,False,3,5
30532,20,69,78,147,False,3,5
30533,21,35,42,77,False,3,5
30534,22,26,26,52,False,3,5
30535,23,15,12,27,False,3,5
30536,0,16,15,31,False,4,5
30537,1,14,18,32,False,4,5
30538,2,12,11,23,False,4,5
30539,3,20,9,29,False,4,5
30540,4,109,50,159,False,4,5
30541,5,220,104,324,False,4,5
30542,6,365,164,529,False,4,5
30543,7,241,162,403,False,4,5
30544,8,215,185,400,False,4,5
30545,9,279,185,464,False,4,5
30546,10,225,233,458,False,4,5
30547,11,261,222,483,False,4,5
30548,12,234,312,546,False,4,5
30549,13,279,302,581,False,4,5
30550,14,211,274,485,False,4,5
30551,15,143,181,324,False,4,5
30552,16,157,147,304,False,4,5
30553,17,124,125,249,False,4,5
30554,18,98,116,214,False,4,5
30555,19,81,101,182,False,4,5
30556,20,64,99,163,False,4,5
30557,21,58,79,137,False,4,5
30558,22,39,43,82,False,4,5
30559,23,25,27,52,False,4,5
30560,0,17,22,39,False,5,5
30561,1,16,18,34,False,5,5
30562,2,17,15,32,False,5,5
30563,3,10,11,21,False,5,5
30564,4,27,12,39,False,5,5
30565,5,28,35,63,False,5,5
30566,6,53,41,94,False,5,5
30567,7,69,61,130,False,5,5
30568,8,106,87,193,False,5,5
30569,9,141,113,254,False,5,5
30570,10,160,148,308,False,5,5
30571,11,173,139,312,False,5,5
30572,12,140,192,332,False,5,5
30573,13,142,187,329,False,5,5
30574,14,120,158,278,False,5,5
30575,15,128,171,299,False,5,5
30576,16,135,130,265,False,5,5
30577,17,86,98,184,False,5,5
30578,18,74,88,162,False,5,5
30579,19,58,73,131,False,5,5
30580,20,41,49,90,False,5,5
30581,21,47,59,106,False,5,5
30582,22,41,51,92,False,5,5
30583,23,28,35,63,False,5,5
30584,0,26,28,54,True,6,5
30585,1,29,25,54,True,6,5
30586,2,10,18,28,True,6,5
30587,3,12,9,21,True,6,5
30588,4,18,13,31,True,6,5
30589,5,18,5,23,True,6,5
30590,6,42,19,61,True,6,5
30591,7,37,37,74,True,6,5
30592,8,69,55,124,True,6,5
30593,9,103,91,194,True,6,5
30594,10,135,113,248,True,6,5
30595,11,148,157,305,True,6,5
30596,12,145,171,316,True,6,5
30597,13,142,176,318,True,6,5
30598,14,131,182,313,True,6,5
30599,15,151,156,307,True,6,5
30600,16,128,128,256,True,6,5
30601,17,120,158,278,True,6,5
30602,18,99,119,218,True,6,5
30603,19,85,126,211,True,6,5
30604,20,115,110,225,True,6,5
30605,21,60,68,128,True,6,5
30606,22,23,40,63,True,6,5
30607,23,16,15,31,True,6,5
30608,0,6,7,13,False,0,5
30609,1,14,10,24,False,0,5
30610,2,9,9,18,False,0,5
30611,3,17,13,30,False,0,5
30612,4,95,51,146,False,0,5
30613,5,228,111,339,False,0,5
30614,6,306,159,465,False,0,5
30615,7,262,169,431,False,0,5
30616,8,221,149,370,False,0,5
30617,9,231,174,405,False,0,5
30618,10,209,176,385,False,0,5
30619,11,218,212,430,False,0,5
30620,12,226,260,486,False,0,5
30621,13,243,337,580,False,0,5
30622,14,175,263,438,False,0,5
30623,15,160,164,324,False,0,5
30624,16,142,139,281,False,0,5
30625,17,112,120,232,False,0,5
30626,18,108,91,199,False,0,5
30627,19,82,88,170,False,0,5
30628,20,59,54,113,False,0,5
30629,21,40,42,82,False,0,5
30630,22,24,27,51,False,0,5
30631,23,13,14,27,False,0,5
30632,0,13,16,29,False,1,5
30633,1,11,3,14,False,1,5
30634,2,5,6,11,False,1,5
30635,3,14,12,26,False,1,5
30636,4,101,44,145,False,1,5
30637,5,218,126,344,False,1,5
30638,6,327,160,487,False,1,5
30639,7,283,152,435,False,1,5
30640,8,202,136,338,False,1,5
30641,9,212,177,389,False,1,5
30642,10,206,188,394,False,1,5
30643,11,212,199,411,False,1,5
30644,12,206,257,463,False,1,5
30645,13,237,310,547,False,1,5
30646,14,179,281,460,False,1,5
30647,15,173,191,364,False,1,5
30648,16,165,135,300,False,1,5
30649,17,118,133,251,False,1,5
30650,18,89,100,189,False,1,5
30651,19,79,115,194,False,1,5
30652,20,75,84,159,False,1,5
30653,21,42,45,87,False,1,5
30654,22,28,29,57,False,1,5
30655,23,14,13,27,False,1,5
30656,0,5,8,13,False,2,5
30657,1,9,13,22,False,2,5
30658,2,4,8,12,False,2,5
30659,3,13,9,22,False,2,5
30660,4,89,46,135,False,2,5
30661,5,234,135,369,False,2,5
30662,6,335,159,494,False,2,5
30663,7,277,162,439,False,2,5
30664,8,212,152,364,False,2,5
30665,9,226,200,426,False,2,5
30666,10,225,225,450,False,2,5
30667,11,212,197,409,False,2,5
30668,12,234,235,469,False,2,5
30669,13,215,329,544,False,2,5
30670,14,178,269,447,False,2,5
30671,15,163,191,354,False,2,5
30672,16,142,176,318,False,2,5
30673,17,119,119,238,False,2,5
30674,18,118,136,254,False,2,5
30675,19,82,94,176,False,2,5
30676,20,71,63,134,False,2,5
30677,21,31,46,77,False,2,5
30678,22,31,24,55,False,2,5
30679,23,12,13,25,False,2,5
30680,0,10,9,19,False,3,5
30681,1,9,11,20,False,3,5
30682,2,10,7,17,False,3,5
30683,3,16,20,36,False,3,5
30684,4,90,45,135,False,3,5
30685,5,233,102,335,False,3,5
30686,6,305,137,442,False,3,5
30687,7,257,137,394,False,3,5
30688,8,189,178,367,False,3,5
30689,9,201,159,360,False,3,5
30690,10,239,181,420,False,3,5
30691,11,219,196,415,False,3,5
30692,12,233,244,477,False,3,5
30693,13,256,333,589,False,3,5
30694,14,175,271,446,False,3,5
30695,15,154,168,322,False,3,5
30696,16,147,146,293,False,3,5
30697,17,119,139,258,False,3,5
30698,18,106,100,206,False,3,5
30699,19,72,86,158,False,3,5
30700,20,53,61,114,False,3,5
30701,21,26,68,94,False,3,5
30702,22,33,35,68,False,3,5
30703,23,24,32,56,False,3,5
30704,0,17,25,42,False,4,5
30705,1,13,21,34,False,4,5
30706,2,9,15,24,False,4,5
30707,3,23,17,40,False,4,5
30708,4,95,39,134,False,4,5
30709,5,219,102,321,False,4,5
30710,6,311,125,436,False,4,5
30711,7,261,168,429,False,4,5
30712,8,209,155,364,False,4,5
30713,9,233,194,427,False,4,5
30714,10,216,178,394,False,4,5
30715,11,224,213,437,False,4,5
30716,12,273,277,550,False,4,5
30717,13,220,289,509,False,4,5
30718,14,152,233,385,False,4,5
30719,15,133,170,303,False,4,5
30720,16,113,129,242,False,4,5
30721,17,105,88,193,False,4,5
30722,18,81,112,193,False,4,5
30723,19,85,86,171,False,4,5
30724,20,62,71,133,False,4,5
30725,21,58,56,114,False,4,5
30726,22,37,35,72,False,4,5
30727,23,12,27,39,False,4,5
30728,0,15,26,41,False,5,5
30729,1,18,13,31,False,5,5
30730,2,9,20,29,False,5,5
30731,3,9,13,22,False,5,5
30732,4,22,13,35,False,5,5
30733,5,28,22,50,False,5,5
30734,6,37,32,69,False,5,5
30735,7,60,43,103,False,5,5
30736,8,85,70,155,False,5,5
30737,9,123,107,230,False,5,5
30738,10,114,108,222,False,5,5
30739,11,122,128,250,False,5,5
30740,12,119,149,268,False,5,5
30741,13,129,136,265,False,5,5
30742,14,111,120,231,False,5,5
30743,15,93,122,215,False,5,5
30744,16,119,115,234,False,5,5
30745,17,80,119,199,False,5,5
30746,18,81,83,164,False,5,5
30747,19,43,54,97,False,5,5
30748,20,42,60,102,False,5,5
30749,21,43,50,93,False,5,5
30750,22,34,32,66,False,5,5
30751,23,29,19,48,False,5,5
30752,0,21,29,50,True,6,5
30753,1,18,27,45,True,6,5
30754,2,14,20,34,True,6,5
30755,3,14,11,25,True,6,5
30756,4,21,6,27,True,6,5
30757,5,12,10,22,True,6,5
30758,6,27,14,41,True,6,5
30759,7,27,27,54,True,6,5
30760,8,79,41,120,True,6,5
30761,9,97,55,152,True,6,5
30762,10,127,110,237,True,6,5
30763,11,126,111,237,True,6,5
30764,12,158,180,338,True,6,5
30765,13,138,158,296,True,6,5
30766,14,117,182,299,True,6,5
30767,15,134,135,269,True,6,5
30768,16,128,145,273,True,6,5
30769,17,150,152,302,True,6,5
30770,18,96,132,228,True,6,5
30771,19,86,106,192,True,6,5
30772,20,60,67,127,True,6,5
30773,21,34,45,79,True,6,5
30774,22,28,25,53,True,6,5
30775,23,15,13,28,True,6,5
30776,0,15,18,33,False,0,6
30777,1,10,9,19,False,0,6
30778,2,6,10,16,False,0,6
30779,3,16,10,26,False,0,6
30780,4,85,49,134,False,0,6
30781,5,206,110,316,False,0,6
30782,6,283,140,423,False,0,6
30783,7,224,129,353,False,0,6
30784,8,221,147,368,False,0,6
30785,9,201,162,363,False,0,6
30786,10,209,185,394,False,0,6
30787,11,223,204,427,False,0,6
30788,12,223,236,459,False,0,6
30789,13,224,311,535,False,0,6
30790,14,161,289,450,False,0,6
30791,15,165,164,329,False,0,6
30792,16,135,137,272,False,0,6
30793,17,115,110,225,False,0,6
30794,18,115,114,229,False,0,6
30795,19,68,85,153,False,0,6
30796,20,68,60,128,False,0,6
30797,21,47,41,88,False,0,6
30798,22,34,34,68,False,0,6
30799,23,15,12,27,False,0,6
30800,0,11,7,18,False,1,6
30801,1,14,12,26,False,1,6
30802,2,11,6,17,False,1,6
30803,3,20,12,32,False,1,6
30804,4,83,34,117,False,1,6
30805,5,178,97,275,False,1,6
30806,6,263,113,376,False,1,6
30807,7,229,174,403,False,1,6
30808,8,163,141,304,False,1,6
30809,9,200,162,362,False,1,6
30810,10,191,175,366,False,1,6
30811,11,201,186,387,False,1,6
30812,12,196,225,421,False,1,6
30813,13,229,305,534,False,1,6
30814,14,169,247,416,False,1,6
30815,15,147,151,298,False,1,6
30816,16,116,133,249,False,1,6
30817,17,123,124,247,False,1,6
30818,18,92,91,183,False,1,6
30819,19,75,95,170,False,1,6
30820,20,61,63,124,False,1,6
30821,21,44,33,77,False,1,6
30822,22,14,54,68,False,1,6
30823,23,21,22,43,False,1,6
30824,0,13,10,23,False,2,6
30825,1,5,11,16,False,2,6
30826,2,7,7,14,False,2,6
30827,3,10,10,20,False,2,6
30828,4,83,45,128,False,2,6
30829,5,199,93,292,False,2,6
30830,6,269,136,405,False,2,6
30831,7,226,144,370,False,2,6
30832,8,199,160,359,False,2,6
30833,9,179,154,333,False,2,6
30834,10,193,158,351,False,2,6
30835,11,185,193,378,False,2,6
30836,12,229,244,473,False,2,6
30837,13,196,305,501,False,2,6
30838,14,172,247,419,False,2,6
30839,15,133,159,292,False,2,6
30840,16,143,118,261,False,2,6
30841,17,98,109,207,False,2,6
30842,18,95,124,219,False,2,6
30843,19,77,77,154,False,2,6
30844,20,67,66,133,False,2,6
30845,21,34,28,62,False,2,6
30846,22,30,24,54,False,2,6
30847,23,12,11,23,False,2,6
30848,0,13,11,24,False,3,6
30849,1,16,15,31,False,3,6
30850,2,7,9,16,False,3,6
30851,3,16,14,30,False,3,6
30852,4,65,48,113,False,3,6
30853,5,189,101,290,False,3,6
30854,6,302,137,439,False,3,6
30855,7,198,130,328,False,3,6
30856,8,193,146,339,False,3,6
30857,9,195,144,339,False,3,6
30858,10,221,198,419,False,3,6
30859,11,204,174,378,False,3,6
30860,12,216,242,458,False,3,6
30861,13,238,279,517,False,3,6
30862,14,167,248,415,False,3,6
30863,15,132,149,281,False,3,6
30864,16,124,143,267,False,3,6
30865,17,116,131,247,False,3,6
30866,18,92,115,207,False,3,6
30867,19,78,93,171,False,3,6
30868,20,64,95,159,False,3,6
30869,21,40,56,96,False,3,6
30870,22,13,122,135,False,3,6
30871,23,16,62,78,False,3,6
30872,0,10,38,48,False,4,6
30873,1,4,43,47,False,4,6
30874,2,8,9,17,False,4,6
30875,3,13,12,25,False,4,6
30876,4,95,44,139,False,4,6
30877,5,172,87,259,False,4,6
30878,6,248,124,372,False,4,6
30879,7,212,133,345,False,4,6
30880,8,190,167,357,False,4,6
30881,9,189,161,350,False,4,6
30882,10,180,173,353,False,4,6
30883,11,200,184,384,False,4,6
30884,12,198,237,435,False,4,6
30885,13,221,240,461,False,4,6
30886,14,150,204,354,False,4,6
30887,15,131,161,292,False,4,6
30888,16,92,128,220,False,4,6
30889,17,92,87,179,False,4,6
30890,18,80,112,192,False,4,6
30891,19,123,86,209,False,4,6
30892,20,60,65,125,False,4,6
30893,21,31,40,71,False,4,6
30894,22,25,40,65,False,4,6
30895,23,17,31,48,False,4,6
30896,0,12,29,41,False,5,6
30897,1,10,14,24,False,5,6
30898,2,7,9,16,False,5,6
30899,3,6,6,12,False,5,6
30900,4,18,9,27,False,5,6
30901,5,26,25,51,False,5,6
30902,6,28,28,56,False,5,6
30903,7,44,29,73,False,5,6
30904,8,60,63,123,False,5,6
30905,9,98,59,157,False,5,6
30906,10,105,88,193,False,5,6
30907,11,130,116,246,False,5,6
30908,12,128,125,253,False,5,6
30909,13,96,144,240,False,5,6
30910,14,110,128,238,False,5,6
30911,15,78,115,193,False,5,6
30912,16,99,105,204,False,5,6
30913,17,70,75,145,False,5,6
30914,18,75,78,153,False,5,6
30915,19,58,66,124,False,5,6
30916,20,47,60,107,False,5,6
30917,21,52,47,99,False,5,6
30918,22,33,43,76,False,5,6
30919,23,23,26,49,False,5,6
30920,0,16,16,32,True,6,6
30921,1,18,24,42,True,6,6
30922,2,10,13,23,True,6,6
30923,3,5,13,18,True,6,6
30924,4,13,8,21,True,6,6
30925,5,22,22,44,True,6,6
30926,6,29,15,44,True,6,6
30927,7,40,29,69,True,6,6
30928,8,67,38,105,True,6,6
30929,9,77,55,132,True,6,6
30930,10,92,114,206,True,6,6
30931,11,104,101,205,True,6,6
30932,12,131,127,258,True,6,6
30933,13,128,131,259,True,6,6
30934,14,106,123,229,True,6,6
30935,15,109,129,238,True,6,6
30936,16,104,96,200,True,6,6
30937,17,106,120,226,True,6,6
30938,18,91,120,211,True,6,6
30939,19,84,81,165,True,6,6
30940,20,61,69,130,True,6,6
30941,21,43,55,98,True,6,6
30942,22,21,16,37,True,6,6
30943,23,9,12,21,True,6,6
30944,0,17,13,30,True,0,6
30945,1,8,6,14,True,0,6
30946,2,5,8,13,True,0,6
30947,3,19,15,34,True,0,6
30948,4,70,45,115,True,0,6
30949,5,127,95,222,True,0,6
30950,6,188,102,290,True,0,6
30951,7,159,110,269,True,0,6
30952,8,153,131,284,True,0,6
30953,9,182,144,326,True,0,6
30954,10,191,156,347,True,0,6
30955,11,172,167,339,True,0,6
30956,12,177,182,359,True,0,6
30957,13,185,224,409,True,0,6
30958,14,120,174,294,True,0,6
30959,15,129,141,270,True,0,6
30960,16,107,108,215,True,0,6
30961,17,108,112,220,True,0,6
30962,18,73,98,171,True,0,6
30963,19,73,75,148,True,0,6
30964,20,78,64,142,True,0,6
30965,21,42,38,80,True,0,6
30966,22,27,34,61,True,0,6
30967,23,11,11,22,True,0,6
30968,0,16,8,24,True,1,6
30969,1,16,9,25,True,1,6
30970,2,13,3,16,True,1,6
30971,3,18,11,29,True,1,6
30972,4,71,34,105,True,1,6
30973,5,145,81,226,True,1,6
30974,6,187,100,287,True,1,6
30975,7,153,111,264,True,1,6
30976,8,131,123,254,True,1,6
30977,9,169,110,279,True,1,6
30978,10,150,158,308,True,1,6
30979,11,149,147,296,True,1,6
30980,12,192,154,346,True,1,6
30981,13,164,207,371,True,1,6
30982,14,151,203,354,True,1,6
30983,15,106,121,227,True,1,6
30984,16,89,113,202,True,1,6
30985,17,95,109,204,True,1,6
30986,18,90,93,183,True,1,6
30987,19,75,90,165,True,1,6
30988,20,69,73,142,True,1,6
30989,21,43,55,98,True,1,6
30990,22,27,26,53,True,1,6
30991,23,11,15,26,True,1,6
30992,0,10,24,34,True,2,6
30993,1,13,31,44,True,2,6
30994,2,4,31,35,True,2,6
30995,3,14,26,40,True,2,6
30996,4,67,37,104,True,2,6
30997,5,126,65,191,True,2,6
30998,6,190,103,293,True,2,6
30999,7,162,96,258,True,2,6
31000,8,154,119,273,True,2,6
31001,9,154,111,265,True,2,6
31002,10,169,137,306,True,2,6
31003,11,173,170,343,True,2,6
31004,12,183,156,339,True,2,6
31005,13,176,201,377,True,2,6
31006,14,131,202,333,True,2,6
31007,15,127,126,253,True,2,6
31008,16,113,119,232,True,2,6
31009,17,95,103,198,True,2,6
31010,18,97,107,204,True,2,6
31011,19,75,99,174,True,2,6
31012,20,77,89,166,True,2,6
31013,21,48,45,93,True,2,6
31014,22,36,43,79,True,2,6
31015,23,12,16,28,True,2,6
31016,0,14,15,29,True,3,6
31017,1,6,12,18,True,3,6
31018,2,8,8,16,True,3,6
31019,3,15,13,28,True,3,6
31020,4,66,37,103,True,3,6
31021,5,121,86,207,True,3,6
31022,6,170,106,276,True,3,6
31023,7,148,100,248,True,3,6
31024,8,142,106,248,True,3,6
31025,9,160,119,279,True,3,6
31026,10,162,121,283,True,3,6
31027,11,152,153,305,True,3,6
31028,12,167,182,349,True,3,6
31029,13,178,198,376,True,3,6
31030,14,160,156,316,True,3,6
31031,15,106,161,267,True,3,6
31032,16,118,132,250,True,3,6
31033,17,110,116,226,True,3,6
31034,18,93,83,176,True,3,6
31035,19,109,91,200,True,3,6
31036,20,69,82,151,True,3,6
31037,21,41,60,101,True,3,6
31038,22,19,27,46,True,3,6
31039,23,15,17,32,True,3,6
31040,0,16,17,33,True,4,6
31041,1,15,18,33,True,4,6
31042,2,8,7,15,True,4,6
31043,3,15,16,31,True,4,6
31044,4,64,31,95,True,4,6
31045,5,137,91,228,True,4,6
31046,6,163,71,234,True,4,6
31047,7,125,120,245,True,4,6
31048,8,148,110,258,True,4,6
31049,9,169,128,297,True,4,6
31050,10,167,134,301,True,4,6
31051,11,173,159,332,True,4,6
31052,12,186,197,383,True,4,6
31053,13,161,184,345,True,4,6
31054,14,123,174,297,True,4,6
31055,15,104,127,231,True,4,6
31056,16,94,110,204,True,4,6
31057,17,95,89,184,True,4,6
31058,18,86,67,153,True,4,6
31059,19,79,74,153,True,4,6
31060,20,57,63,120,True,4,6
31061,21,42,49,91,True,4,6
31062,22,22,32,54,True,4,6
31063,23,13,16,29,True,4,6
31064,0,10,12,22,True,5,6
31065,1,13,27,40,True,5,6
31066,2,6,9,15,True,5,6
31067,3,6,11,17,True,5,6
31068,4,16,7,23,True,5,6
31069,5,28,17,45,True,5,6
31070,6,24,33,57,True,5,6
31071,7,42,43,85,True,5,6
31072,8,56,56,112,True,5,6
31073,9,97,76,173,True,5,6
31074,10,88,79,167,True,5,6
31075,11,84,88,172,True,5,6
31076,12,96,111,207,True,5,6
31077,13,86,104,190,True,5,6
31078,14,106,108,214,True,5,6
31079,15,92,92,184,True,5,6
31080,16,83,81,164,True,5,6
31081,17,73,91,164,True,5,6
31082,18,74,86,160,True,5,6
31083,19,48,67,115,True,5,6
31084,20,45,54,99,True,5,6
31085,21,36,43,79,True,5,6
31086,22,21,44,65,True,5,6
31087,23,21,26,47,True,5,6
31088,0,14,18,32,True,6,6
31089,1,17,19,36,True,6,6
31090,2,9,17,26,True,6,6
31091,3,8,7,15,True,6,6
31092,4,8,6,14,True,6,6
31093,5,18,8,26,True,6,6
31094,6,21,8,29,True,6,6
31095,7,22,24,46,True,6,6
31096,8,63,43,106,True,6,6
31097,9,63,66,129,True,6,6
31098,10,90,82,172,True,6,6
31099,11,82,84,166,True,6,6
31100,12,118,101,219,True,6,6
31101,13,110,129,239,True,6,6
31102,14,123,138,261,True,6,6
31103,15,87,110,197,True,6,6
31104,16,94,121,215,True,6,6
31105,17,102,104,206,True,6,6
31106,18,83,108,191,True,6,6
31107,19,63,85,148,True,6,6
31108,20,54,59,113,True,6,6
31109,21,24,42,66,True,6,6
31110,22,23,25,48,True,6,6
31111,23,9,18,27,True,6,6
31112,0,10,6,16,True,0,6
31113,1,5,9,14,True,0,6
31114,2,7,4,11,True,0,6
31115,3,17,8,25,True,0,6
31116,4,62,34,96,True,0,6
31117,5,103,67,170,True,0,6
31118,6,120,70,190,True,0,6
31119,7,122,98,220,True,0,6
31120,8,132,116,248,True,0,6
31121,9,141,132,273,True,0,6
31122,10,157,140,297,True,0,6
31123,11,152,151,303,True,0,6
31124,12,146,166,312,True,0,6
31125,13,132,174,306,True,0,6
31126,14,108,149,257,True,0,6
31127,15,98,135,233,True,0,6
31128,16,111,115,226,True,0,6
31129,17,80,102,182,True,0,6
31130,18,84,80,164,True,0,6
31131,19,62,83,145,True,0,6
31132,20,49,68,117,True,0,6
31133,21,31,34,65,True,0,6
31134,22,22,25,47,True,0,6
31135,23,11,17,28,True,0,6
31136,0,7,14,21,True,1,6
31137,1,11,10,21,True,1,6
31138,2,5,4,9,True,1,6
31139,3,13,10,23,True,1,6
31140,4,59,34,93,True,1,6
31141,5,111,78,189,True,1,6
31142,6,119,99,218,True,1,6
31143,7,125,90,215,True,1,6
31144,8,134,118,252,True,1,6
31145,9,149,108,257,True,1,6
31146,10,157,146,303,True,1,6
31147,11,167,143,310,True,1,6
31148,12,151,171,322,True,1,6
31149,13,182,184,366,True,1,6
31150,14,103,138,241,True,1,6
31151,15,98,124,222,True,1,6
31152,16,112,107,219,True,1,6
31153,17,95,82,177,True,1,6
31154,18,76,100,176,True,1,6
31155,19,60,93,153,True,1,6
31156,20,44,44,88,True,1,6
31157,21,26,42,68,True,1,6
31158,22,18,17,35,True,1,6
31159,23,14,13,27,True,1,6
31160,0,8,8,16,True,2,6
31161,1,8,12,20,True,2,6
31162,2,3,9,12,True,2,6
31163,3,14,9,23,True,2,6
31164,4,51,28,79,True,2,6
31165,5,105,84,189,True,2,6
31166,6,138,83,221,True,2,6
31167,7,133,88,221,True,2,6
31168,8,134,104,238,True,2,6
31169,9,132,120,252,True,2,6
31170,10,148,132,280,True,2,6
31171,11,140,129,269,True,2,6
31172,12,164,157,321,True,2,6
31173,13,163,183,346,True,2,6
31174,14,130,142,272,True,2,6
31175,15,131,131,262,True,2,6
31176,16,100,120,220,True,2,6
31177,17,90,94,184,True,2,6
31178,18,81,74,155,True,2,6
31179,19,67,72,139,True,2,6
31180,20,38,74,112,True,2,6
31181,21,37,35,72,True,2,6
31182,22,13,22,35,True,2,6
31183,23,13,12,25,True,2,6
31184,0,13,14,27,True,3,6
31185,1,10,11,21,True,3,6
31186,2,4,9,13,True,3,6
31187,3,15,8,23,True,3,6
31188,4,48,34,82,True,3,6
31189,5,107,77,184,True,3,6
31190,6,124,76,200,True,3,6
31191,7,137,99,236,True,3,6
31192,8,139,115,254,True,3,6
31193,9,155,118,273,True,3,6
31194,10,149,131,280,True,3,6
31195,11,172,123,295,True,3,6
31196,12,165,181,346,True,3,6
31197,13,164,171,335,True,3,6
31198,14,112,170,282,True,3,6
31199,15,121,116,237,True,3,6
31200,16,113,107,220,True,3,6
31201,17,102,89,191,True,3,6
31202,18,72,83,155,True,3,6
31203,19,47,73,120,True,3,6
31204,20,34,43,77,True,3,6
31205,21,33,52,85,True,3,6
31206,22,18,21,39,True,3,6
31207,23,9,11,20,True,3,6
31208,0,15,13,28,True,4,6
31209,1,7,13,20,True,4,6
31210,2,8,9,17,True,4,6
31211,3,9,6,15,True,4,6
31212,4,52,31,83,True,4,6
31213,5,108,75,183,True,4,6
31214,6,132,81,213,True,4,6
31215,7,145,81,226,True,4,6
31216,8,119,107,226,True,4,6
31217,9,156,116,272,True,4,6
31218,10,155,143,298,True,4,6
31219,11,169,153,322,True,4,6
31220,12,166,168,334,True,4,6
31221,13,144,209,353,True,4,6
31222,14,145,144,289,True,4,6
31223,15,107,121,228,True,4,6
31224,16,87,99,186,True,4,6
31225,17,94,81,175,True,4,6
31226,18,86,88,174,True,4,6
31227,19,62,73,135,True,4,6
31228,20,56,52,108,True,4,6
31229,21,28,43,71,True,4,6
31230,22,30,37,67,True,4,6
31231,23,7,30,37,True,4,6
31232,0,12,14,26,True,5,6
31233,1,11,13,24,True,5,6
31234,2,7,11,18,True,5,6
31235,3,12,9,21,True,5,6
31236,4,10,13,23,True,5,6
31237,5,23,22,45,True,5,6
31238,6,26,22,48,True,5,6
31239,7,56,33,89,True,5,6
31240,8,67,58,125,True,5,6
31241,9,73,77,150,True,5,6
31242,10,111,76,187,True,5,6
31243,11,119,99,218,True,5,6
31244,12,123,122,245,True,5,6
31245,13,100,126,226,True,5,6
31246,14,105,122,227,True,5,6
31247,15,103,113,216,True,5,6
31248,16,99,105,204,True,5,6
31249,17,85,72,157,True,5,6
31250,18,81,91,172,True,5,6
31251,19,60,60,120,True,5,6
31252,20,44,55,99,True,5,6
31253,21,38,40,78,True,5,6
31254,22,36,32,68,True,5,6
31255,23,22,28,50,True,5,6
31256,0,18,15,33,True,6,6
31257,1,21,30,51,True,6,6
31258,2,17,23,40,True,6,6
31259,3,6,10,16,True,6,6
31260,4,14,8,22,True,6,6
31261,5,16,11,27,True,6,6
31262,6,23,7,30,True,6,6
31263,7,27,28,55,True,6,6
31264,8,74,39,113,True,6,6
31265,9,95,57,152,True,6,6
31266,10,131,99,230,True,6,6
31267,11,131,93,224,True,6,6
31268,12,110,123,233,True,6,6
31269,13,135,126,261,True,6,6
31270,14,121,127,248,True,6,6
31271,15,105,162,267,True,6,6
31272,16,135,130,265,True,6,6
31273,17,99,104,203,True,6,6
31274,18,136,113,249,True,6,6
31275,19,80,106,186,True,6,6
31276,20,48,55,103,True,6,6
31277,21,40,58,98,True,6,6
31278,22,15,30,45,True,6,6
31279,23,17,14,31,True,6,6
31280,0,7,9,16,True,0,6
31281,1,10,12,22,True,0,6
31282,2,7,8,15,True,0,6
31283,3,16,12,28,True,0,6
31284,4,61,32,93,True,0,6
31285,5,94,64,158,True,0,6
31286,6,147,71,218,True,0,6
31287,7,122,89,211,True,0,6
31288,8,134,102,236,True,0,6
31289,9,153,131,284,True,0,6
31290,10,195,154,349,True,0,6
31291,11,167,133,300,True,0,6
31292,12,180,164,344,True,0,6
31293,13,174,179,353,True,0,6
31294,14,132,169,301,True,0,6
31295,15,133,128,261,True,0,6
31296,16,106,125,231,True,0,6
31297,17,89,106,195,True,0,6
31298,18,71,91,162,True,0,6
31299,19,60,57,117,True,0,6
31300,20,44,173,217,True,0,6
31301,21,25,185,210,True,0,6
31302,22,27,33,60,True,0,6
31303,23,15,16,31,True,0,6
31304,0,7,5,12,True,1,6
31305,1,6,14,20,True,1,6
31306,2,12,4,16,True,1,6
31307,3,18,9,27,True,1,6
31308,4,56,25,81,True,1,6
31309,5,110,77,187,True,1,6
31310,6,124,87,211,True,1,6
31311,7,140,86,226,True,1,6
31312,8,128,97,225,True,1,6
31313,9,152,139,291,True,1,6
31314,10,179,125,304,True,1,6
31315,11,159,135,294,True,1,6
31316,12,179,169,348,True,1,6
31317,13,183,180,363,True,1,6
31318,14,129,166,295,True,1,6
31319,15,131,124,255,True,1,6
31320,16,101,107,208,True,1,6
31321,17,85,100,185,True,1,6
31322,18,83,124,207,True,1,6
31323,19,62,89,151,True,1,6
31324,20,56,57,113,True,1,6
31325,21,25,88,113,True,1,6
31326,22,13,24,37,True,1,6
31327,23,9,16,25,True,1,6
31328,0,9,7,16,True,2,6
31329,1,6,14,20,True,2,6
31330,2,6,9,15,True,2,6
31331,3,17,11,28,True,2,6
31332,4,45,24,69,True,2,6
31333,5,101,71,172,True,2,6
31334,6,146,85,231,True,2,6
31335,7,146,97,243,True,2,6
31336,8,151,104,255,True,2,6
31337,9,138,125,263,True,2,6
31338,10,149,113,262,True,2,6
31339,11,142,123,265,True,2,6
31340,12,157,163,320,True,2,6
31341,13,141,158,299,True,2,6
31342,14,133,155,288,True,2,6
31343,15,98,120,218,True,2,6
31344,16,94,96,190,True,2,6
31345,17,111,107,218,True,2,6
31346,18,66,68,134,True,2,6
31347,19,57,72,129,True,2,6
31348,20,66,52,118,True,2,6
31349,21,46,42,88,True,2,6
31350,22,25,27,52,True,2,6
31351,23,18,19,37,True,2,6
31352,0,13,15,28,True,3,6
31353,1,20,22,42,True,3,6
31354,2,10,6,16,True,3,6
31355,3,20,9,29,True,3,6
31356,4,46,31,77,True,3,6
31357,5,93,67,160,True,3,6
31358,6,121,83,204,True,3,6
31359,7,123,99,222,True,3,6
31360,8,139,105,244,True,3,6
31361,9,133,126,259,True,3,6
31362,10,141,135,276,True,3,6
31363,11,124,126,250,True,3,6
31364,12,183,146,329,True,3,6
31365,13,154,197,351,True,3,6
31366,14,105,152,257,True,3,6
31367,15,127,116,243,True,3,6
31368,16,108,112,220,True,3,6
31369,17,91,100,191,True,3,6
31370,18,85,101,186,True,3,6
31371,19,77,92,169,True,3,6
31372,20,54,57,111,True,3,6
31373,21,35,70,105,True,3,6
31374,22,22,26,48,True,3,6
31375,23,12,24,36,True,3,6
31376,0,8,22,30,True,4,6
31377,1,5,21,26,True,4,6
31378,2,11,14,25,True,4,6
31379,3,17,9,26,True,4,6
31380,4,64,30,94,True,4,6
31381,5,86,69,155,True,4,6
31382,6,106,78,184,True,4,6
31383,7,142,91,233,True,4,6
31384,8,123,114,237,True,4,6
31385,9,154,131,285,True,4,6
31386,10,142,133,275,True,4,6
31387,11,132,153,285,True,4,6
31388,12,140,178,318,True,4,6
31389,13,144,146,290,True,4,6
31390,14,125,136,261,True,4,6
31391,15,102,124,226,True,4,6
31392,16,99,113,212,True,4,6
31393,17,101,94,195,True,4,6
31394,18,74,83,157,True,4,6
31395,19,59,86,145,True,4,6
31396,20,63,70,133,True,4,6
31397,21,50,53,103,True,4,6
31398,22,31,27,58,True,4,6
31399,23,16,18,34,True,4,6
31400,0,13,19,32,True,5,6
31401,1,10,18,28,True,5,6
31402,2,8,10,18,True,5,6
31403,3,4,3,7,True,5,6
31404,4,14,4,18,True,5,6
31405,5,25,24,49,True,5,6
31406,6,28,36,64,True,5,6
31407,7,59,40,99,True,5,6
31408,8,73,66,139,True,5,6
31409,9,98,96,194,True,5,6
31410,10,108,94,202,True,5,6
31411,11,112,103,215,True,5,6
31412,12,92,100,192,True,5,6
31413,13,91,98,189,True,5,6
31414,14,87,100,187,True,5,6
31415,15,88,120,208,True,5,6
31416,16,93,80,173,True,5,6
31417,17,75,94,169,True,5,6
31418,18,79,81,160,True,5,6
31419,19,60,73,133,True,5,6
31420,20,51,64,115,True,5,6
31421,21,25,51,76,True,5,6
31422,22,33,39,72,True,5,6
31423,23,25,29,54,True,5,6
31424,0,16,26,42,True,6,6
31425,1,26,30,56,True,6,6
31426,2,11,24,35,True,6,6
31427,3,10,12,22,True,6,6
31428,4,15,12,27,True,6,6
31429,5,19,17,36,True,6,6
31430,6,25,12,37,True,6,6
31431,7,53,30,83,True,6,6
31432,8,68,36,104,True,6,6
31433,9,77,65,142,True,6,6
31434,10,101,89,190,True,6,6
31435,11,110,108,218,True,6,6
31436,12,121,97,218,True,6,6
31437,13,107,111,218,True,6,6
31438,14,101,117,218,True,6,6
31439,15,121,134,255,True,6,6
31440,16,109,127,236,True,6,6
31441,17,119,104,223,True,6,6
31442,18,99,151,250,True,6,6
31443,19,86,104,190,True,6,6
31444,20,53,72,125,True,6,6
31445,21,41,57,98,True,6,6
31446,22,17,18,35,True,6,6
31447,23,16,14,30,True,6,6
31448,0,5,6,11,False,0,6
31449,1,12,8,20,False,0,6
31450,2,5,4,9,False,0,6
31451,3,13,9,22,False,0,6
31452,4,61,35,96,False,0,6
31453,5,117,75,192,False,0,6
31454,6,190,78,268,False,0,6
31455,7,166,101,267,False,0,6
31456,8,156,122,278,False,0,6
31457,9,166,132,298,False,0,6
31458,10,181,141,322,False,0,6
31459,11,153,168,321,False,0,6
31460,12,166,180,346,False,0,6
31461,13,186,212,398,False,0,6
31462,14,133,176,309,False,0,6
31463,15,132,136,268,False,0,6
31464,16,125,110,235,False,0,6
31465,17,103,118,221,False,0,6
31466,18,108,100,208,False,0,6
31467,19,75,98,173,False,0,6
31468,20,72,215,287,False,0,6
31469,21,46,160,206,False,0,6
31470,22,23,83,106,False,0,6
31471,23,9,32,41,False,0,6
31472,0,9,20,29,False,1,6
31473,1,12,23,35,False,1,6
31474,2,5,20,25,False,1,6
31475,3,13,25,38,False,1,6
31476,4,66,36,102,False,1,6
31477,5,134,87,221,False,1,6
31478,6,172,101,273,False,1,6
31479,7,146,100,246,False,1,6
31480,8,147,122,269,False,1,6
31481,9,153,129,282,False,1,6
31482,10,163,161,324,False,1,6
31483,11,192,166,358,False,1,6
31484,12,168,209,377,False,1,6
31485,13,189,221,410,False,1,6
31486,14,161,194,355,False,1,6
31487,15,135,161,296,False,1,6
31488,16,128,115,243,False,1,6
31489,17,130,122,252,False,1,6
31490,18,102,106,208,False,1,6
31491,19,90,89,179,False,1,6
31492,20,58,65,123,False,1,6
31493,21,42,41,83,False,1,6
31494,22,19,28,47,False,1,6
31495,23,15,19,34,False,1,6
31496,0,9,5,14,False,2,6
31497,1,9,9,18,False,2,6
31498,2,9,7,16,False,2,6
31499,3,14,8,22,False,2,6
31500,4,73,31,104,False,2,6
31501,5,163,96,259,False,2,6
31502,6,206,113,319,False,2,6
31503,7,172,117,289,False,2,6
31504,8,204,117,321,False,2,6
31505,9,161,130,291,False,2,6
31506,10,213,178,391,False,2,6
31507,11,181,183,364,False,2,6
31508,12,221,212,433,False,2,6
31509,13,212,261,473,False,2,6
31510,14,190,227,417,False,2,6
31511,15,145,166,311,False,2,6
31512,16,133,151,284,False,2,6
31513,17,133,127,260,False,2,6
31514,18,97,101,198,False,2,6
31515,19,72,104,176,False,2,6
31516,20,49,55,104,False,2,6
31517,21,33,47,80,False,2,6
31518,22,12,33,45,False,2,6
31519,23,14,13,27,False,2,6
31520,0,16,13,29,False,3,7
31521,1,8,12,20,False,3,7
31522,2,6,5,11,False,3,7
31523,3,13,8,21,False,3,7
31524,4,59,38,97,False,3,7
31525,5,129,74,203,False,3,7
31526,6,185,101,286,False,3,7
31527,7,171,108,279,False,3,7
31528,8,194,142,336,False,3,7
31529,9,210,161,371,False,3,7
31530,10,199,173,372,False,3,7
31531,11,206,182,388,False,3,7
31532,12,177,193,370,False,3,7
31533,13,202,232,434,False,3,7
31534,14,190,230,420,False,3,7
31535,15,136,161,297,False,3,7
31536,16,138,133,271,False,3,7
31537,17,124,137,261,False,3,7
31538,18,96,104,200,False,3,7
31539,19,68,109,177,False,3,7
31540,20,64,222,286,False,3,7
31541,21,31,192,223,False,3,7
31542,22,22,75,97,False,3,7
31543,23,16,50,66,False,3,7
31544,0,13,38,51,False,4,7
31545,1,15,48,63,False,4,7
31546,2,19,32,51,False,4,7
31547,3,17,11,28,False,4,7
31548,4,63,35,98,False,4,7
31549,5,120,92,212,False,4,7
31550,6,186,101,287,False,4,7
31551,7,143,101,244,False,4,7
31552,8,160,130,290,False,4,7
31553,9,171,123,294,False,4,7
31554,10,169,133,302,False,4,7
31555,11,178,183,361,False,4,7
31556,12,184,205,389,False,4,7
31557,13,213,228,441,False,4,7
31558,14,166,206,372,False,4,7
31559,15,119,136,255,False,4,7
31560,16,117,126,243,False,4,7
31561,17,115,98,213,False,4,7
31562,18,95,88,183,False,4,7
31563,19,80,108,188,False,4,7
31564,20,59,75,134,False,4,7
31565,21,45,50,95,False,4,7
31566,22,30,41,71,False,4,7
31567,23,18,28,46,False,4,7
31568,0,5,14,19,False,5,7
31569,1,10,14,24,False,5,7
31570,2,5,18,23,False,5,7
31571,3,11,7,18,False,5,7
31572,4,23,17,40,False,5,7
31573,5,27,17,44,False,5,7
31574,6,29,26,55,False,5,7
31575,7,53,45,98,False,5,7
31576,8,71,54,125,False,5,7
31577,9,95,82,177,False,5,7
31578,10,112,109,221,False,5,7
31579,11,119,103,222,False,5,7
31580,12,113,119,232,False,5,7
31581,13,132,132,264,False,5,7
31582,14,107,118,225,False,5,7
31583,15,100,119,219,False,5,7
31584,16,96,104,200,False,5,7
31585,17,74,92,166,False,5,7
31586,18,75,73,148,False,5,7
31587,19,72,73,145,False,5,7
31588,20,52,69,121,False,5,7
31589,21,34,51,85,False,5,7
31590,22,27,42,69,False,5,7
31591,23,11,24,35,False,5,7
31592,0,13,15,28,True,6,7
31593,1,20,30,50,True,6,7
31594,2,19,15,34,True,6,7
31595,3,10,11,21,True,6,7
31596,4,23,15,38,True,6,7
31597,5,12,21,33,True,6,7
31598,6,34,15,49,True,6,7
31599,7,34,28,62,True,6,7
31600,8,75,48,123,True,6,7
31601,9,73,52,125,True,6,7
31602,10,120,109,229,True,6,7
31603,11,135,123,258,True,6,7
31604,12,137,123,260,True,6,7
31605,13,131,155,286,True,6,7
31606,14,102,142,244,True,6,7
31607,15,122,107,229,True,6,7
31608,16,131,125,256,True,6,7
31609,17,132,130,262,True,6,7
31610,18,115,136,251,True,6,7
31611,19,93,110,203,True,6,7
31612,20,53,74,127,True,6,7
31613,21,30,59,89,True,6,7
31614,22,19,36,55,True,6,7
31615,23,13,15,28,True,6,7
31616,0,10,8,18,False,0,7
31617,1,3,8,11,False,0,7
31618,2,7,5,12,False,0,7
31619,3,17,15,32,False,0,7
31620,4,76,43,119,False,0,7
31621,5,181,152,333,False,0,7
31622,6,271,139,410,False,0,7
31623,7,207,125,332,False,0,7
31624,8,184,129,313,False,0,7
31625,9,194,138,332,False,0,7
31626,10,199,170,369,False,0,7
31627,11,194,189,383,False,0,7
31628,12,204,215,419,False,0,7
31629,13,201,284,485,False,0,7
31630,14,163,237,400,False,0,7
31631,15,152,166,318,False,0,7
31632,16,138,140,278,False,0,7
31633,17,111,117,228,False,0,7
31634,18,125,103,228,False,0,7
31635,19,86,125,211,False,0,7
31636,20,56,70,126,False,0,7
31637,21,27,43,70,False,0,7
31638,22,17,23,40,False,0,7
31639,23,17,11,28,False,0,7
31640,0,6,9,15,False,1,7
31641,1,11,8,19,False,1,7
31642,2,8,9,17,False,1,7
31643,3,12,15,27,False,1,7
31644,4,79,43,122,False,1,7
31645,5,178,94,272,False,1,7
31646,6,287,128,415,False,1,7
31647,7,208,131,339,False,1,7
31648,8,166,120,286,False,1,7
31649,9,193,153,346,False,1,7
31650,10,201,177,378,False,1,7
31651,11,191,189,380,False,1,7
31652,12,204,213,417,False,1,7
31653,13,237,287,524,False,1,7
31654,14,184,267,451,False,1,7
31655,15,138,166,304,False,1,7
31656,16,158,125,283,False,1,7
31657,17,125,134,259,False,1,7
31658,18,96,125,221,False,1,7
31659,19,90,94,184,False,1,7
31660,20,58,72,130,False,1,7
31661,21,27,36,63,False,1,7
31662,22,18,24,42,False,1,7
31663,23,17,16,33,False,1,7
31664,0,4,11,15,False,2,7
31665,1,6,6,12,False,2,7
31666,2,4,10,14,False,2,7
31667,3,14,10,24,False,2,7
31668,4,75,46,121,False,2,7
31669,5,166,99,265,False,2,7
31670,6,295,132,427,False,2,7
31671,7,204,131,335,False,2,7
31672,8,191,135,326,False,2,7
31673,9,209,181,390,False,2,7
31674,10,201,186,387,False,2,7
31675,11,204,181,385,False,2,7
31676,12,220,225,445,False,2,7
31677,13,223,276,499,False,2,7
31678,14,215,233,448,False,2,7
31679,15,159,182,341,False,2,7
31680,16,130,122,252,False,2,7
31681,17,129,131,260,False,2,7
31682,18,88,121,209,False,2,7
31683,19,84,115,199,False,2,7
31684,20,74,102,176,False,2,7
31685,21,39,46,85,False,2,7
31686,22,21,34,55,False,2,7
31687,23,17,16,33,False,2,7
31688,0,6,12,18,False,3,7
31689,1,8,17,25,False,3,7
31690,2,11,10,21,False,3,7
31691,3,13,11,24,False,3,7
31692,4,74,41,115,False,3,7
31693,5,197,100,297,False,3,7
31694,6,257,143,400,False,3,7
31695,7,213,131,344,False,3,7
31696,8,190,134,324,False,3,7
31697,9,231,171,402,False,3,7
31698,10,219,173,392,False,3,7
31699,11,211,188,399,False,3,7
31700,12,218,215,433,False,3,7
31701,13,244,317,561,False,3,7
31702,14,200,273,473,False,3,7
31703,15,152,183,335,False,3,7
31704,16,167,153,320,False,3,7
31705,17,128,139,267,False,3,7
31706,18,113,109,222,False,3,7
31707,19,77,93,170,False,3,7
31708,20,59,267,326,False,3,7
31709,21,36,171,207,False,3,7
31710,22,22,37,59,False,3,7
31711,23,19,16,35,False,3,7
31712,0,25,16,41,False,4,7
31713,1,20,13,33,False,4,7
31714,2,18,6,24,False,4,7
31715,3,15,9,24,False,4,7
31716,4,69,38,107,False,4,7
31717,5,183,82,265,False,4,7
31718,6,293,132,425,False,4,7
31719,7,215,146,361,False,4,7
31720,8,224,164,388,False,4,7
31721,9,232,171,403,False,4,7
31722,10,207,183,390,False,4,7
31723,11,214,215,429,False,4,7
31724,12,243,257,500,False,4,7
31725,13,288,293,581,False,4,7
31726,14,188,250,438,False,4,7
31727,15,158,191,349,False,4,7
31728,16,144,139,283,False,4,7
31729,17,137,122,259,False,4,7
31730,18,103,100,203,False,4,7
31731,19,90,89,179,False,4,7
31732,20,71,95,166,False,4,7
31733,21,41,66,107,False,4,7
31734,22,28,39,67,False,4,7
31735,23,15,19,34,False,4,7
31736,0,8,21,29,False,5,7
31737,1,12,18,30,False,5,7
31738,2,8,10,18,False,5,7
31739,3,9,7,16,False,5,7
31740,4,20,13,33,False,5,7
31741,5,32,26,58,False,5,7
31742,6,42,25,67,False,5,7
31743,7,82,49,131,False,5,7
31744,8,120,91,211,False,5,7
31745,9,126,122,248,False,5,7
31746,10,162,134,296,False,5,7
31747,11,157,125,282,False,5,7
31748,12,195,154,349,False,5,7
31749,13,179,182,361,False,5,7
31750,14,139,184,323,False,5,7
31751,15,135,149,284,False,5,7
31752,16,140,162,302,False,5,7
31753,17,109,135,244,False,5,7
31754,18,105,106,211,False,5,7
31755,19,80,78,158,False,5,7
31756,20,75,86,161,False,5,7
31757,21,54,54,108,False,5,7
31758,22,43,58,101,False,5,7
31759,23,18,25,43,False,5,7
31760,0,27,20,47,True,6,7
31761,1,18,30,48,True,6,7
31762,2,12,18,30,True,6,7
31763,3,20,8,28,True,6,7
31764,4,11,8,19,True,6,7
31765,5,23,13,36,True,6,7
31766,6,32,12,44,True,6,7
31767,7,48,49,97,True,6,7
31768,8,115,54,169,True,6,7
31769,9,165,94,259,True,6,7
31770,10,145,130,275,True,6,7
31771,11,170,158,328,True,6,7
31772,12,168,165,333,True,6,7
31773,13,153,173,326,True,6,7
31774,14,142,199,341,True,6,7
31775,15,164,164,328,True,6,7
31776,16,134,137,271,True,6,7
31777,17,137,149,286,True,6,7
31778,18,123,137,260,True,6,7
31779,19,100,105,205,True,6,7
31780,20,67,89,156,True,6,7
31781,21,43,70,113,True,6,7
31782,22,31,57,88,True,6,7
31783,23,5,14,19,True,6,7
31784,0,12,10,22,False,0,7
31785,1,2,6,8,False,0,7
31786,2,4,5,9,False,0,7
31787,3,18,10,28,False,0,7
31788,4,107,48,155,False,0,7
31789,5,219,140,359,False,0,7
31790,6,400,173,573,False,0,7
31791,7,270,179,449,False,0,7
31792,8,219,147,366,False,0,7
31793,9,212,162,374,False,0,7
31794,10,186,194,380,False,0,7
31795,11,212,200,412,False,0,7
31796,12,234,259,493,False,0,7
31797,13,253,348,601,False,0,7
31798,14,250,311,561,False,0,7
31799,15,166,183,349,False,0,7
31800,16,155,155,310,False,0,7
31801,17,129,126,255,False,0,7
31802,18,110,123,233,False,0,7
31803,19,71,92,163,False,0,7
31804,20,59,64,123,False,0,7
31805,21,39,49,88,False,0,7
31806,22,30,34,64,False,0,7
31807,23,17,24,41,False,0,7
31808,0,11,11,22,False,1,7
31809,1,5,13,18,False,1,7
31810,2,4,6,10,False,1,7
31811,3,17,10,27,False,1,7
31812,4,99,48,147,False,1,7
31813,5,228,132,360,False,1,7
31814,6,330,139,469,False,1,7
31815,7,271,169,440,False,1,7
31816,8,241,183,424,False,1,7
31817,9,220,200,420,False,1,7
31818,10,200,195,395,False,1,7
31819,11,243,209,452,False,1,7
31820,12,209,231,440,False,1,7
31821,13,255,349,604,False,1,7
31822,14,224,300,524,False,1,7
31823,15,171,206,377,False,1,7
31824,16,179,141,320,False,1,7
31825,17,157,142,299,False,1,7
31826,18,107,120,227,False,1,7
31827,19,100,120,220,False,1,7
31828,20,53,103,156,False,1,7
31829,21,36,50,86,False,1,7
31830,22,17,41,58,False,1,7
31831,23,19,20,39,False,1,7
31832,0,15,18,33,False,2,7
31833,1,9,13,22,False,2,7
31834,2,12,10,22,False,2,7
31835,3,19,13,32,False,2,7
31836,4,90,44,134,False,2,7
31837,5,219,111,330,False,2,7
31838,6,383,175,558,False,2,7
31839,7,247,176,423,False,2,7
31840,8,212,146,358,False,2,7
31841,9,217,176,393,False,2,7
31842,10,212,208,420,False,2,7
31843,11,236,210,446,False,2,7
31844,12,255,266,521,False,2,7
31845,13,240,334,574,False,2,7
31846,14,228,299,527,False,2,7
31847,15,147,231,378,False,2,7
31848,16,164,168,332,False,2,7
31849,17,132,149,281,False,2,7
31850,18,122,124,246,False,2,7
31851,19,91,124,215,False,2,7
31852,20,66,352,418,False,2,7
31853,21,41,240,281,False,2,7
31854,22,28,161,189,False,2,7
31855,23,20,100,120,False,2,7
31856,0,15,49,64,False,3,7
31857,1,20,29,49,False,3,7
31858,2,10,15,25,False,3,7
31859,3,13,7,20,False,3,7
31860,4,106,50,156,False,3,7
31861,5,223,103,326,False,3,7
31862,6,348,181,529,False,3,7
31863,7,245,142,387,False,3,7
31864,8,231,163,394,False,3,7
31865,9,258,201,459,False,3,7
31866,10,233,224,457,False,3,7
31867,11,218,211,429,False,3,7
31868,12,234,257,491,False,3,7
31869,13,269,333,602,False,3,7
31870,14,233,279,512,False,3,7
31871,15,163,201,364,False,3,7
31872,16,184,181,365,False,3,7
31873,17,142,141,283,False,3,7
31874,18,120,141,261,False,3,7
31875,19,92,115,207,False,3,7
31876,20,73,89,162,False,3,7
31877,21,41,70,111,False,3,7
31878,22,35,44,79,False,3,7
31879,23,27,26,53,False,3,7
31880,0,21,17,38,False,4,7
31881,1,7,13,20,False,4,7
31882,2,6,9,15,False,4,7
31883,3,16,10,26,False,4,7
31884,4,80,44,124,False,4,7
31885,5,232,119,351,False,4,7
31886,6,347,175,522,False,4,7
31887,7,229,153,382,False,4,7
31888,8,217,166,383,False,4,7
31889,9,233,183,416,False,4,7
31890,10,229,222,451,False,4,7
31891,11,239,236,475,False,4,7
31892,12,221,256,477,False,4,7
31893,13,253,312,565,False,4,7
31894,14,216,251,467,False,4,7
31895,15,152,184,336,False,4,7
31896,16,148,139,287,False,4,7
31897,17,131,124,255,False,4,7
31898,18,120,93,213,False,4,7
31899,19,84,103,187,False,4,7
31900,20,58,76,134,False,4,7
31901,21,38,54,92,False,4,7
31902,22,38,59,97,False,4,7
31903,23,23,34,57,False,4,7
31904,0,25,34,59,False,5,7
31905,1,22,30,52,False,5,7
31906,2,5,15,20,False,5,7
31907,3,17,9,26,False,5,7
31908,4,23,13,36,False,5,7
31909,5,30,27,57,False,5,7
31910,6,33,33,66,False,5,7
31911,7,60,50,110,False,5,7
31912,8,99,77,176,False,5,7
31913,9,145,108,253,False,5,7
31914,10,147,125,272,False,5,7
31915,11,181,151,332,False,5,7
31916,12,151,153,304,False,5,7
31917,13,165,191,356,False,5,7
31918,14,137,155,292,False,5,7
31919,15,124,141,265,False,5,7
31920,16,167,163,330,False,5,7
31921,17,108,125,233,False,5,7
31922,18,102,101,203,False,5,7
31923,19,98,92,190,False,5,7
31924,20,70,75,145,False,5,7
31925,21,51,67,118,False,5,7
31926,22,44,57,101,False,5,7
31927,23,27,34,61,False,5,7
31928,0,34,38,72,True,6,7
31929,1,42,37,79,True,6,7
31930,2,17,22,39,True,6,7
31931,3,19,13,32,True,6,7
31932,4,17,8,25,True,6,7
31933,5,22,20,42,True,6,7
31934,6,37,11,48,True,6,7
31935,7,49,48,97,True,6,7
31936,8,97,59,156,True,6,7
31937,9,125,83,208,True,6,7
31938,10,149,137,286,True,6,7
31939,11,164,193,357,True,6,7
31940,12,173,195,368,True,6,7
31941,13,147,184,331,True,6,7
31942,14,156,232,388,True,6,7
31943,15,160,169,329,True,6,7
31944,16,146,151,297,True,6,7
31945,17,118,127,245,True,6,7
31946,18,149,138,287,True,6,7
31947,19,86,133,219,True,6,7
31948,20,62,77,139,True,6,7
31949,21,34,42,76,True,6,7
31950,22,22,25,47,True,6,7
31951,23,10,11,21,True,6,7
31952,0,8,11,19,False,0,7
31953,1,7,8,15,False,0,7
31954,2,6,11,17,False,0,7
31955,3,19,7,26,False,0,7
31956,4,107,41,148,False,0,7
31957,5,248,161,409,False,0,7
31958,6,446,202,648,False,0,7
31959,7,266,165,431,False,0,7
31960,8,238,152,390,False,0,7
31961,9,210,182,392,False,0,7
31962,10,236,192,428,False,0,7
31963,11,211,210,421,False,0,7
31964,12,236,270,506,False,0,7
31965,13,258,362,620,False,0,7
31966,14,235,344,579,False,0,7
31967,15,179,178,357,False,0,7
31968,16,166,144,310,False,0,7
31969,17,134,121,255,False,0,7
31970,18,114,135,249,False,0,7
31971,19,86,116,202,False,0,7
31972,20,59,67,126,False,0,7
31973,21,45,44,89,False,0,7
31974,22,16,18,34,False,0,7
31975,23,10,13,23,False,0,7
31976,0,7,7,14,False,1,7
31977,1,4,9,13,False,1,7
31978,2,13,8,21,False,1,7
31979,3,18,10,28,False,1,7
31980,4,114,41,155,False,1,7
31981,5,257,138,395,False,1,7
31982,6,372,177,549,False,1,7
31983,7,266,162,428,False,1,7
31984,8,228,172,400,False,1,7
31985,9,227,180,407,False,1,7
31986,10,225,183,408,False,1,7
31987,11,238,210,448,False,1,7
31988,12,262,267,529,False,1,7
31989,13,272,325,597,False,1,7
31990,14,231,310,541,False,1,7
31991,15,159,200,359,False,1,7
31992,16,187,150,337,False,1,7
31993,17,134,146,280,False,1,7
31994,18,106,125,231,False,1,7
31995,19,99,148,247,False,1,7
31996,20,65,61,126,False,1,7
31997,21,28,43,71,False,1,7
31998,22,16,22,38,False,1,7
31999,23,6,8,14,False,1,7
32000,0,9,5,14,False,2,7
32001,1,6,10,16,False,2,7
32002,2,7,11,18,False,2,7
32003,3,20,7,27,False,2,7
32004,4,103,47,150,False,2,7
32005,5,243,158,401,False,2,7
32006,6,393,209,602,False,2,7
32007,7,247,155,402,False,2,7
32008,8,272,149,421,False,2,7
32009,9,229,173,402,False,2,7
32010,10,217,184,401,False,2,7
32011,11,196,202,398,False,2,7
32012,12,240,271,511,False,2,7
32013,13,269,342,611,False,2,7
32014,14,266,276,542,False,2,7
32015,15,202,194,396,False,2,7
32016,16,257,139,396,False,2,7
32017,17,191,180,371,False,2,7
32018,18,137,243,380,False,2,7
32019,19,108,121,229,False,2,7
32020,20,71,92,163,False,2,7
32021,21,34,61,95,False,2,7
32022,22,22,31,53,False,2,7
32023,23,9,9,18,False,2,7
32024,0,8,12,20,False,3,7
32025,1,5,13,18,False,3,7
32026,2,7,6,13,False,3,7
32027,3,16,10,26,False,3,7
32028,4,119,52,171,False,3,7
32029,5,248,130,378,False,3,7
32030,6,389,208,597,False,3,7
32031,7,253,165,418,False,3,7
32032,8,249,140,389,False,3,7
32033,9,240,176,416,False,3,7
32034,10,231,195,426,False,3,7
32035,11,244,222,466,False,3,7
32036,12,254,276,530,False,3,7
32037,13,258,319,577,False,3,7
32038,14,262,289,551,False,3,7
32039,15,175,197,372,False,3,7
32040,16,214,158,372,False,3,7
32041,17,145,168,313,False,3,7
32042,18,116,215,331,False,3,7
32043,19,96,126,222,False,3,7
32044,20,71,76,147,False,3,7
32045,21,41,52,93,False,3,7
32046,22,20,26,46,False,3,7
32047,23,28,23,51,False,3,7
32048,0,14,64,78,False,4,7
32049,1,14,46,60,False,4,7
32050,2,10,41,51,False,4,7
32051,3,18,4,22,False,4,7
32052,4,103,43,146,False,4,7
32053,5,230,127,357,False,4,7
32054,6,376,208,584,False,4,7
32055,7,250,139,389,False,4,7
32056,8,201,166,367,False,4,7
32057,9,260,171,431,False,4,7
32058,10,201,190,391,False,4,7
32059,11,211,205,416,False,4,7
32060,12,277,254,531,False,4,7
32061,13,282,354,636,False,4,7
32062,14,223,278,501,False,4,7
32063,15,161,199,360,False,4,7
32064,16,153,166,319,False,4,7
32065,17,119,116,235,False,4,7
32066,18,112,100,212,False,4,7
32067,19,80,92,172,False,4,7
32068,20,82,79,161,False,4,7
32069,21,40,57,97,False,4,7
32070,22,31,36,67,False,4,7
32071,23,17,29,46,False,4,7
32072,0,21,27,48,False,5,7
32073,1,17,37,54,False,5,7
32074,2,9,10,19,False,5,7
32075,3,13,8,21,False,5,7
32076,4,24,12,36,False,5,7
32077,5,23,28,51,False,5,7
32078,6,47,36,83,False,5,7
32079,7,54,53,107,False,5,7
32080,8,101,72,173,False,5,7
32081,9,137,103,240,False,5,7
32082,10,148,130,278,False,5,7
32083,11,154,152,306,False,5,7
32084,12,126,147,273,False,5,7
32085,13,156,174,330,False,5,7
32086,14,131,161,292,False,5,7
32087,15,113,132,245,False,5,7
32088,16,117,119,236,False,5,7
32089,17,97,105,202,False,5,7
32090,18,75,83,158,False,5,7
32091,19,63,76,139,False,5,7
32092,20,42,68,110,False,5,7
32093,21,57,67,124,False,5,7
32094,22,41,50,91,False,5,7
32095,23,31,34,65,False,5,7
32096,0,19,30,49,True,6,7
32097,1,25,29,54,True,6,7
32098,2,15,28,43,True,6,7
32099,3,15,8,23,True,6,7
32100,4,17,14,31,True,6,7
32101,5,19,20,39,True,6,7
32102,6,25,19,44,True,6,7
32103,7,81,44,125,True,6,7
32104,8,241,63,304,True,6,7
32105,9,218,110,328,True,6,7
32106,10,171,191,362,True,6,7
32107,11,153,257,410,True,6,7
32108,12,151,254,405,True,6,7
32109,13,158,199,357,True,6,7
32110,14,155,198,353,True,6,7
32111,15,158,201,359,True,6,7
32112,16,180,191,371,True,6,7
32113,17,149,157,306,True,6,7
32114,18,178,158,336,True,6,7
32115,19,92,129,221,True,6,7
32116,20,75,91,166,True,6,7
32117,21,27,40,67,True,6,7
32118,22,24,31,55,True,6,7
32119,23,18,17,35,True,6,7
32120,0,11,5,16,False,0,7
32121,1,2,9,11,False,0,7
32122,2,8,6,14,False,0,7
32123,3,25,10,35,False,0,7
32124,4,123,54,177,False,0,7
32125,5,254,142,396,False,0,7
32126,6,364,212,576,False,0,7
32127,7,265,167,432,False,0,7
32128,8,201,157,358,False,0,7
32129,9,222,171,393,False,0,7
32130,10,238,201,439,False,0,7
32131,11,211,219,430,False,0,7
32132,12,272,257,529,False,0,7
32133,13,258,338,596,False,0,7
32134,14,241,366,607,False,0,7
32135,15,179,255,434,False,0,7
32136,16,142,163,305,False,0,7
32137,17,131,142,273,False,0,7
32138,18,134,142,276,False,0,7
32139,19,114,137,251,False,0,7
32140,20,48,101,149,False,0,7
32141,21,34,58,92,False,0,7
32142,22,15,15,30,False,0,7
32143,23,9,9,18,False,0,7
32144,0,13,6,19,False,1,7
32145,1,9,8,17,False,1,7
32146,2,6,7,13,False,1,7
32147,3,27,11,38,False,1,7
32148,4,103,61,164,False,1,7
32149,5,255,120,375,False,1,7
32150,6,392,194,586,False,1,7
32151,7,250,160,410,False,1,7
32152,8,249,154,403,False,1,7
32153,9,245,209,454,False,1,7
32154,10,227,200,427,False,1,7
32155,11,236,222,458,False,1,7
32156,12,248,253,501,False,1,7
32157,13,255,349,604,False,1,7
32158,14,194,271,465,False,1,7
32159,15,171,185,356,False,1,7
32160,16,197,148,345,False,1,7
32161,17,153,184,337,False,1,7
32162,18,125,141,266,False,1,7
32163,19,95,132,227,False,1,7
32164,20,88,102,190,False,1,7
32165,21,53,58,111,False,1,7
32166,22,23,28,51,False,1,7
32167,23,8,5,13,False,1,7
32168,0,14,10,24,False,2,7
32169,1,4,8,12,False,2,7
32170,2,8,4,12,False,2,7
32171,3,17,11,28,False,2,7
32172,4,104,50,154,False,2,7
32173,5,238,137,375,False,2,7
32174,6,417,210,627,False,2,7
32175,7,290,158,448,False,2,7
32176,8,205,192,397,False,2,7
32177,9,245,174,419,False,2,7
32178,10,236,236,472,False,2,7
32179,11,235,213,448,False,2,7
32180,12,235,274,509,False,2,7
32181,13,271,322,593,False,2,7
32182,14,244,289,533,False,2,7
32183,15,206,208,414,False,2,7
32184,16,171,153,324,False,2,7
32185,17,140,156,296,False,2,7
32186,18,118,101,219,False,2,7
32187,19,93,118,211,False,2,7
32188,20,72,138,210,False,2,7
32189,21,23,94,117,False,2,7
32190,22,17,33,50,False,2,7
32191,23,10,16,26,False,2,7
32192,0,12,11,23,False,3,7
32193,1,4,7,11,False,3,7
32194,2,8,10,18,False,3,7
32195,3,22,7,29,False,3,7
32196,4,131,53,184,False,3,7
32197,5,258,139,397,False,3,7
32198,6,407,186,593,False,3,7
32199,7,278,167,445,False,3,7
32200,8,218,182,400,False,3,7
32201,9,196,183,379,False,3,7
32202,10,235,190,425,False,3,7
32203,11,229,196,425,False,3,7
32204,12,248,259,507,False,3,7
32205,13,271,328,599,False,3,7
32206,14,234,315,549,False,3,7
32207,15,166,208,374,False,3,7
32208,16,194,171,365,False,3,7
32209,17,159,140,299,False,3,7
32210,18,137,150,287,False,3,7
32211,19,92,102,194,False,3,7
32212,20,90,101,191,False,3,7
32213,21,40,66,106,False,3,7
32214,22,28,31,59,False,3,7
32215,23,8,20,28,False,3,7
32216,0,10,16,26,False,4,7
32217,1,18,16,34,False,4,7
32218,2,13,11,24,False,4,7
32219,3,24,16,40,False,4,7
32220,4,102,52,154,False,4,7
32221,5,249,133,382,False,4,7
32222,6,436,194,630,False,4,7
32223,7,258,169,427,False,4,7
32224,8,207,177,384,False,4,7
32225,9,229,167,396,False,4,7
32226,10,226,209,435,False,4,7
32227,11,238,212,450,False,4,7
32228,12,269,276,545,False,4,7
32229,13,311,365,676,False,4,7
32230,14,197,291,488,False,4,7
32231,15,154,177,331,False,4,7
32232,16,130,116,246,False,4,7
32233,17,117,126,243,False,4,7
32234,18,120,112,232,False,4,7
32235,19,92,92,184,False,4,7
32236,20,64,78,142,False,4,7
32237,21,48,75,123,False,4,7
32238,22,34,48,82,False,4,7
32239,23,24,22,46,False,4,7
32240,0,31,34,65,False,5,7
32241,1,16,31,47,False,5,7
32242,2,10,11,21,False,5,7
32243,3,8,6,14,False,5,7
32244,4,19,18,37,False,5,7
32245,5,25,25,50,False,5,7
32246,6,40,33,73,False,5,7
32247,7,82,44,126,False,5,7
32248,8,131,87,218,False,5,7
32249,9,162,100,262,False,5,7
32250,10,211,137,348,False,5,7
32251,11,177,156,333,False,5,7
32252,12,166,198,364,False,5,7
32253,13,160,207,367,False,5,7
32254,14,146,201,347,False,5,7
32255,15,145,144,289,False,5,7
32256,16,161,157,318,False,5,7
32257,17,93,113,206,False,5,7
32258,18,87,94,181,False,5,7
32259,19,76,92,168,False,5,7
32260,20,62,65,127,False,5,7
32261,21,61,85,146,False,5,7
32262,22,48,57,105,False,5,7
32263,23,27,33,60,False,5,7
32264,0,34,38,72,True,6,8
32265,1,26,41,67,True,6,8
32266,2,16,26,42,True,6,8
32267,3,14,12,26,True,6,8
32268,4,15,12,27,True,6,8
32269,5,17,10,27,True,6,8
32270,6,21,23,44,True,6,8
32271,7,44,37,81,True,6,8
32272,8,99,71,170,True,6,8
32273,9,134,77,211,True,6,8
32274,10,159,158,317,True,6,8
32275,11,149,156,305,True,6,8
32276,12,186,168,354,True,6,8
32277,13,158,227,385,True,6,8
32278,14,157,204,361,True,6,8
32279,15,146,136,282,True,6,8
32280,16,122,129,251,True,6,8
32281,17,142,147,289,True,6,8
32282,18,123,151,274,True,6,8
32283,19,84,113,197,True,6,8
32284,20,58,61,119,True,6,8
32285,21,26,30,56,True,6,8
32286,22,14,20,34,True,6,8
32287,23,9,10,19,True,6,8
32288,0,4,3,7,False,0,8
32289,1,5,9,14,False,0,8
32290,2,6,8,14,False,0,8
32291,3,26,8,34,False,0,8
32292,4,122,42,164,False,0,8
32293,5,245,147,392,False,0,8
32294,6,383,198,581,False,0,8
32295,7,258,194,452,False,0,8
32296,8,229,154,383,False,0,8
32297,9,208,191,399,False,0,8
32298,10,225,178,403,False,0,8
32299,11,203,200,403,False,0,8
32300,12,254,242,496,False,0,8
32301,13,285,346,631,False,0,8
32302,14,242,294,536,False,0,8
32303,15,194,203,397,False,0,8
32304,16,193,149,342,False,0,8
32305,17,157,121,278,False,0,8
32306,18,113,132,245,False,0,8
32307,19,68,121,189,False,0,8
32308,20,64,96,160,False,0,8
32309,21,22,44,66,False,0,8
32310,22,14,16,30,False,0,8
32311,23,7,8,15,False,0,8
32312,0,3,10,13,False,1,8
32313,1,7,9,16,False,1,8
32314,2,7,5,12,False,1,8
32315,3,20,6,26,False,1,8
32316,4,118,55,173,False,1,8
32317,5,254,156,410,False,1,8
32318,6,381,217,598,False,1,8
32319,7,243,155,398,False,1,8
32320,8,232,170,402,False,1,8
32321,9,179,147,326,False,1,8
32322,10,197,173,370,False,1,8
32323,11,223,206,429,False,1,8
32324,12,219,228,447,False,1,8
32325,13,252,327,579,False,1,8
32326,14,238,300,538,False,1,8
32327,15,198,209,407,False,1,8
32328,16,182,146,328,False,1,8
32329,17,143,148,291,False,1,8
32330,18,148,134,282,False,1,8
32331,19,75,114,189,False,1,8
32332,20,44,77,121,False,1,8
32333,21,26,38,64,False,1,8
32334,22,16,20,36,False,1,8
32335,23,10,10,20,False,1,8
32336,0,5,11,16,False,2,8
32337,1,6,5,11,False,2,8
32338,2,9,5,14,False,2,8
32339,3,25,10,35,False,2,8
32340,4,120,39,159,False,2,8
32341,5,272,164,436,False,2,8
32342,6,387,199,586,False,2,8
32343,7,233,144,377,False,2,8
32344,8,206,161,367,False,2,8
32345,9,241,153,394,False,2,8
32346,10,279,214,493,False,2,8
32347,11,218,201,419,False,2,8
32348,12,237,239,476,False,2,8
32349,13,245,333,578,False,2,8
32350,14,264,286,550,False,2,8
32351,15,184,210,394,False,2,8
32352,16,206,149,355,False,2,8
32353,17,141,161,302,False,2,8
32354,18,111,139,250,False,2,8
32355,19,100,115,215,False,2,8
32356,20,44,56,100,False,2,8
32357,21,25,37,62,False,2,8
32358,22,15,22,37,False,2,8
32359,23,11,14,25,False,2,8
32360,0,10,15,25,False,3,8
32361,1,18,9,27,False,3,8
32362,2,11,9,20,False,3,8
32363,3,16,8,24,False,3,8
32364,4,121,49,170,False,3,8
32365,5,234,124,358,False,3,8
32366,6,413,208,621,False,3,8
32367,7,228,147,375,False,3,8
32368,8,238,168,406,False,3,8
32369,9,206,157,363,False,3,8
32370,10,224,182,406,False,3,8
32371,11,197,210,407,False,3,8
32372,12,243,250,493,False,3,8
32373,13,258,316,574,False,3,8
32374,14,226,302,528,False,3,8
32375,15,205,183,388,False,3,8
32376,16,192,167,359,False,3,8
32377,17,149,146,295,False,3,8
32378,18,109,126,235,False,3,8
32379,19,98,111,209,False,3,8
32380,20,60,74,134,False,3,8
32381,21,36,42,78,False,3,8
32382,22,15,16,31,False,3,8
32383,23,9,37,46,False,3,8
32384,0,9,39,48,False,4,8
32385,1,5,33,38,False,4,8
32386,2,10,7,17,False,4,8
32387,3,20,7,27,False,4,8
32388,4,126,50,176,False,4,8
32389,5,249,121,370,False,4,8
32390,6,419,176,595,False,4,8
32391,7,300,207,507,False,4,8
32392,8,333,433,766,False,4,8
32393,9,228,328,556,False,4,8
32394,10,235,216,451,False,4,8
32395,11,251,213,464,False,4,8
32396,12,255,272,527,False,4,8
32397,13,271,334,605,False,4,8
32398,14,203,260,463,False,4,8
32399,15,143,166,309,False,4,8
32400,16,159,162,321,False,4,8
32401,17,136,134,270,False,4,8
32402,18,103,108,211,False,4,8
32403,19,75,99,174,False,4,8
32404,20,54,70,124,False,4,8
32405,21,42,187,229,False,4,8
32406,22,25,45,70,False,4,8
32407,23,17,26,43,False,4,8
32408,0,25,30,55,False,5,8
32409,1,23,19,42,False,5,8
32410,2,9,18,27,False,5,8
32411,3,10,6,16,False,5,8
32412,4,15,15,30,False,5,8
32413,5,20,19,39,False,5,8
32414,6,34,28,62,False,5,8
32415,7,72,50,122,False,5,8
32416,8,96,70,166,False,5,8
32417,9,129,87,216,False,5,8
32418,10,122,135,257,False,5,8
32419,11,161,152,313,False,5,8
32420,12,152,154,306,False,5,8
32421,13,154,176,330,False,5,8
32422,14,122,145,267,False,5,8
32423,15,132,167,299,False,5,8
32424,16,117,133,250,False,5,8
32425,17,114,114,228,False,5,8
32426,18,90,86,176,False,5,8
32427,19,58,82,140,False,5,8
32428,20,55,61,116,False,5,8
32429,21,50,58,108,False,5,8
32430,22,36,48,84,False,5,8
32431,23,25,42,67,False,5,8
32432,0,26,28,54,True,6,8
32433,1,29,26,55,True,6,8
32434,2,12,22,34,True,6,8
32435,3,7,12,19,True,6,8
32436,4,19,10,29,True,6,8
32437,5,22,12,34,True,6,8
32438,6,33,17,50,True,6,8
32439,7,42,35,77,True,6,8
32440,8,94,52,146,True,6,8
32441,9,94,93,187,True,6,8
32442,10,131,140,271,True,6,8
32443,11,141,136,277,True,6,8
32444,12,172,178,350,True,6,8
32445,13,161,171,332,True,6,8
32446,14,128,171,299,True,6,8
32447,15,156,176,332,True,6,8
32448,16,156,133,289,True,6,8
32449,17,158,148,306,True,6,8
32450,18,130,153,283,True,6,8
32451,19,79,103,182,True,6,8
32452,20,50,73,123,True,6,8
32453,21,44,64,108,True,6,8
32454,22,20,20,40,True,6,8
32455,23,14,14,28,True,6,8
32456,0,7,5,12,False,0,8
32457,1,8,7,15,False,0,8
32458,2,6,7,13,False,0,8
32459,3,18,11,29,False,0,8
32460,4,112,60,172,False,0,8
32461,5,262,126,388,False,0,8
32462,6,318,176,494,False,0,8
32463,7,230,156,386,False,0,8
32464,8,226,188,414,False,0,8
32465,9,207,172,379,False,0,8
32466,10,233,168,401,False,0,8
32467,11,198,205,403,False,0,8
32468,12,210,241,451,False,0,8
32469,13,296,292,588,False,0,8
32470,14,226,286,512,False,0,8
32471,15,186,184,370,False,0,8
32472,16,161,139,300,False,0,8
32473,17,159,150,309,False,0,8
32474,18,100,102,202,False,0,8
32475,19,86,102,188,False,0,8
32476,20,50,69,119,False,0,8
32477,21,30,34,64,False,0,8
32478,22,11,18,29,False,0,8
32479,23,8,7,15,False,0,8
32480,0,6,8,14,False,1,8
32481,1,4,6,10,False,1,8
32482,2,5,7,12,False,1,8
32483,3,18,7,25,False,1,8
32484,4,118,49,167,False,1,8
32485,5,279,124,403,False,1,8
32486,6,406,203,609,False,1,8
32487,7,256,179,435,False,1,8
32488,8,212,154,366,False,1,8
32489,9,216,160,376,False,1,8
32490,10,198,195,393,False,1,8
32491,11,216,203,419,False,1,8
32492,12,210,248,458,False,1,8
32493,13,263,349,612,False,1,8
32494,14,219,308,527,False,1,8
32495,15,193,194,387,False,1,8
32496,16,175,153,328,False,1,8
32497,17,148,145,293,False,1,8
32498,18,111,141,252,False,1,8
32499,19,88,124,212,False,1,8
32500,20,61,77,138,False,1,8
32501,21,27,28,55,False,1,8
32502,22,17,14,31,False,1,8
32503,23,10,10,20,False,1,8
32504,0,9,6,15,False,2,8
32505,1,5,6,11,False,2,8
32506,2,19,9,28,False,2,8
32507,3,20,9,29,False,2,8
32508,4,96,54,150,False,2,8
32509,5,253,133,386,False,2,8
32510,6,385,203,588,False,2,8
32511,7,288,167,455,False,2,8
32512,8,237,171,408,False,2,8
32513,9,197,173,370,False,2,8
32514,10,218,200,418,False,2,8
32515,11,202,185,387,False,2,8
32516,12,251,251,502,False,2,8
32517,13,245,310,555,False,2,8
32518,14,213,300,513,False,2,8
32519,15,171,181,352,False,2,8
32520,16,177,176,353,False,2,8
32521,17,132,166,298,False,2,8
32522,18,119,126,245,False,2,8
32523,19,86,106,192,False,2,8
32524,20,44,70,114,False,2,8
32525,21,6,39,45,False,2,8
32526,22,8,24,32,False,2,8
32527,23,1,17,18,False,2,8
32528,0,2,13,15,False,3,8
32529,1,3,15,18,False,3,8
32530,2,5,17,22,False,3,8
32531,3,13,14,27,False,3,8
32532,4,115,63,178,False,3,8
32533,5,231,124,355,False,3,8
32534,6,385,204,589,False,3,8
32535,7,259,170,429,False,3,8
32536,8,228,173,401,False,3,8
32537,9,232,196,428,False,3,8
32538,10,228,199,427,False,3,8
32539,11,219,203,422,False,3,8
32540,12,236,237,473,False,3,8
32541,13,272,324,596,False,3,8
32542,14,247,318,565,False,3,8
32543,15,175,188,363,False,3,8
32544,16,156,188,344,False,3,8
32545,17,120,144,264,False,3,8
32546,18,103,138,241,False,3,8
32547,19,92,112,204,False,3,8
32548,20,66,75,141,False,3,8
32549,21,28,42,70,False,3,8
32550,22,15,28,43,False,3,8
32551,23,12,17,29,False,3,8
32552,0,10,17,27,False,4,8
32553,1,4,6,10,False,4,8
32554,2,5,6,11,False,4,8
32555,3,20,12,32,False,4,8
32556,4,94,48,142,False,4,8
32557,5,260,141,401,False,4,8
32558,6,376,187,563,False,4,8
32559,7,240,150,390,False,4,8
32560,8,221,210,431,False,4,8
32561,9,234,164,398,False,4,8
32562,10,200,215,415,False,4,8
32563,11,239,197,436,False,4,8
32564,12,238,270,508,False,4,8
32565,13,281,302,583,False,4,8
32566,14,198,246,444,False,4,8
32567,15,164,179,343,False,4,8
32568,16,169,154,323,False,4,8
32569,17,124,130,254,False,4,8
32570,18,89,110,199,False,4,8
32571,19,74,78,152,False,4,8
32572,20,59,67,126,False,4,8
32573,21,41,60,101,False,4,8
32574,22,31,48,79,False,4,8
32575,23,17,29,46,False,4,8
32576,0,18,27,45,False,5,8
32577,1,13,21,34,False,5,8
32578,2,9,15,24,False,5,8
32579,3,7,11,18,False,5,8
32580,4,21,14,35,False,5,8
32581,5,23,22,45,False,5,8
32582,6,41,34,75,False,5,8
32583,7,72,48,120,False,5,8
32584,8,110,70,180,False,5,8
32585,9,134,87,221,False,5,8
32586,10,155,149,304,False,5,8
32587,11,162,144,306,False,5,8
32588,12,163,191,354,False,5,8
32589,13,170,186,356,False,5,8
32590,14,163,145,308,False,5,8
32591,15,138,121,259,False,5,8
32592,16,131,150,281,False,5,8
32593,17,107,110,217,False,5,8
32594,18,98,100,198,False,5,8
32595,19,76,65,141,False,5,8
32596,20,56,60,116,False,5,8
32597,21,42,63,105,False,5,8
32598,22,37,42,79,False,5,8
32599,23,26,28,54,False,5,8
32600,0,19,25,44,True,6,8
32601,1,22,34,56,True,6,8
32602,2,19,22,41,True,6,8
32603,3,9,15,24,True,6,8
32604,4,17,9,26,True,6,8
32605,5,16,22,38,True,6,8
32606,6,38,21,59,True,6,8
32607,7,58,25,83,True,6,8
32608,8,115,76,191,True,6,8
32609,9,140,75,215,True,6,8
32610,10,168,150,318,True,6,8
32611,11,153,177,330,True,6,8
32612,12,159,197,356,True,6,8
32613,13,137,196,333,True,6,8
32614,14,135,191,326,True,6,8
32615,15,153,172,325,True,6,8
32616,16,168,137,305,True,6,8
32617,17,167,153,320,True,6,8
32618,18,120,138,258,True,6,8
32619,19,77,146,223,True,6,8
32620,20,61,76,137,True,6,8
32621,21,29,37,66,True,6,8
32622,22,20,21,41,True,6,8
32623,23,13,12,25,True,6,8
32624,0,4,5,9,False,0,8
32625,1,5,7,12,False,0,8
32626,2,7,5,12,False,0,8
32627,3,26,11,37,False,0,8
32628,4,123,60,183,False,0,8
32629,5,243,151,394,False,0,8
32630,6,382,227,609,False,0,8
32631,7,256,123,379,False,0,8
32632,8,224,163,387,False,0,8
32633,9,206,154,360,False,0,8
32634,10,169,188,357,False,0,8
32635,11,217,183,400,False,0,8
32636,12,239,258,497,False,0,8
32637,13,219,289,508,False,0,8
32638,14,248,261,509,False,0,8
32639,15,226,194,420,False,0,8
32640,16,165,155,320,False,0,8
32641,17,139,145,284,False,0,8
32642,18,121,102,223,False,0,8
32643,19,82,108,190,False,0,8
32644,20,57,79,136,False,0,8
32645,21,25,48,73,False,0,8
32646,22,20,22,42,False,0,8
32647,23,7,7,14,False,0,8
32648,0,4,5,9,False,1,8
32649,1,5,26,31,False,1,8
32650,2,9,6,15,False,1,8
32651,3,20,13,33,False,1,8
32652,4,113,54,167,False,1,8
32653,5,239,141,380,False,1,8
32654,6,386,206,592,False,1,8
32655,7,246,168,414,False,1,8
32656,8,227,146,373,False,1,8
32657,9,226,161,387,False,1,8
32658,10,224,203,427,False,1,8
32659,11,227,193,420,False,1,8
32660,12,233,265,498,False,1,8
32661,13,265,302,567,False,1,8
32662,14,255,304,559,False,1,8
32663,15,197,188,385,False,1,8
32664,16,175,177,352,False,1,8
32665,17,147,155,302,False,1,8
32666,18,118,129,247,False,1,8
32667,19,76,116,192,False,1,8
32668,20,35,65,100,False,1,8
32669,21,29,46,75,False,1,8
32670,22,13,29,42,False,1,8
32671,23,6,13,19,False,1,8
32672,0,6,7,13,False,2,8
32673,1,8,7,15,False,2,8
32674,2,6,6,12,False,2,8
32675,3,20,10,30,False,2,8
32676,4,107,49,156,False,2,8
32677,5,260,154,414,False,2,8
32678,6,436,196,632,False,2,8
32679,7,268,147,415,False,2,8
32680,8,190,166,356,False,2,8
32681,9,205,144,349,False,2,8
32682,10,209,188,397,False,2,8
32683,11,216,188,404,False,2,8
32684,12,208,252,460,False,2,8
32685,13,266,326,592,False,2,8
32686,14,241,270,511,False,2,8
32687,15,185,209,394,False,2,8
32688,16,152,151,303,False,2,8
32689,17,143,150,293,False,2,8
32690,18,110,117,227,False,2,8
32691,19,106,110,216,False,2,8
32692,20,52,60,112,False,2,8
32693,21,19,36,55,False,2,8
32694,22,14,23,37,False,2,8
32695,23,11,18,29,False,2,8
32696,0,8,14,22,False,3,8
32697,1,5,4,9,False,3,8
32698,2,9,6,15,False,3,8
32699,3,15,14,29,False,3,8
32700,4,104,42,146,False,3,8
32701,5,270,124,394,False,3,8
32702,6,387,205,592,False,3,8
32703,7,237,137,374,False,3,8
32704,8,233,176,409,False,3,8
32705,9,235,183,418,False,3,8
32706,10,201,184,385,False,3,8
32707,11,219,208,427,False,3,8
32708,12,254,228,482,False,3,8
32709,13,304,332,636,False,3,8
32710,14,241,302,543,False,3,8
32711,15,200,193,393,False,3,8
32712,16,188,155,343,False,3,8
32713,17,135,119,254,False,3,8
32714,18,115,143,258,False,3,8
32715,19,83,109,192,False,3,8
32716,20,58,95,153,False,3,8
32717,21,30,62,92,False,3,8
32718,22,8,26,34,False,3,8
32719,23,11,16,27,False,3,8
32720,0,17,9,26,False,4,8
32721,1,13,11,24,False,4,8
32722,2,9,11,20,False,4,8
32723,3,23,11,34,False,4,8
32724,4,94,47,141,False,4,8
32725,5,281,155,436,False,4,8
32726,6,402,223,625,False,4,8
32727,7,255,134,389,False,4,8
32728,8,209,173,382,False,4,8
32729,9,213,162,375,False,4,8
32730,10,237,202,439,False,4,8
32731,11,229,212,441,False,4,8
32732,12,262,257,519,False,4,8
32733,13,264,306,570,False,4,8
32734,14,179,251,430,False,4,8
32735,15,174,167,341,False,4,8
32736,16,137,187,324,False,4,8
32737,17,103,125,228,False,4,8
32738,18,135,119,254,False,4,8
32739,19,100,100,200,False,4,8
32740,20,58,66,124,False,4,8
32741,21,34,43,77,False,4,8
32742,22,28,41,69,False,4,8
32743,23,17,37,54,False,4,8
32744,0,19,22,41,False,5,8
32745,1,17,26,43,False,5,8
32746,2,10,17,27,False,5,8
32747,3,10,10,20,False,5,8
32748,4,16,14,30,False,5,8
32749,5,31,15,46,False,5,8
32750,6,42,28,70,False,5,8
32751,7,75,46,121,False,5,8
32752,8,107,73,180,False,5,8
32753,9,124,83,207,False,5,8
32754,10,162,130,292,False,5,8
32755,11,143,121,264,False,5,8
32756,12,144,160,304,False,5,8
32757,13,153,148,301,False,5,8
32758,14,100,163,263,False,5,8
32759,15,123,180,303,False,5,8
32760,16,145,133,278,False,5,8
32761,17,108,115,223,False,5,8
32762,18,112,92,204,False,5,8
32763,19,60,85,145,False,5,8
32764,20,42,57,99,False,5,8
32765,21,40,44,84,False,5,8
32766,22,33,49,82,False,5,8
32767,23,24,39,63,False,5,8
32768,0,27,34,61,True,6,8
32769,1,27,29,56,True,6,8
32770,2,10,23,33,True,6,8
32771,3,7,7,14,True,6,8
32772,4,15,12,27,True,6,8
32773,5,5,13,18,True,6,8
32774,6,37,15,52,True,6,8
32775,7,42,35,77,True,6,8
32776,8,99,60,159,True,6,8
32777,9,118,69,187,True,6,8
32778,10,138,158,296,True,6,8
32779,11,136,157,293,True,6,8
32780,12,161,162,323,True,6,8
32781,13,164,167,331,True,6,8
32782,14,142,194,336,True,6,8
32783,15,145,147,292,True,6,8
32784,16,165,148,313,True,6,8
32785,17,140,156,296,True,6,8
32786,18,126,149,275,True,6,8
32787,19,104,116,220,True,6,8
32788,20,50,75,125,True,6,8
32789,21,16,30,46,True,6,8
32790,22,21,17,38,True,6,8
32791,23,9,10,19,True,6,8
32792,0,9,5,14,False,0,8
32793,1,3,9,12,False,0,8
32794,2,11,3,14,False,0,8
32795,3,15,7,22,False,0,8
32796,4,101,55,156,False,0,8
32797,5,240,121,361,False,0,8
32798,6,379,196,575,False,0,8
32799,7,245,154,399,False,0,8
32800,8,202,131,333,False,0,8
32801,9,206,166,372,False,0,8
32802,10,184,185,369,False,0,8
32803,11,213,179,392,False,0,8
32804,12,227,233,460,False,0,8
32805,13,232,327,559,False,0,8
32806,14,183,299,482,False,0,8
32807,15,164,169,333,False,0,8
32808,16,167,161,328,False,0,8
32809,17,155,141,296,False,0,8
32810,18,124,123,247,False,0,8
32811,19,84,92,176,False,0,8
32812,20,39,175,214,False,0,8
32813,21,33,123,156,False,0,8
32814,22,12,60,72,False,0,8
32815,23,11,32,43,False,0,8
32816,0,8,16,24,False,1,8
32817,1,2,17,19,False,1,8
32818,2,3,23,26,False,1,8
32819,3,21,6,27,False,1,8
32820,4,104,51,155,False,1,8
32821,5,250,123,373,False,1,8
32822,6,376,189,565,False,1,8
32823,7,245,179,424,False,1,8
32824,8,217,165,382,False,1,8
32825,9,214,153,367,False,1,8
32826,10,230,179,409,False,1,8
32827,11,206,213,419,False,1,8
32828,12,216,260,476,False,1,8
32829,13,254,288,542,False,1,8
32830,14,202,287,489,False,1,8
32831,15,182,190,372,False,1,8
32832,16,178,201,379,False,1,8
32833,17,131,132,263,False,1,8
32834,18,98,137,235,False,1,8
32835,19,82,98,180,False,1,8
32836,20,43,78,121,False,1,8
32837,21,26,26,52,False,1,8
32838,22,16,16,32,False,1,8
32839,23,15,11,26,False,1,8
32840,0,6,7,13,False,2,8
32841,1,7,7,14,False,2,8
32842,2,5,8,13,False,2,8
32843,3,19,13,32,False,2,8
32844,4,104,42,146,False,2,8
32845,5,243,141,384,False,2,8
32846,6,389,186,575,False,2,8
32847,7,221,138,359,False,2,8
32848,8,242,138,380,False,2,8
32849,9,197,158,355,False,2,8
32850,10,214,215,429,False,2,8
32851,11,234,188,422,False,2,8
32852,12,218,235,453,False,2,8
32853,13,235,302,537,False,2,8
32854,14,209,255,464,False,2,8
32855,15,182,203,385,False,2,8
32856,16,168,153,321,False,2,8
32857,17,132,132,264,False,2,8
32858,18,114,116,230,False,2,8
32859,19,89,96,185,False,2,8
32860,20,67,76,143,False,2,8
32861,21,28,39,67,False,2,8
32862,22,23,24,47,False,2,8
32863,23,14,15,29,False,2,8
32864,0,6,5,11,False,3,8
32865,1,9,13,22,False,3,8
32866,2,4,4,8,False,3,8
32867,3,16,11,27,False,3,8
32868,4,108,58,166,False,3,8
32869,5,271,138,409,False,3,8
32870,6,377,187,564,False,3,8
32871,7,253,145,398,False,3,8
32872,8,223,158,381,False,3,8
32873,9,214,174,388,False,3,8
32874,10,228,194,422,False,3,8
32875,11,191,181,372,False,3,8
32876,12,229,274,503,False,3,8
32877,13,245,295,540,False,3,8
32878,14,202,271,473,False,3,8
32879,15,188,180,368,False,3,8
32880,16,176,156,332,False,3,8
32881,17,144,148,292,False,3,8
32882,18,97,139,236,False,3,8
32883,19,72,105,177,False,3,8
32884,20,81,72,153,False,3,8
32885,21,44,35,79,False,3,8
32886,22,35,25,60,False,3,8
32887,23,15,12,27,False,3,8
32888,0,22,19,41,False,4,8
32889,1,13,17,30,False,4,8
32890,2,10,6,16,False,4,8
32891,3,20,13,33,False,4,8
32892,4,114,46,160,False,4,8
32893,5,275,150,425,False,4,8
32894,6,384,175,559,False,4,8
32895,7,212,150,362,False,4,8
32896,8,208,160,368,False,4,8
32897,9,219,184,403,False,4,8
32898,10,243,211,454,False,4,8
32899,11,202,219,421,False,4,8
32900,12,247,292,539,False,4,8
32901,13,287,338,625,False,4,8
32902,14,233,301,534,False,4,8
32903,15,204,186,390,False,4,8
32904,16,140,156,296,False,4,8
32905,17,116,151,267,False,4,8
32906,18,86,93,179,False,4,8
32907,19,81,100,181,False,4,8
32908,20,44,76,120,False,4,8
32909,21,42,61,103,False,4,8
32910,22,27,39,66,False,4,8
32911,23,27,32,59,False,4,8
32912,0,22,25,47,False,5,8
32913,1,11,22,33,False,5,8
32914,2,4,13,17,False,5,8
32915,3,10,9,19,False,5,8
32916,4,21,9,30,False,5,8
32917,5,20,22,42,False,5,8
32918,6,32,24,56,False,5,8
32919,7,76,60,136,False,5,8
32920,8,88,67,155,False,5,8
32921,9,134,102,236,False,5,8
32922,10,162,127,289,False,5,8
32923,11,154,147,301,False,5,8
32924,12,150,152,302,False,5,8
32925,13,144,164,308,False,5,8
32926,14,153,164,317,False,5,8
32927,15,122,149,271,False,5,8
32928,16,111,147,258,False,5,8
32929,17,116,163,279,False,5,8
32930,18,77,96,173,False,5,8
32931,19,60,56,116,False,5,8
32932,20,48,46,94,False,5,8
32933,21,36,61,97,False,5,8
32934,22,32,53,85,False,5,8
32935,23,29,46,75,False,5,8
32936,0,33,30,63,True,6,8
32937,1,25,22,47,True,6,8
32938,2,16,18,34,True,6,8
32939,3,12,7,19,True,6,8
32940,4,17,12,29,True,6,8
32941,5,10,12,22,True,6,8
32942,6,59,14,73,True,6,8
32943,7,67,33,100,True,6,8
32944,8,99,67,166,True,6,8
32945,9,90,109,199,True,6,8
32946,10,154,138,292,True,6,8
32947,11,164,165,329,True,6,8
32948,12,184,200,384,True,6,8
32949,13,151,189,340,True,6,8
32950,14,127,205,332,True,6,8
32951,15,174,175,349,True,6,8
32952,16,157,152,309,True,6,8
32953,17,144,151,295,True,6,8
32954,18,110,117,227,True,6,8
32955,19,82,101,183,True,6,8
32956,20,65,77,142,True,6,8
32957,21,27,44,71,True,6,8
32958,22,18,18,36,True,6,8
32959,23,13,7,20,True,6,8
32960,0,6,8,14,False,0,8
32961,1,7,9,16,False,0,8
32962,2,12,7,19,False,0,8
32963,3,18,10,28,False,0,8
32964,4,96,53,149,False,0,8
32965,5,239,138,377,False,0,8
32966,6,405,199,604,False,0,8
32967,7,233,145,378,False,0,8
32968,8,216,161,377,False,0,8
32969,9,215,149,364,False,0,8
32970,10,199,193,392,False,0,8
32971,11,215,180,395,False,0,8
32972,12,228,229,457,False,0,8
32973,13,242,302,544,False,0,8
32974,14,224,302,526,False,0,8
32975,15,180,197,377,False,0,8
32976,16,155,153,308,False,0,8
32977,17,128,142,270,False,0,8
32978,18,125,107,232,False,0,8
32979,19,81,98,179,False,0,8
32980,20,42,292,334,False,0,8
32981,21,34,180,214,False,0,8
32982,22,10,55,65,False,0,8
32983,23,6,36,42,False,0,8
32984,0,2,30,32,False,1,9
32985,1,5,35,40,False,1,9
32986,2,8,24,32,False,1,9
32987,3,23,10,33,False,1,9
32988,4,116,51,167,False,1,9
32989,5,227,161,388,False,1,9
32990,6,419,205,624,False,1,9
32991,7,255,152,407,False,1,9
32992,8,247,172,419,False,1,9
32993,9,228,155,383,False,1,9
32994,10,217,214,431,False,1,9
32995,11,223,208,431,False,1,9
32996,12,247,234,481,False,1,9
32997,13,259,313,572,False,1,9
32998,14,246,313,559,False,1,9
32999,15,183,184,367,False,1,9
33000,16,198,171,369,False,1,9
33001,17,123,155,278,False,1,9
33002,18,105,144,249,False,1,9
33003,19,83,119,202,False,1,9
33004,20,60,70,130,False,1,9
33005,21,39,37,76,False,1,9
33006,22,16,24,40,False,1,9
33007,23,11,11,22,False,1,9
33008,0,10,8,18,False,2,9
33009,1,4,12,16,False,2,9
33010,2,10,3,13,False,2,9
33011,3,20,18,38,False,2,9
33012,4,104,61,165,False,2,9
33013,5,247,155,402,False,2,9
33014,6,409,189,598,False,2,9
33015,7,257,168,425,False,2,9
33016,8,223,138,361,False,2,9
33017,9,227,195,422,False,2,9
33018,10,196,178,374,False,2,9
33019,11,217,212,429,False,2,9
33020,12,249,236,485,False,2,9
33021,13,235,320,555,False,2,9
33022,14,211,264,475,False,2,9
33023,15,185,168,353,False,2,9
33024,16,174,138,312,False,2,9
33025,17,118,150,268,False,2,9
33026,18,107,113,220,False,2,9
33027,19,80,121,201,False,2,9
33028,20,65,58,123,False,2,9
33029,21,31,41,72,False,2,9
33030,22,17,27,44,False,2,9
33031,23,16,11,27,False,2,9
33032,0,8,14,22,False,3,9
33033,1,7,10,17,False,3,9
33034,2,8,6,14,False,3,9
33035,3,15,13,28,False,3,9
33036,4,120,60,180,False,3,9
33037,5,251,128,379,False,3,9
33038,6,383,204,587,False,3,9
33039,7,247,148,395,False,3,9
33040,8,446,187,633,False,3,9
33041,9,557,246,803,False,3,9
33042,10,203,197,400,False,3,9
33043,11,231,187,418,False,3,9
33044,12,222,254,476,False,3,9
33045,13,263,300,563,False,3,9
33046,14,233,284,517,False,3,9
33047,15,188,156,344,False,3,9
33048,16,197,186,383,False,3,9
33049,17,144,151,295,False,3,9
33050,18,97,126,223,False,3,9
33051,19,73,112,185,False,3,9
33052,20,51,379,430,False,3,9
33053,21,31,221,252,False,3,9
33054,22,16,69,85,False,3,9
33055,23,15,19,34,False,3,9
33056,0,11,10,21,False,4,9
33057,1,12,21,33,False,4,9
33058,2,12,11,23,False,4,9
33059,3,15,9,24,False,4,9
33060,4,115,51,166,False,4,9
33061,5,249,130,379,False,4,9
33062,6,367,184,551,False,4,9
33063,7,241,155,396,False,4,9
33064,8,201,165,366,False,4,9
33065,9,230,157,387,False,4,9
33066,10,224,210,434,False,4,9
33067,11,242,226,468,False,4,9
33068,12,274,277,551,False,4,9
33069,13,255,304,559,False,4,9
33070,14,210,265,475,False,4,9
33071,15,150,184,334,False,4,9
33072,16,153,138,291,False,4,9
33073,17,116,108,224,False,4,9
33074,18,101,104,205,False,4,9
33075,19,70,69,139,False,4,9
33076,20,54,68,122,False,4,9
33077,21,36,56,92,False,4,9
33078,22,31,33,64,False,4,9
33079,23,14,22,36,False,4,9
33080,0,16,22,38,False,5,9
33081,1,16,25,41,False,5,9
33082,2,6,12,18,False,5,9
33083,3,6,8,14,False,5,9
33084,4,16,10,26,False,5,9
33085,5,23,20,43,False,5,9
33086,6,42,24,66,False,5,9
33087,7,66,57,123,False,5,9
33088,8,92,59,151,False,5,9
33089,9,121,83,204,False,5,9
33090,10,120,125,245,False,5,9
33091,11,142,137,279,False,5,9
33092,12,153,166,319,False,5,9
33093,13,154,189,343,False,5,9
33094,14,134,141,275,False,5,9
33095,15,97,125,222,False,5,9
33096,16,118,101,219,False,5,9
33097,17,113,100,213,False,5,9
33098,18,72,80,152,False,5,9
33099,19,52,51,103,False,5,9
33100,20,54,53,107,False,5,9
33101,21,41,54,95,False,5,9
33102,22,31,40,71,False,5,9
33103,23,33,32,65,False,5,9
33104,0,26,28,54,True,6,9
33105,1,24,33,57,True,6,9
33106,2,16,22,38,True,6,9
33107,3,9,6,15,True,6,9
33108,4,22,11,33,True,6,9
33109,5,13,18,31,True,6,9
33110,6,28,16,44,True,6,9
33111,7,35,31,66,True,6,9
33112,8,93,50,143,True,6,9
33113,9,113,92,205,True,6,9
33114,10,135,113,248,True,6,9
33115,11,137,151,288,True,6,9
33116,12,177,168,345,True,6,9
33117,13,137,155,292,True,6,9
33118,14,136,182,318,True,6,9
33119,15,146,154,300,True,6,9
33120,16,140,125,265,True,6,9
33121,17,126,143,269,True,6,9
33122,18,90,93,183,True,6,9
33123,19,65,76,141,True,6,9
33124,20,91,70,161,True,6,9
33125,21,26,34,60,True,6,9
33126,22,17,21,38,True,6,9
33127,23,10,9,19,True,6,9
33128,0,4,2,6,True,0,9
33129,1,7,9,16,True,0,9
33130,2,4,4,8,True,0,9
33131,3,15,8,23,True,0,9
33132,4,112,49,161,True,0,9
33133,5,215,120,335,True,0,9
33134,6,310,146,456,True,0,9
33135,7,224,153,377,True,0,9
33136,8,208,162,370,True,0,9
33137,9,183,164,347,True,0,9
33138,10,201,206,407,True,0,9
33139,11,204,184,388,True,0,9
33140,12,200,227,427,True,0,9
33141,13,219,269,488,True,0,9
33142,14,166,262,428,True,0,9
33143,15,153,171,324,True,0,9
33144,16,124,137,261,True,0,9
33145,17,116,107,223,True,0,9
33146,18,103,100,203,True,0,9
33147,19,68,83,151,True,0,9
33148,20,44,57,101,True,0,9
33149,21,18,40,58,True,0,9
33150,22,11,15,26,True,0,9
33151,23,9,7,16,True,0,9
33152,0,2,4,6,True,1,9
33153,1,7,5,12,True,1,9
33154,2,5,6,11,True,1,9
33155,3,11,5,16,True,1,9
33156,4,112,39,151,True,1,9
33157,5,230,131,361,True,1,9
33158,6,324,160,484,True,1,9
33159,7,227,152,379,True,1,9
33160,8,245,138,383,True,1,9
33161,9,231,168,399,True,1,9
33162,10,209,181,390,True,1,9
33163,11,200,181,381,True,1,9
33164,12,208,222,430,True,1,9
33165,13,225,271,496,True,1,9
33166,14,172,264,436,True,1,9
33167,15,158,184,342,True,1,9
33168,16,146,129,275,True,1,9
33169,17,143,114,257,True,1,9
33170,18,96,106,202,True,1,9
33171,19,68,111,179,True,1,9
33172,20,53,81,134,True,1,9
33173,21,20,33,53,True,1,9
33174,22,17,16,33,True,1,9
33175,23,2,9,11,True,1,9
33176,0,5,6,11,True,2,9
33177,1,5,6,11,True,2,9
33178,2,3,5,8,True,2,9
33179,3,23,11,34,True,2,9
33180,4,105,43,148,True,2,9
33181,5,235,106,341,True,2,9
33182,6,310,160,470,True,2,9
33183,7,242,145,387,True,2,9
33184,8,223,151,374,True,2,9
33185,9,176,166,342,True,2,9
33186,10,217,193,410,True,2,9
33187,11,234,195,429,True,2,9
33188,12,213,203,416,True,2,9
33189,13,254,280,534,True,2,9
33190,14,202,279,481,True,2,9
33191,15,168,188,356,True,2,9
33192,16,159,144,303,True,2,9
33193,17,119,109,228,True,2,9
33194,18,80,102,182,True,2,9
33195,19,68,87,155,True,2,9
33196,20,46,59,105,True,2,9
33197,21,43,38,81,True,2,9
33198,22,19,8,27,True,2,9
33199,23,9,11,20,True,2,9
33200,0,8,10,18,True,3,9
33201,1,18,9,27,True,3,9
33202,2,8,4,12,True,3,9
33203,3,19,10,29,True,3,9
33204,4,107,37,144,True,3,9
33205,5,206,129,335,True,3,9
33206,6,280,135,415,True,3,9
33207,7,254,136,390,True,3,9
33208,8,214,155,369,True,3,9
33209,9,223,142,365,True,3,9
33210,10,209,162,371,True,3,9
33211,11,234,204,438,True,3,9
33212,12,199,240,439,True,3,9
33213,13,217,294,511,True,3,9
33214,14,223,257,480,True,3,9
33215,15,144,192,336,True,3,9
33216,16,145,129,274,True,3,9
33217,17,109,114,223,True,3,9
33218,18,96,100,196,True,3,9
33219,19,74,87,161,True,3,9
33220,20,45,277,322,True,3,9
33221,21,29,236,265,True,3,9
33222,22,13,77,90,True,3,9
33223,23,12,36,48,True,3,9
33224,0,11,34,45,True,4,9
33225,1,13,27,40,True,4,9
33226,2,3,36,39,True,4,9
33227,3,13,35,48,True,4,9
33228,4,110,39,149,True,4,9
33229,5,168,111,279,True,4,9
33230,6,251,116,367,True,4,9
33231,7,186,133,319,True,4,9
33232,8,177,135,312,True,4,9
33233,9,210,160,370,True,4,9
33234,10,211,168,379,True,4,9
33235,11,245,211,456,True,4,9
33236,12,209,220,429,True,4,9
33237,13,287,266,553,True,4,9
33238,14,181,265,446,True,4,9
33239,15,129,158,287,True,4,9
33240,16,132,168,300,True,4,9
33241,17,114,113,227,True,4,9
33242,18,66,76,142,True,4,9
33243,19,75,68,143,True,4,9
33244,20,56,65,121,True,4,9
33245,21,56,47,103,True,4,9
33246,22,34,40,74,True,4,9
33247,23,21,22,43,True,4,9
33248,0,20,25,45,True,5,9
33249,1,13,28,41,True,5,9
33250,2,9,23,32,True,5,9
33251,3,6,5,11,True,5,9
33252,4,27,15,42,True,5,9
33253,5,18,25,43,True,5,9
33254,6,37,27,64,True,5,9
33255,7,54,33,87,True,5,9
33256,8,86,54,140,True,5,9
33257,9,111,76,187,True,5,9
33258,10,140,131,271,True,5,9
33259,11,133,139,272,True,5,9
33260,12,143,141,284,True,5,9
33261,13,132,162,294,True,5,9
33262,14,109,163,272,True,5,9
33263,15,120,163,283,True,5,9
33264,16,142,114,256,True,5,9
33265,17,99,106,205,True,5,9
33266,18,63,87,150,True,5,9
33267,19,54,62,116,True,5,9
33268,20,42,58,100,True,5,9
33269,21,49,61,110,True,5,9
33270,22,36,43,79,True,5,9
33271,23,35,39,74,True,5,9
33272,0,39,34,73,True,6,9
33273,1,19,25,44,True,6,9
33274,2,13,19,32,True,6,9
33275,3,10,14,24,True,6,9
33276,4,20,13,33,True,6,9
33277,5,21,20,41,True,6,9
33278,6,33,11,44,True,6,9
33279,7,49,33,82,True,6,9
33280,8,87,56,143,True,6,9
33281,9,107,66,173,True,6,9
33282,10,158,125,283,True,6,9
33283,11,169,156,325,True,6,9
33284,12,173,224,397,True,6,9
33285,13,164,218,382,True,6,9
33286,14,139,189,328,True,6,9
33287,15,157,154,311,True,6,9
33288,16,160,157,317,True,6,9
33289,17,159,145,304,True,6,9
33290,18,90,136,226,True,6,9
33291,19,65,99,164,True,6,9
33292,20,51,62,113,True,6,9
33293,21,29,33,62,True,6,9
33294,22,13,22,35,True,6,9
33295,23,7,7,14,True,6,9
33296,0,6,9,15,False,0,9
33297,1,6,7,13,False,0,9
33298,2,8,9,17,False,0,9
33299,3,21,8,29,False,0,9
33300,4,130,53,183,False,0,9
33301,5,236,129,365,False,0,9
33302,6,401,173,574,False,0,9
33303,7,240,131,371,False,0,9
33304,8,202,142,344,False,0,9
33305,9,197,147,344,False,0,9
33306,10,189,154,343,False,0,9
33307,11,196,191,387,False,0,9
33308,12,206,225,431,False,0,9
33309,13,230,293,523,False,0,9
33310,14,223,276,499,False,0,9
33311,15,189,196,385,False,0,9
33312,16,189,131,320,False,0,9
33313,17,178,130,308,False,0,9
33314,18,129,159,288,False,0,9
33315,19,59,143,202,False,0,9
33316,20,36,113,149,False,0,9
33317,21,20,95,115,False,0,9
33318,22,6,30,36,False,0,9
33319,23,4,32,36,False,0,9
33320,0,7,8,15,False,1,9
33321,1,8,16,24,False,1,9
33322,2,6,23,29,False,1,9
33323,3,24,35,59,False,1,9
33324,4,113,100,213,False,1,9
33325,5,213,158,371,False,1,9
33326,6,402,175,577,False,1,9
33327,7,237,173,410,False,1,9
33328,8,219,149,368,False,1,9
33329,9,212,180,392,False,1,9
33330,10,205,175,380,False,1,9
33331,11,181,188,369,False,1,9
33332,12,202,240,442,False,1,9
33333,13,237,323,560,False,1,9
33334,14,213,286,499,False,1,9
33335,15,177,181,358,False,1,9
33336,16,185,140,325,False,1,9
33337,17,128,143,271,False,1,9
33338,18,99,114,213,False,1,9
33339,19,80,97,177,False,1,9
33340,20,52,145,197,False,1,9
33341,21,24,154,178,False,1,9
33342,22,13,49,62,False,1,9
33343,23,8,48,56,False,1,9
33344,0,14,21,35,False,2,9
33345,1,6,15,21,False,2,9
33346,2,8,18,26,False,2,9
33347,3,15,104,119,False,2,9
33348,4,133,196,329,False,2,9
33349,5,243,143,386,False,2,9
33350,6,411,154,565,False,2,9
33351,7,272,78,350,False,2,9
33352,8,198,137,335,False,2,9
33353,9,188,164,352,False,2,9
33354,10,221,202,423,False,2,9
33355,11,209,217,426,False,2,9
33356,12,219,247,466,False,2,9
33357,13,255,277,532,False,2,9
33358,14,223,307,530,False,2,9
33359,15,184,167,351,False,2,9
33360,16,188,151,339,False,2,9
33361,17,130,130,260,False,2,9
33362,18,103,101,204,False,2,9
33363,19,82,119,201,False,2,9
33364,20,49,172,221,False,2,9
33365,21,29,109,138,False,2,9
33366,22,15,25,40,False,2,9
33367,23,11,13,24,False,2,9
33368,0,10,21,31,False,3,9
33369,1,7,14,21,False,3,9
33370,2,7,10,17,False,3,9
33371,3,16,8,24,False,3,9
33372,4,106,49,155,False,3,9
33373,5,243,118,361,False,3,9
33374,6,378,197,575,False,3,9
33375,7,254,134,388,False,3,9
33376,8,237,165,402,False,3,9
33377,9,212,145,357,False,3,9
33378,10,200,187,387,False,3,9
33379,11,204,205,409,False,3,9
33380,12,199,255,454,False,3,9
33381,13,242,279,521,False,3,9
33382,14,215,294,509,False,3,9
33383,15,200,163,363,False,3,9
33384,16,195,150,345,False,3,9
33385,17,123,155,278,False,3,9
33386,18,96,110,206,False,3,9
33387,19,95,113,208,False,3,9
33388,20,64,70,134,False,3,9
33389,21,43,44,87,False,3,9
33390,22,16,24,40,False,3,9
33391,23,8,13,21,False,3,9
33392,0,16,11,27,False,4,9
33393,1,11,14,25,False,4,9
33394,2,5,11,16,False,4,9
33395,3,14,8,22,False,4,9
33396,4,116,52,168,False,4,9
33397,5,239,114,353,False,4,9
33398,6,412,181,593,False,4,9
33399,7,222,133,355,False,4,9
33400,8,217,149,366,False,4,9
33401,9,224,207,431,False,4,9
33402,10,229,212,441,False,4,9
33403,11,229,214,443,False,4,9
33404,12,265,288,553,False,4,9
33405,13,264,315,579,False,4,9
33406,14,184,283,467,False,4,9
33407,15,150,183,333,False,4,9
33408,16,148,149,297,False,4,9
33409,17,135,132,267,False,4,9
33410,18,106,102,208,False,4,9
33411,19,66,92,158,False,4,9
33412,20,58,73,131,False,4,9
33413,21,43,55,98,False,4,9
33414,22,24,40,64,False,4,9
33415,23,15,25,40,False,4,9
33416,0,12,24,36,False,5,9
33417,1,16,21,37,False,5,9
33418,2,9,14,23,False,5,9
33419,3,9,8,17,False,5,9
33420,4,21,6,27,False,5,9
33421,5,35,24,59,False,5,9
33422,6,38,28,66,False,5,9
33423,7,61,44,105,False,5,9
33424,8,111,73,184,False,5,9
33425,9,154,95,249,False,5,9
33426,10,148,100,248,False,5,9
33427,11,184,176,360,False,5,9
33428,12,176,169,345,False,5,9
33429,13,152,208,360,False,5,9
33430,14,147,159,306,False,5,9
33431,15,146,156,302,False,5,9
33432,16,131,134,265,False,5,9
33433,17,79,109,188,False,5,9
33434,18,79,79,158,False,5,9
33435,19,48,63,111,False,5,9
33436,20,45,69,114,False,5,9
33437,21,48,54,102,False,5,9
33438,22,42,59,101,False,5,9
33439,23,39,37,76,False,5,9
33440,0,23,27,50,True,6,9
33441,1,19,34,53,True,6,9
33442,2,15,25,40,True,6,9
33443,3,16,9,25,True,6,9
33444,4,17,8,25,True,6,9
33445,5,16,11,27,True,6,9
33446,6,38,21,59,True,6,9
33447,7,41,25,66,True,6,9
33448,8,112,49,161,True,6,9
33449,9,122,71,193,True,6,9
33450,10,163,127,290,True,6,9
33451,11,156,137,293,True,6,9
33452,12,192,171,363,True,6,9
33453,13,166,222,388,True,6,9
33454,14,141,201,342,True,6,9
33455,15,169,174,343,True,6,9
33456,16,143,156,299,True,6,9
33457,17,131,140,271,True,6,9
33458,18,99,124,223,True,6,9
33459,19,62,90,152,True,6,9
33460,20,60,76,136,True,6,9
33461,21,28,34,62,True,6,9
33462,22,15,15,30,True,6,9
33463,23,9,7,16,True,6,9
33464,0,9,8,17,False,0,9
33465,1,3,6,9,False,0,9
33466,2,8,10,18,False,0,9
33467,3,20,12,32,False,0,9
33468,4,112,45,157,False,0,9
33469,5,222,128,350,False,0,9
33470,6,436,178,614,False,0,9
33471,7,259,140,399,False,0,9
33472,8,225,161,386,False,0,9
33473,9,212,172,384,False,0,9
33474,10,193,204,397,False,0,9
33475,11,220,199,419,False,0,9
33476,12,220,228,448,False,0,9
33477,13,237,337,574,False,0,9
33478,14,199,249,448,False,0,9
33479,15,191,184,375,False,0,9
33480,16,160,148,308,False,0,9
33481,17,133,119,252,False,0,9
33482,18,92,112,204,False,0,9
33483,19,81,99,180,False,0,9
33484,20,54,57,111,False,0,9
33485,21,34,34,68,False,0,9
33486,22,11,14,25,False,0,9
33487,23,7,7,14,False,0,9
33488,0,4,6,10,False,1,9
33489,1,11,9,20,False,1,9
33490,2,3,5,8,False,1,9
33491,3,19,10,29,False,1,9
33492,4,120,41,161,False,1,9
33493,5,223,136,359,False,1,9
33494,6,379,201,580,False,1,9
33495,7,286,160,446,False,1,9
33496,8,215,169,384,False,1,9
33497,9,247,150,397,False,1,9
33498,10,232,201,433,False,1,9
33499,11,236,188,424,False,1,9
33500,12,229,237,466,False,1,9
33501,13,252,323,575,False,1,9
33502,14,255,304,559,False,1,9
33503,15,218,187,405,False,1,9
33504,16,183,166,349,False,1,9
33505,17,130,130,260,False,1,9
33506,18,88,125,213,False,1,9
33507,19,92,105,197,False,1,9
33508,20,63,69,132,False,1,9
33509,21,29,34,63,False,1,9
33510,22,18,11,29,False,1,9
33511,23,5,4,9,False,1,9
33512,0,6,7,13,False,2,9
33513,1,5,13,18,False,2,9
33514,2,7,6,13,False,2,9
33515,3,24,9,33,False,2,9
33516,4,116,43,159,False,2,9
33517,5,236,118,354,False,2,9
33518,6,406,198,604,False,2,9
33519,7,258,143,401,False,2,9
33520,8,212,164,376,False,2,9
33521,9,192,158,350,False,2,9
33522,10,212,175,387,False,2,9
33523,11,210,207,417,False,2,9
33524,12,223,244,467,False,2,9
33525,13,249,294,543,False,2,9
33526,14,231,274,505,False,2,9
33527,15,198,186,384,False,2,9
33528,16,171,173,344,False,2,9
33529,17,113,150,263,False,2,9
33530,18,113,112,225,False,2,9
33531,19,67,110,177,False,2,9
33532,20,55,71,126,False,2,9
33533,21,45,47,92,False,2,9
33534,22,21,18,39,False,2,9
33535,23,8,15,23,False,2,9
33536,0,7,3,10,False,3,9
33537,1,11,8,19,False,3,9
33538,2,6,10,16,False,3,9
33539,3,19,9,28,False,3,9
33540,4,116,48,164,False,3,9
33541,5,226,124,350,False,3,9
33542,6,392,191,583,False,3,9
33543,7,279,140,419,False,3,9
33544,8,195,172,367,False,3,9
33545,9,193,151,344,False,3,9
33546,10,225,176,401,False,3,9
33547,11,201,196,397,False,3,9
33548,12,390,369,759,False,3,9
33549,13,375,462,837,False,3,9
33550,14,302,350,652,False,3,9
33551,15,183,194,377,False,3,9
33552,16,160,133,293,False,3,9
33553,17,137,134,271,False,3,9
33554,18,94,104,198,False,3,9
33555,19,84,114,198,False,3,9
33556,20,69,72,141,False,3,9
33557,21,33,33,66,False,3,9
33558,22,13,21,34,False,3,9
33559,23,10,21,31,False,3,9
33560,0,10,13,23,False,4,9
33561,1,4,20,24,False,4,9
33562,2,7,10,17,False,4,9
33563,3,22,7,29,False,4,9
33564,4,112,45,157,False,4,9
33565,5,231,118,349,False,4,9
33566,6,328,186,514,False,4,9
33567,7,303,152,455,False,4,9
33568,8,225,155,380,False,4,9
33569,9,203,188,391,False,4,9
33570,10,228,207,435,False,4,9
33571,11,191,206,397,False,4,9
33572,12,221,236,457,False,4,9
33573,13,269,313,582,False,4,9
33574,14,183,251,434,False,4,9
33575,15,162,163,325,False,4,9
33576,16,149,159,308,False,4,9
33577,17,124,131,255,False,4,9
33578,18,84,81,165,False,4,9
33579,19,67,88,155,False,4,9
33580,20,52,66,118,False,4,9
33581,21,45,61,106,False,4,9
33582,22,26,43,69,False,4,9
33583,23,17,34,51,False,4,9
33584,0,19,27,46,False,5,9
33585,1,15,30,45,False,5,9
33586,2,10,17,27,False,5,9
33587,3,6,8,14,False,5,9
33588,4,21,16,37,False,5,9
33589,5,28,19,47,False,5,9
33590,6,52,26,78,False,5,9
33591,7,76,42,118,False,5,9
33592,8,146,65,211,False,5,9
33593,9,166,81,247,False,5,9
33594,10,162,145,307,False,5,9
33595,11,163,139,302,False,5,9
33596,12,181,183,364,False,5,9
33597,13,124,221,345,False,5,9
33598,14,148,174,322,False,5,9
33599,15,124,129,253,False,5,9
33600,16,149,130,279,False,5,9
33601,17,117,121,238,False,5,9
33602,18,79,88,167,False,5,9
33603,19,57,71,128,False,5,9
33604,20,35,56,91,False,5,9
33605,21,45,60,105,False,5,9
33606,22,41,47,88,False,5,9
33607,23,33,47,80,False,5,9
33608,0,29,25,54,True,6,9
33609,1,24,39,63,True,6,9
33610,2,18,28,46,True,6,9
33611,3,9,23,32,True,6,9
33612,4,8,7,15,True,6,9
33613,5,18,10,28,True,6,9
33614,6,23,11,34,True,6,9
33615,7,39,11,50,True,6,9
33616,8,49,36,85,True,6,9
33617,9,121,76,197,True,6,9
33618,10,137,107,244,True,6,9
33619,11,160,131,291,True,6,9
33620,12,186,196,382,True,6,9
33621,13,189,184,373,True,6,9
33622,14,161,213,374,True,6,9
33623,15,146,212,358,True,6,9
33624,16,147,139,286,True,6,9
33625,17,131,115,246,True,6,9
33626,18,123,141,264,True,6,9
33627,19,95,122,217,True,6,9
33628,20,67,83,150,True,6,9
33629,21,45,63,108,True,6,9
33630,22,22,41,63,True,6,9
33631,23,13,15,28,True,6,9
33632,0,13,7,20,False,0,9
33633,1,7,5,12,False,0,9
33634,2,10,10,20,False,0,9
33635,3,11,9,20,False,0,9
33636,4,24,8,32,False,0,9
33637,5,100,58,158,False,0,9
33638,6,233,135,368,False,0,9
33639,7,380,204,584,False,0,9
33640,8,255,134,389,False,0,9
33641,9,221,126,347,False,0,9
33642,10,194,147,341,False,0,9
33643,11,198,187,385,False,0,9
33644,12,205,188,393,False,0,9
33645,13,227,242,469,False,0,9
33646,14,224,334,558,False,0,9
33647,15,216,279,495,False,0,9
33648,16,208,178,386,False,0,9
33649,17,176,178,354,False,0,9
33650,18,115,125,240,False,0,9
33651,19,96,121,217,False,0,9
33652,20,110,102,212,False,0,9
33653,21,52,74,126,False,0,9
33654,22,29,52,81,False,0,9
33655,23,10,27,37,False,0,9
33656,0,8,9,17,False,1,9
33657,1,4,6,10,False,1,9
33658,2,7,7,14,False,1,9
33659,3,9,11,20,False,1,9
33660,4,25,7,32,False,1,9
33661,5,114,49,163,False,1,9
33662,6,235,144,379,False,1,9
33663,7,385,205,590,False,1,9
33664,8,270,154,424,False,1,9
33665,9,207,169,376,False,1,9
33666,10,206,148,354,False,1,9
33667,11,201,193,394,False,1,9
33668,12,194,201,395,False,1,9
33669,13,236,247,483,False,1,9
33670,14,250,299,549,False,1,9
33671,15,234,305,539,False,1,9
33672,16,177,177,354,False,1,9
33673,17,177,141,318,False,1,9
33674,18,135,127,262,False,1,9
33675,19,109,116,225,False,1,9
33676,20,89,105,194,False,1,9
33677,21,64,70,134,False,1,9
33678,22,29,35,64,False,1,9
33679,23,9,17,26,False,1,9
33680,0,6,14,20,False,2,9
33681,1,6,8,14,False,2,9
33682,2,7,7,14,False,2,9
33683,3,6,4,10,False,2,9
33684,4,19,8,27,False,2,9
33685,5,104,49,153,False,2,9
33686,6,221,137,358,False,2,9
33687,7,401,189,590,False,2,9
33688,8,257,161,418,False,2,9
33689,9,247,184,431,False,2,9
33690,10,219,172,391,False,2,9
33691,11,217,165,382,False,2,9
33692,12,228,224,452,False,2,9
33693,13,187,241,428,False,2,9
33694,14,249,296,545,False,2,9
33695,15,237,284,521,False,2,9
33696,16,189,184,373,False,2,9
33697,17,172,163,335,False,2,9
33698,18,118,154,272,False,2,9
33699,19,103,80,183,False,2,9
33700,20,63,91,154,False,2,9
33701,21,48,81,129,False,2,9
33702,22,25,44,69,False,2,9
33703,23,18,20,38,False,2,9
33704,0,7,9,16,False,3,9
33705,1,8,8,16,False,3,9
33706,2,3,10,13,False,3,9
33707,3,15,7,22,False,3,9
33708,4,21,6,27,False,3,9
33709,5,111,54,165,False,3,9
33710,6,226,131,357,False,3,9
33711,7,387,191,578,False,3,9
33712,8,239,136,375,False,3,9
33713,9,201,162,363,False,3,9
33714,10,197,179,376,False,3,9
33715,11,211,170,381,False,3,9
33716,12,218,223,441,False,3,9
33717,13,220,239,459,False,3,9
33718,14,292,322,614,False,3,9
33719,15,203,279,482,False,3,9
33720,16,191,181,372,False,3,9
33721,17,169,153,322,False,3,9
33722,18,125,145,270,False,3,9
33723,19,99,121,220,False,3,9
33724,20,81,99,180,False,3,9
33725,21,71,315,386,False,3,9
33726,22,30,196,226,False,3,9
33727,23,21,69,90,False,3,9
33728,0,18,18,36,False,4,10
33729,1,13,18,31,False,4,10
33730,2,20,10,30,False,4,10
33731,3,14,13,27,False,4,10
33732,4,26,7,33,False,4,10
33733,5,114,51,165,False,4,10
33734,6,239,123,362,False,4,10
33735,7,390,175,565,False,4,10
33736,8,250,152,402,False,4,10
33737,9,208,169,377,False,4,10
33738,10,208,149,357,False,4,10
33739,11,210,219,429,False,4,10
33740,12,223,207,430,False,4,10
33741,13,231,244,475,False,4,10
33742,14,279,310,589,False,4,10
33743,15,174,260,434,False,4,10
33744,16,135,149,284,False,4,10
33745,17,149,133,282,False,4,10
33746,18,116,119,235,False,4,10
33747,19,72,88,160,False,4,10
33748,20,59,72,131,False,4,10
33749,21,74,73,147,False,4,10
33750,22,39,56,95,False,4,10
33751,23,35,36,71,False,4,10
33752,0,22,17,39,False,5,10
33753,1,19,24,43,False,5,10
33754,2,15,20,35,False,5,10
33755,3,7,19,26,False,5,10
33756,4,13,9,22,False,5,10
33757,5,21,12,33,False,5,10
33758,6,23,20,43,False,5,10
33759,7,50,35,85,False,5,10
33760,8,74,46,120,False,5,10
33761,9,107,85,192,False,5,10
33762,10,144,96,240,False,5,10
33763,11,155,122,277,False,5,10
33764,12,154,168,322,False,5,10
33765,13,158,169,327,False,5,10
33766,14,167,204,371,False,5,10
33767,15,130,169,299,False,5,10
33768,16,136,133,269,False,5,10
33769,17,113,135,248,False,5,10
33770,18,93,101,194,False,5,10
33771,19,68,68,136,False,5,10
33772,20,55,66,121,False,5,10
33773,21,45,55,100,False,5,10
33774,22,51,53,104,False,5,10
33775,23,29,38,67,False,5,10
33776,0,35,35,70,True,6,10
33777,1,29,27,56,True,6,10
33778,2,24,21,45,True,6,10
33779,3,13,21,34,True,6,10
33780,4,9,10,19,True,6,10
33781,5,16,10,26,True,6,10
33782,6,11,18,29,True,6,10
33783,7,33,12,45,True,6,10
33784,8,56,46,102,True,6,10
33785,9,97,63,160,True,6,10
33786,10,109,91,200,True,6,10
33787,11,157,123,280,True,6,10
33788,12,169,153,322,True,6,10
33789,13,190,215,405,True,6,10
33790,14,177,234,411,True,6,10
33791,15,182,193,375,True,6,10
33792,16,261,153,414,True,6,10
33793,17,165,181,346,True,6,10
33794,18,135,233,368,True,6,10
33795,19,103,132,235,True,6,10
33796,20,69,82,151,True,6,10
33797,21,37,64,101,True,6,10
33798,22,27,32,59,True,6,10
33799,23,14,17,31,True,6,10
33800,0,8,10,18,False,0,10
33801,1,6,6,12,False,0,10
33802,2,8,12,20,False,0,10
33803,3,7,3,10,False,0,10
33804,4,24,11,35,False,0,10
33805,5,119,49,168,False,0,10
33806,6,227,126,353,False,0,10
33807,7,344,184,528,False,0,10
33808,8,243,122,365,False,0,10
33809,9,217,153,370,False,0,10
33810,10,194,155,349,False,0,10
33811,11,207,173,380,False,0,10
33812,12,203,200,403,False,0,10
33813,13,204,227,431,False,0,10
33814,14,251,296,547,False,0,10
33815,15,209,283,492,False,0,10
33816,16,191,186,377,False,0,10
33817,17,157,146,303,False,0,10
33818,18,101,150,251,False,0,10
33819,19,111,113,224,False,0,10
33820,20,74,98,172,False,0,10
33821,21,60,54,114,False,0,10
33822,22,31,25,56,False,0,10
33823,23,21,11,32,False,0,10
33824,0,11,15,26,False,1,10
33825,1,9,6,15,False,1,10
33826,2,18,3,21,False,1,10
33827,3,14,4,18,False,1,10
33828,4,28,12,40,False,1,10
33829,5,114,45,159,False,1,10
33830,6,239,120,359,False,1,10
33831,7,387,204,591,False,1,10
33832,8,260,168,428,False,1,10
33833,9,218,138,356,False,1,10
33834,10,194,155,349,False,1,10
33835,11,213,156,369,False,1,10
33836,12,187,204,391,False,1,10
33837,13,191,216,407,False,1,10
33838,14,267,317,584,False,1,10
33839,15,197,258,455,False,1,10
33840,16,156,161,317,False,1,10
33841,17,151,130,281,False,1,10
33842,18,128,121,249,False,1,10
33843,19,105,131,236,False,1,10
33844,20,61,86,147,False,1,10
33845,21,45,55,100,False,1,10
33846,22,22,18,40,False,1,10
33847,23,14,16,30,False,1,10
33848,0,4,9,13,False,2,10
33849,1,5,8,13,False,2,10
33850,2,5,6,11,False,2,10
33851,3,4,3,7,False,2,10
33852,4,20,14,34,False,2,10
33853,5,111,46,157,False,2,10
33854,6,224,121,345,False,2,10
33855,7,355,174,529,False,2,10
33856,8,251,117,368,False,2,10
33857,9,214,144,358,False,2,10
33858,10,224,155,379,False,2,10
33859,11,208,188,396,False,2,10
33860,12,196,189,385,False,2,10
33861,13,187,222,409,False,2,10
33862,14,238,281,519,False,2,10
33863,15,200,283,483,False,2,10
33864,16,191,199,390,False,2,10
33865,17,154,147,301,False,2,10
33866,18,116,125,241,False,2,10
33867,19,92,109,201,False,2,10
33868,20,81,100,181,False,2,10
33869,21,73,71,144,False,2,10
33870,22,37,42,79,False,2,10
33871,23,14,21,35,False,2,10
33872,0,10,10,20,False,3,10
33873,1,5,12,17,False,3,10
33874,2,5,8,13,False,3,10
33875,3,6,8,14,False,3,10
33876,4,15,9,24,False,3,10
33877,5,122,48,170,False,3,10
33878,6,244,118,362,False,3,10
33879,7,382,191,573,False,3,10
33880,8,234,127,361,False,3,10
33881,9,190,161,351,False,3,10
33882,10,204,169,373,False,3,10
33883,11,220,197,417,False,3,10
33884,12,212,212,424,False,3,10
33885,13,218,260,478,False,3,10
33886,14,265,290,555,False,3,10
33887,15,217,277,494,False,3,10
33888,16,185,168,353,False,3,10
33889,17,178,157,335,False,3,10
33890,18,126,115,241,False,3,10
33891,19,97,122,219,False,3,10
33892,20,81,103,184,False,3,10
33893,21,57,81,138,False,3,10
33894,22,4,39,43,False,3,10
33895,23,19,19,38,False,3,10
33896,0,12,14,26,False,4,10
33897,1,18,11,29,False,4,10
33898,2,12,10,22,False,4,10
33899,3,3,9,12,False,4,10
33900,4,17,7,24,False,4,10
33901,5,115,52,167,False,4,10
33902,6,232,121,353,False,4,10
33903,7,311,156,467,False,4,10
33904,8,213,134,347,False,4,10
33905,9,214,134,348,False,4,10
33906,10,233,165,398,False,4,10
33907,11,208,180,388,False,4,10
33908,12,209,199,408,False,4,10
33909,13,238,243,481,False,4,10
33910,14,244,285,529,False,4,10
33911,15,188,247,435,False,4,10
33912,16,154,163,317,False,4,10
33913,17,134,147,281,False,4,10
33914,18,108,111,219,False,4,10
33915,19,77,72,149,False,4,10
33916,20,98,81,179,False,4,10
33917,21,22,59,81,False,4,10
33918,22,2,51,53,False,4,10
33919,23,13,28,41,False,4,10
33920,0,22,26,48,False,5,10
33921,1,13,15,28,False,5,10
33922,2,17,13,30,False,5,10
33923,3,5,17,22,False,5,10
33924,4,7,10,17,False,5,10
33925,5,22,9,31,False,5,10
33926,6,48,27,75,False,5,10
33927,7,144,58,202,False,5,10
33928,8,58,39,97,False,5,10
33929,9,129,91,220,False,5,10
33930,10,131,85,216,False,5,10
33931,11,255,180,435,False,5,10
33932,12,170,190,360,False,5,10
33933,13,168,188,356,False,5,10
33934,14,169,224,393,False,5,10
33935,15,142,175,317,False,5,10
33936,16,147,220,367,False,5,10
33937,17,120,126,246,False,5,10
33938,18,123,115,238,False,5,10
33939,19,88,76,164,False,5,10
33940,20,55,73,128,False,5,10
33941,21,57,56,113,False,5,10
33942,22,40,61,101,False,5,10
33943,23,37,50,87,False,5,10
33944,0,25,34,59,True,6,10
33945,1,23,28,51,True,6,10
33946,2,19,32,51,True,6,10
33947,3,15,23,38,True,6,10
33948,4,10,15,25,True,6,10
33949,5,9,7,16,True,6,10
33950,6,23,11,34,True,6,10
33951,7,29,25,54,True,6,10
33952,8,60,31,91,True,6,10
33953,9,102,68,170,True,6,10
33954,10,110,89,199,True,6,10
33955,11,165,142,307,True,6,10
33956,12,154,141,295,True,6,10
33957,13,209,193,402,True,6,10
33958,14,158,168,326,True,6,10
33959,15,131,205,336,True,6,10
33960,16,147,134,281,True,6,10
33961,17,122,123,245,True,6,10
33962,18,123,118,241,True,6,10
33963,19,124,135,259,True,6,10
33964,20,74,92,166,True,6,10
33965,21,39,56,95,True,6,10
33966,22,29,28,57,True,6,10
33967,23,15,17,32,True,6,10
33968,0,17,9,26,False,0,10
33969,1,7,8,15,False,0,10
33970,2,5,7,12,False,0,10
33971,3,4,2,6,False,0,10
33972,4,22,11,33,False,0,10
33973,5,110,50,160,False,0,10
33974,6,218,115,333,False,0,10
33975,7,375,176,551,False,0,10
33976,8,245,144,389,False,0,10
33977,9,206,145,351,False,0,10
33978,10,211,146,357,False,0,10
33979,11,178,166,344,False,0,10
33980,12,233,214,447,False,0,10
33981,13,183,264,447,False,0,10
33982,14,229,300,529,False,0,10
33983,15,202,262,464,False,0,10
33984,16,187,140,327,False,0,10
33985,17,145,127,272,False,0,10
33986,18,112,116,228,False,0,10
33987,19,87,97,184,False,0,10
33988,20,86,86,172,False,0,10
33989,21,53,72,125,False,0,10
33990,22,20,35,55,False,0,10
33991,23,7,16,23,False,0,10
33992,0,4,9,13,False,1,10
33993,1,7,12,19,False,1,10
33994,2,5,5,10,False,1,10
33995,3,6,8,14,False,1,10
33996,4,20,9,29,False,1,10
33997,5,103,56,159,False,1,10
33998,6,254,131,385,False,1,10
33999,7,372,228,600,False,1,10
34000,8,275,159,434,False,1,10
34001,9,227,153,380,False,1,10
34002,10,208,142,350,False,1,10
34003,11,225,168,393,False,1,10
34004,12,194,205,399,False,1,10
34005,13,211,215,426,False,1,10
34006,14,257,318,575,False,1,10
34007,15,231,294,525,False,1,10
34008,16,186,190,376,False,1,10
34009,17,185,165,350,False,1,10
34010,18,132,126,258,False,1,10
34011,19,101,121,222,False,1,10
34012,20,77,108,185,False,1,10
34013,21,42,316,358,False,1,10
34014,22,22,174,196,False,1,10
34015,23,16,40,56,False,1,10
34016,0,11,11,22,False,2,10
34017,1,12,10,22,False,2,10
34018,2,8,6,14,False,2,10
34019,3,5,6,11,False,2,10
34020,4,19,7,26,False,2,10
34021,5,104,42,146,False,2,10
34022,6,221,131,352,False,2,10
34023,7,407,223,630,False,2,10
34024,8,290,161,451,False,2,10
34025,9,215,139,354,False,2,10
34026,10,204,147,351,False,2,10
34027,11,207,177,384,False,2,10
34028,12,198,185,383,False,2,10
34029,13,226,232,458,False,2,10
34030,14,265,321,586,False,2,10
34031,15,195,292,487,False,2,10
34032,16,182,185,367,False,2,10
34033,17,159,130,289,False,2,10
34034,18,127,157,284,False,2,10
34035,19,115,120,235,False,2,10
34036,20,76,97,173,False,2,10
34037,21,49,66,115,False,2,10
34038,22,21,44,65,False,2,10
34039,23,20,20,40,False,2,10
34040,0,10,11,21,False,3,10
34041,1,9,10,19,False,3,10
34042,2,9,11,20,False,3,10
34043,3,10,13,23,False,3,10
34044,4,16,12,28,False,3,10
34045,5,100,52,152,False,3,10
34046,6,241,137,378,False,3,10
34047,7,388,205,593,False,3,10
34048,8,262,170,432,False,3,10
34049,9,208,159,367,False,3,10
34050,10,216,169,385,False,3,10
34051,11,221,172,393,False,3,10
34052,12,233,192,425,False,3,10
34053,13,218,232,450,False,3,10
34054,14,276,317,593,False,3,10
34055,15,225,279,504,False,3,10
34056,16,188,192,380,False,3,10
34057,17,172,145,317,False,3,10
34058,18,123,133,256,False,3,10
34059,19,88,100,188,False,3,10
34060,20,89,96,185,False,3,10
34061,21,43,74,117,False,3,10
34062,22,38,51,89,False,3,10
34063,23,21,28,49,False,3,10
34064,0,15,18,33,False,4,10
34065,1,12,13,25,False,4,10
34066,2,12,17,29,False,4,10
34067,3,7,18,25,False,4,10
34068,4,14,10,24,False,4,10
34069,5,93,44,137,False,4,10
34070,6,243,119,362,False,4,10
34071,7,355,179,534,False,4,10
34072,8,229,156,385,False,4,10
34073,9,223,167,390,False,4,10
34074,10,246,172,418,False,4,10
34075,11,215,180,395,False,4,10
34076,12,226,218,444,False,4,10
34077,13,244,251,495,False,4,10
34078,14,273,314,587,False,4,10
34079,15,164,250,414,False,4,10
34080,16,156,174,330,False,4,10
34081,17,145,150,295,False,4,10
34082,18,118,113,231,False,4,10
34083,19,99,113,212,False,4,10
34084,20,64,71,135,False,4,10
34085,21,54,58,112,False,4,10
34086,22,44,45,89,False,4,10
34087,23,24,51,75,False,4,10
34088,0,14,32,46,False,5,10
34089,1,20,18,38,False,5,10
34090,2,20,28,48,False,5,10
34091,3,13,17,30,False,5,10
34092,4,4,8,12,False,5,10
34093,5,24,7,31,False,5,10
34094,6,30,23,53,False,5,10
34095,7,45,35,80,False,5,10
34096,8,60,39,99,False,5,10
34097,9,87,65,152,False,5,10
34098,10,139,80,219,False,5,10
34099,11,119,128,247,False,5,10
34100,12,160,113,273,False,5,10
34101,13,140,161,301,False,5,10
34102,14,139,168,307,False,5,10
34103,15,126,142,268,False,5,10
34104,16,120,138,258,False,5,10
34105,17,135,125,260,False,5,10
34106,18,101,102,203,False,5,10
34107,19,74,75,149,False,5,10
34108,20,72,79,151,False,5,10
34109,21,42,66,108,False,5,10
34110,22,46,70,116,False,5,10
34111,23,35,57,92,False,5,10
34112,0,30,47,77,True,6,10
34113,1,25,28,53,True,6,10
34114,2,28,37,65,True,6,10
34115,3,23,27,50,True,6,10
34116,4,12,16,28,True,6,10
34117,5,18,12,30,True,6,10
34118,6,17,15,32,True,6,10
34119,7,35,15,50,True,6,10
34120,8,35,43,78,True,6,10
34121,9,100,45,145,True,6,10
34122,10,115,65,180,True,6,10
34123,11,147,131,278,True,6,10
34124,12,142,150,292,True,6,10
34125,13,200,183,383,True,6,10
34126,14,167,217,384,True,6,10
34127,15,155,192,347,True,6,10
34128,16,152,166,318,True,6,10
34129,17,120,131,251,True,6,10
34130,18,123,129,252,True,6,10
34131,19,95,118,213,True,6,10
34132,20,65,82,147,True,6,10
34133,21,41,64,105,True,6,10
34134,22,30,29,59,True,6,10
34135,23,20,22,42,True,6,10
34136,0,14,12,26,False,0,10
34137,1,8,6,14,False,0,10
34138,2,6,14,20,False,0,10
34139,3,6,11,17,False,0,10
34140,4,21,8,29,False,0,10
34141,5,111,53,164,False,0,10
34142,6,248,145,393,False,0,10
34143,7,386,208,594,False,0,10
34144,8,254,168,422,False,0,10
34145,9,224,169,393,False,0,10
34146,10,211,166,377,False,0,10
34147,11,208,166,374,False,0,10
34148,12,216,192,408,False,0,10
34149,13,183,258,441,False,0,10
34150,14,246,302,548,False,0,10
34151,15,211,267,478,False,0,10
34152,16,170,162,332,False,0,10
34153,17,128,142,270,False,0,10
34154,18,121,105,226,False,0,10
34155,19,87,108,195,False,0,10
34156,20,84,98,182,False,0,10
34157,21,48,75,123,False,0,10
34158,22,29,43,72,False,0,10
34159,23,6,18,24,False,0,10
34160,0,1,7,8,False,1,10
34161,1,2,9,11,False,1,10
34162,2,2,7,9,False,1,10
34163,3,7,9,16,False,1,10
34164,4,19,5,24,False,1,10
34165,5,123,54,177,False,1,10
34166,6,220,131,351,False,1,10
34167,7,401,195,596,False,1,10
34168,8,278,165,443,False,1,10
34169,9,203,160,363,False,1,10
34170,10,208,146,354,False,1,10
34171,11,196,170,366,False,1,10
34172,12,226,183,409,False,1,10
34173,13,215,265,480,False,1,10
34174,14,282,319,601,False,1,10
34175,15,202,278,480,False,1,10
34176,16,172,174,346,False,1,10
34177,17,166,128,294,False,1,10
34178,18,135,133,268,False,1,10
34179,19,82,130,212,False,1,10
34180,20,76,93,169,False,1,10
34181,21,50,83,133,False,1,10
34182,22,30,39,69,False,1,10
34183,23,14,18,32,False,1,10
34184,0,13,11,24,False,2,10
34185,1,11,12,23,False,2,10
34186,2,5,6,11,False,2,10
34187,3,10,10,20,False,2,10
34188,4,19,7,26,False,2,10
34189,5,111,48,159,False,2,10
34190,6,224,132,356,False,2,10
34191,7,404,228,632,False,2,10
34192,8,256,138,394,False,2,10
34193,9,217,176,393,False,2,10
34194,10,197,153,350,False,2,10
34195,11,202,187,389,False,2,10
34196,12,233,189,422,False,2,10
34197,13,202,229,431,False,2,10
34198,14,261,295,556,False,2,10
34199,15,207,275,482,False,2,10
34200,16,206,217,423,False,2,10
34201,17,170,136,306,False,2,10
34202,18,123,129,252,False,2,10
34203,19,102,116,218,False,2,10
34204,20,67,79,146,False,2,10
34205,21,49,69,118,False,2,10
34206,22,31,57,88,False,2,10
34207,23,16,18,34,False,2,10
34208,0,7,16,23,False,3,10
34209,1,4,10,14,False,3,10
34210,2,9,13,22,False,3,10
34211,3,5,6,11,False,3,10
34212,4,13,8,21,False,3,10
34213,5,117,48,165,False,3,10
34214,6,251,118,369,False,3,10
34215,7,401,187,588,False,3,10
34216,8,224,161,385,False,3,10
34217,9,238,198,436,False,3,10
34218,10,228,167,395,False,3,10
34219,11,240,178,418,False,3,10
34220,12,216,204,420,False,3,10
34221,13,207,234,441,False,3,10
34222,14,237,292,529,False,3,10
34223,15,198,292,490,False,3,10
34224,16,184,167,351,False,3,10
34225,17,178,158,336,False,3,10
34226,18,114,123,237,False,3,10
34227,19,106,123,229,False,3,10
34228,20,80,109,189,False,3,10
34229,21,66,91,157,False,3,10
34230,22,30,57,87,False,3,10
34231,23,12,23,35,False,3,10
34232,0,13,17,30,False,4,10
34233,1,14,16,30,False,4,10
34234,2,8,28,36,False,4,10
34235,3,9,28,37,False,4,10
34236,4,18,10,28,False,4,10
34237,5,115,48,163,False,4,10
34238,6,223,109,332,False,4,10
34239,7,366,201,567,False,4,10
34240,8,258,138,396,False,4,10
34241,9,220,150,370,False,4,10
34242,10,219,160,379,False,4,10
34243,11,212,197,409,False,4,10
34244,12,214,229,443,False,4,10
34245,13,220,268,488,False,4,10
34246,14,239,315,554,False,4,10
34247,15,206,253,459,False,4,10
34248,16,185,189,374,False,4,10
34249,17,159,145,304,False,4,10
34250,18,119,137,256,False,4,10
34251,19,105,88,193,False,4,10
34252,20,78,74,152,False,4,10
34253,21,52,59,111,False,4,10
34254,22,50,65,115,False,4,10
34255,23,31,41,72,False,4,10
34256,0,21,28,49,False,5,10
34257,1,17,22,39,False,5,10
34258,2,10,11,21,False,5,10
34259,3,13,16,29,False,5,10
34260,4,10,12,22,False,5,10
34261,5,24,11,35,False,5,10
34262,6,26,22,48,False,5,10
34263,7,40,35,75,False,5,10
34264,8,56,38,94,False,5,10
34265,9,95,59,154,False,5,10
34266,10,139,102,241,False,5,10
34267,11,148,121,269,False,5,10
34268,12,185,137,322,False,5,10
34269,13,294,170,464,False,5,10
34270,14,560,174,734,False,5,10
34271,15,489,190,679,False,5,10
34272,16,185,523,708,False,5,10
34273,17,126,265,391,False,5,10
34274,18,102,145,247,False,5,10
34275,19,78,82,160,False,5,10
34276,20,44,64,108,False,5,10
34277,21,54,75,129,False,5,10
34278,22,44,60,104,False,5,10
34279,23,41,53,94,False,5,10
34280,0,24,36,60,True,6,10
34281,1,22,34,56,True,6,10
34282,2,27,29,56,True,6,10
34283,3,17,21,38,True,6,10
34284,4,16,20,36,True,6,10
34285,5,16,13,29,True,6,10
34286,6,19,16,35,True,6,10
34287,7,38,19,57,True,6,10
34288,8,58,39,97,True,6,10
34289,9,90,45,135,True,6,10
34290,10,114,69,183,True,6,10
34291,11,151,156,307,True,6,10
34292,12,176,160,336,True,6,10
34293,13,183,205,388,True,6,10
34294,14,183,218,401,True,6,10
34295,15,160,185,345,True,6,10
34296,16,128,137,265,True,6,10
34297,17,139,121,260,True,6,10
34298,18,123,112,235,True,6,10
34299,19,98,110,208,True,6,10
34300,20,63,96,159,True,6,10
34301,21,47,48,95,True,6,10
34302,22,16,31,47,True,6,10
34303,23,14,12,26,True,6,10
34304,0,14,12,26,False,0,10
34305,1,8,13,21,False,0,10
34306,2,7,12,19,False,0,10
34307,3,7,7,14,False,0,10
34308,4,25,12,37,False,0,10
34309,5,116,47,163,False,0,10
34310,6,253,125,378,False,0,10
34311,7,384,197,581,False,0,10
34312,8,260,138,398,False,0,10
34313,9,218,166,384,False,0,10
34314,10,238,147,385,False,0,10
34315,11,191,176,367,False,0,10
34316,12,209,190,399,False,0,10
34317,13,216,229,445,False,0,10
34318,14,229,290,519,False,0,10
34319,15,194,316,510,False,0,10
34320,16,192,165,357,False,0,10
34321,17,145,146,291,False,0,10
34322,18,123,103,226,False,0,10
34323,19,114,108,222,False,0,10
34324,20,65,105,170,False,0,10
34325,21,53,61,114,False,0,10
34326,22,22,75,97,False,0,10
34327,23,15,35,50,False,0,10
34328,0,12,12,24,False,1,10
34329,1,2,2,4,False,1,10
34330,2,6,12,18,False,1,10
34331,3,7,3,10,False,1,10
34332,4,16,11,27,False,1,10
34333,5,125,53,178,False,1,10
34334,6,248,142,390,False,1,10
34335,7,405,197,602,False,1,10
34336,8,261,188,449,False,1,10
34337,9,177,158,335,False,1,10
34338,10,215,149,364,False,1,10
34339,11,194,171,365,False,1,10
34340,12,199,185,384,False,1,10
34341,13,211,213,424,False,1,10
34342,14,235,333,568,False,1,10
34343,15,197,301,498,False,1,10
34344,16,194,160,354,False,1,10
34345,17,150,152,302,False,1,10
34346,18,105,118,223,False,1,10
34347,19,84,93,177,False,1,10
34348,20,63,95,158,False,1,10
34349,21,48,62,110,False,1,10
34350,22,31,42,73,False,1,10
34351,23,19,11,30,False,1,10
34352,0,10,8,18,False,2,10
34353,1,15,9,24,False,2,10
34354,2,17,6,23,False,2,10
34355,3,17,5,22,False,2,10
34356,4,22,10,32,False,2,10
34357,5,124,46,170,False,2,10
34358,6,219,108,327,False,2,10
34359,7,366,169,535,False,2,10
34360,8,203,120,323,False,2,10
34361,9,172,130,302,False,2,10
34362,10,181,140,321,False,2,10
34363,11,165,142,307,False,2,10
34364,12,208,167,375,False,2,10
34365,13,198,231,429,False,2,10
34366,14,215,280,495,False,2,10
34367,15,178,232,410,False,2,10
34368,16,171,170,341,False,2,10
34369,17,149,140,289,False,2,10
34370,18,140,131,271,False,2,10
34371,19,121,128,249,False,2,10
34372,20,105,102,207,False,2,10
34373,21,65,96,161,False,2,10
34374,22,31,32,63,False,2,10
34375,23,23,21,44,False,2,10
34376,0,21,12,33,False,3,10
34377,1,13,7,20,False,3,10
34378,2,7,6,13,False,3,10
34379,3,17,5,22,False,3,10
34380,4,27,15,42,False,3,10
34381,5,125,51,176,False,3,10
34382,6,223,113,336,False,3,10
34383,7,375,194,569,False,3,10
34384,8,255,169,424,False,3,10
34385,9,196,136,332,False,3,10
34386,10,233,171,404,False,3,10
34387,11,202,173,375,False,3,10
34388,12,212,192,404,False,3,10
34389,13,226,249,475,False,3,10
34390,14,272,333,605,False,3,10
34391,15,192,267,459,False,3,10
34392,16,180,174,354,False,3,10
34393,17,179,146,325,False,3,10
34394,18,111,125,236,False,3,10
34395,19,95,124,219,False,3,10
34396,20,85,97,182,False,3,10
34397,21,52,94,146,False,3,10
34398,22,32,38,70,False,3,10
34399,23,21,28,49,False,3,10
34400,0,13,18,31,False,4,10
34401,1,9,19,28,False,4,10
34402,2,10,20,30,False,4,10
34403,3,8,8,16,False,4,10
34404,4,20,13,33,False,4,10
34405,5,110,45,155,False,4,10
34406,6,234,136,370,False,4,10
34407,7,385,199,584,False,4,10
34408,8,248,147,395,False,4,10
34409,9,197,154,351,False,4,10
34410,10,205,159,364,False,4,10
34411,11,215,191,406,False,4,10
34412,12,245,201,446,False,4,10
34413,13,248,260,508,False,4,10
34414,14,257,290,547,False,4,10
34415,15,213,262,475,False,4,10
34416,16,147,176,323,False,4,10
34417,17,180,163,343,False,4,10
34418,18,133,162,295,False,4,10
34419,19,88,87,175,False,4,10
34420,20,68,90,158,False,4,10
34421,21,69,80,149,False,4,10
34422,22,59,88,147,False,4,10
34423,23,46,54,100,False,4,10
34424,0,25,32,57,False,5,10
34425,1,23,28,51,False,5,10
34426,2,16,23,39,False,5,10
34427,3,12,20,32,False,5,10
34428,4,10,11,21,False,5,10
34429,5,22,12,34,False,5,10
34430,6,28,27,55,False,5,10
34431,7,50,31,81,False,5,10
34432,8,70,33,103,False,5,10
34433,9,106,70,176,False,5,10
34434,10,129,90,219,False,5,10
34435,11,152,111,263,False,5,10
34436,12,174,142,316,False,5,10
34437,13,147,140,287,False,5,10
34438,14,158,177,335,False,5,10
34439,15,139,163,302,False,5,10
34440,16,129,153,282,False,5,10
34441,17,130,135,265,False,5,10
34442,18,111,114,225,False,5,10
34443,19,69,96,165,False,5,10
34444,20,55,60,115,False,5,10
34445,21,53,72,125,False,5,10
34446,22,54,61,115,False,5,10
34447,23,28,52,80,False,5,10
34448,0,29,31,60,True,6,11
34449,1,25,24,49,True,6,11
34450,2,18,35,53,True,6,11
34451,3,20,23,43,True,6,11
34452,4,15,17,32,True,6,11
34453,5,17,16,33,True,6,11
34454,6,17,18,35,True,6,11
34455,7,33,16,49,True,6,11
34456,8,53,28,81,True,6,11
34457,9,79,51,130,True,6,11
34458,10,98,82,180,True,6,11
34459,11,128,144,272,True,6,11
34460,12,147,141,288,True,6,11
34461,13,197,164,361,True,6,11
34462,14,164,203,367,True,6,11
34463,15,163,175,338,True,6,11
34464,16,155,190,345,True,6,11
34465,17,126,143,269,True,6,11
34466,18,118,126,244,True,6,11
34467,19,142,139,281,True,6,11
34468,20,61,81,142,True,6,11
34469,21,47,50,97,True,6,11
34470,22,32,40,72,True,6,11
34471,23,17,26,43,True,6,11
34472,0,15,10,25,False,0,11
34473,1,9,14,23,False,0,11
34474,2,13,13,26,False,0,11
34475,3,7,7,14,False,0,11
34476,4,16,11,27,False,0,11
34477,5,107,48,155,False,0,11
34478,6,214,131,345,False,0,11
34479,7,399,201,600,False,0,11
34480,8,265,157,422,False,0,11
34481,9,227,157,384,False,0,11
34482,10,209,168,377,False,0,11
34483,11,206,160,366,False,0,11
34484,12,186,194,380,False,0,11
34485,13,209,205,414,False,0,11
34486,14,237,319,556,False,0,11
34487,15,197,289,486,False,0,11
34488,16,158,194,352,False,0,11
34489,17,146,130,276,False,0,11
34490,18,115,112,227,False,0,11
34491,19,88,126,214,False,0,11
34492,20,88,95,183,False,0,11
34493,21,65,65,130,False,0,11
34494,22,27,20,47,False,0,11
34495,23,18,19,37,False,0,11
34496,0,8,10,18,False,1,11
34497,1,8,10,18,False,1,11
34498,2,11,6,17,False,1,11
34499,3,5,3,8,False,1,11
34500,4,23,6,29,False,1,11
34501,5,119,48,167,False,1,11
34502,6,242,135,377,False,1,11
34503,7,300,203,503,False,1,11
34504,8,289,176,465,False,1,11
34505,9,218,181,399,False,1,11
34506,10,223,166,389,False,1,11
34507,11,180,182,362,False,1,11
34508,12,225,191,416,False,1,11
34509,13,212,231,443,False,1,11
34510,14,266,304,570,False,1,11
34511,15,204,276,480,False,1,11
34512,16,194,199,393,False,1,11
34513,17,173,167,340,False,1,11
34514,18,117,131,248,False,1,11
34515,19,98,114,212,False,1,11
34516,20,73,101,174,False,1,11
34517,21,77,51,128,False,1,11
34518,22,36,55,91,False,1,11
34519,23,19,13,32,False,1,11
34520,0,11,6,17,False,2,11
34521,1,4,5,9,False,2,11
34522,2,10,3,13,False,2,11
34523,3,5,6,11,False,2,11
34524,4,17,7,24,False,2,11
34525,5,119,41,160,False,2,11
34526,6,277,139,416,False,2,11
34527,7,402,210,612,False,2,11
34528,8,267,141,408,False,2,11
34529,9,212,172,384,False,2,11
34530,10,217,156,373,False,2,11
34531,11,210,187,397,False,2,11
34532,12,186,178,364,False,2,11
34533,13,227,259,486,False,2,11
34534,14,268,302,570,False,2,11
34535,15,235,334,569,False,2,11
34536,16,171,179,350,False,2,11
34537,17,171,141,312,False,2,11
34538,18,130,137,267,False,2,11
34539,19,103,119,222,False,2,11
34540,20,80,100,180,False,2,11
34541,21,52,58,110,False,2,11
34542,22,40,41,81,False,2,11
34543,23,18,15,33,False,2,11
34544,0,9,14,23,False,3,11
34545,1,8,18,26,False,3,11
34546,2,9,24,33,False,3,11
34547,3,5,18,23,False,3,11
34548,4,15,6,21,False,3,11
34549,5,121,48,169,False,3,11
34550,6,273,109,382,False,3,11
34551,7,416,204,620,False,3,11
34552,8,226,141,367,False,3,11
34553,9,206,160,366,False,3,11
34554,10,224,174,398,False,3,11
34555,11,245,175,420,False,3,11
34556,12,187,213,400,False,3,11
34557,13,256,237,493,False,3,11
34558,14,252,358,610,False,3,11
34559,15,221,306,527,False,3,11
34560,16,175,193,368,False,3,11
34561,17,182,145,327,False,3,11
34562,18,121,138,259,False,3,11
34563,19,93,143,236,False,3,11
34564,20,67,82,149,False,3,11
34565,21,68,60,128,False,3,11
34566,22,38,50,88,False,3,11
34567,23,20,28,48,False,3,11
34568,0,19,24,43,False,4,11
34569,1,8,17,25,False,4,11
34570,2,21,17,38,False,4,11
34571,3,12,2,14,False,4,11
34572,4,18,6,24,False,4,11
34573,5,106,57,163,False,4,11
34574,6,247,108,355,False,4,11
34575,7,376,198,574,False,4,11
34576,8,256,149,405,False,4,11
34577,9,220,187,407,False,4,11
34578,10,223,154,377,False,4,11
34579,11,219,184,403,False,4,11
34580,12,245,220,465,False,4,11
34581,13,263,252,515,False,4,11
34582,14,290,284,574,False,4,11
34583,15,218,293,511,False,4,11
34584,16,169,171,340,False,4,11
34585,17,180,143,323,False,4,11
34586,18,116,151,267,False,4,11
34587,19,80,113,193,False,4,11
34588,20,70,77,147,False,4,11
34589,21,66,64,130,False,4,11
34590,22,54,73,127,False,4,11
34591,23,36,42,78,False,4,11
34592,0,45,49,94,False,5,11
34593,1,21,19,40,False,5,11
34594,2,14,33,47,False,5,11
34595,3,20,22,42,False,5,11
34596,4,14,15,29,False,5,11
34597,5,21,9,30,False,5,11
34598,6,30,16,46,False,5,11
34599,7,46,23,69,False,5,11
34600,8,56,30,86,False,5,11
34601,9,101,72,173,False,5,11
34602,10,157,100,257,False,5,11
34603,11,169,127,296,False,5,11
34604,12,174,145,319,False,5,11
34605,13,209,267,476,False,5,11
34606,14,156,197,353,False,5,11
34607,15,125,150,275,False,5,11
34608,16,131,175,306,False,5,11
34609,17,136,135,271,False,5,11
34610,18,99,101,200,False,5,11
34611,19,81,87,168,False,5,11
34612,20,60,70,130,False,5,11
34613,21,42,61,103,False,5,11
34614,22,51,62,113,False,5,11
34615,23,42,39,81,False,5,11
34616,0,21,32,53,True,6,11
34617,1,25,33,58,True,6,11
34618,2,20,44,64,True,6,11
34619,3,17,26,43,True,6,11
34620,4,15,14,29,True,6,11
34621,5,17,8,25,True,6,11
34622,6,23,19,42,True,6,11
34623,7,31,16,47,True,6,11
34624,8,37,30,67,True,6,11
34625,9,116,51,167,True,6,11
34626,10,99,58,157,True,6,11
34627,11,136,120,256,True,6,11
34628,12,159,152,311,True,6,11
34629,13,180,173,353,True,6,11
34630,14,154,177,331,True,6,11
34631,15,155,160,315,True,6,11
34632,16,127,161,288,True,6,11
34633,17,139,125,264,True,6,11
34634,18,122,101,223,True,6,11
34635,19,103,120,223,True,6,11
34636,20,64,74,138,True,6,11
34637,21,39,58,97,True,6,11
34638,22,21,26,47,True,6,11
34639,23,19,13,32,True,6,11
34640,0,8,18,26,False,0,11
34641,1,10,6,16,False,0,11
34642,2,12,11,23,False,0,11
34643,3,9,7,16,False,0,11
34644,4,19,7,26,False,0,11
34645,5,122,50,172,False,0,11
34646,6,224,141,365,False,0,11
34647,7,406,198,604,False,0,11
34648,8,266,142,408,False,0,11
34649,9,204,163,367,False,0,11
34650,10,209,144,353,False,0,11
34651,11,207,171,378,False,0,11
34652,12,234,192,426,False,0,11
34653,13,226,256,482,False,0,11
34654,14,245,317,562,False,0,11
34655,15,216,303,519,False,0,11
34656,16,176,184,360,False,0,11
34657,17,153,134,287,False,0,11
34658,18,114,111,225,False,0,11
34659,19,99,87,186,False,0,11
34660,20,73,80,153,False,0,11
34661,21,70,62,132,False,0,11
34662,22,34,46,80,False,0,11
34663,23,21,15,36,False,0,11
34664,0,14,27,41,False,1,11
34665,1,6,6,12,False,1,11
34666,2,5,8,13,False,1,11
34667,3,9,8,17,False,1,11
34668,4,16,8,24,False,1,11
34669,5,102,47,149,False,1,11
34670,6,250,140,390,False,1,11
34671,7,385,191,576,False,1,11
34672,8,271,154,425,False,1,11
34673,9,206,157,363,False,1,11
34674,10,215,166,381,False,1,11
34675,11,232,202,434,False,1,11
34676,12,230,214,444,False,1,11
34677,13,233,243,476,False,1,11
34678,14,252,306,558,False,1,11
34679,15,226,340,566,False,1,11
34680,16,196,167,363,False,1,11
34681,17,180,158,338,False,1,11
34682,18,110,120,230,False,1,11
34683,19,77,93,170,False,1,11
34684,20,91,114,205,False,1,11
34685,21,59,84,143,False,1,11
34686,22,39,48,87,False,1,11
34687,23,20,15,35,False,1,11
34688,0,17,10,27,False,2,11
34689,1,8,15,23,False,2,11
34690,2,15,12,27,False,2,11
34691,3,14,5,19,False,2,11
34692,4,15,6,21,False,2,11
34693,5,111,45,156,False,2,11
34694,6,260,148,408,False,2,11
34695,7,414,207,621,False,2,11
34696,8,281,166,447,False,2,11
34697,9,226,160,386,False,2,11
34698,10,222,181,403,False,2,11
34699,11,205,179,384,False,2,11
34700,12,210,176,386,False,2,11
34701,13,228,251,479,False,2,11
34702,14,278,339,617,False,2,11
34703,15,248,303,551,False,2,11
34704,16,203,182,385,False,2,11
34705,17,149,146,295,False,2,11
34706,18,127,162,289,False,2,11
34707,19,90,109,199,False,2,11
34708,20,67,124,191,False,2,11
34709,21,68,305,373,False,2,11
34710,22,32,176,208,False,2,11
34711,23,13,60,73,False,2,11
34712,0,11,46,57,False,3,11
34713,1,5,30,35,False,3,11
34714,2,11,34,45,False,3,11
34715,3,10,31,41,False,3,11
34716,4,17,21,38,False,3,11
34717,5,107,58,165,False,3,11
34718,6,260,139,399,False,3,11
34719,7,418,203,621,False,3,11
34720,8,256,142,398,False,3,11
34721,9,193,156,349,False,3,11
34722,10,241,185,426,False,3,11
34723,11,236,184,420,False,3,11
34724,12,230,205,435,False,3,11
34725,13,248,227,475,False,3,11
34726,14,288,310,598,False,3,11
34727,15,265,306,571,False,3,11
34728,16,192,186,378,False,3,11
34729,17,193,167,360,False,3,11
34730,18,154,139,293,False,3,11
34731,19,97,116,213,False,3,11
34732,20,87,123,210,False,3,11
34733,21,68,82,150,False,3,11
34734,22,36,62,98,False,3,11
34735,23,24,32,56,False,3,11
34736,0,22,20,42,False,4,11
34737,1,16,14,30,False,4,11
34738,2,14,15,29,False,4,11
34739,3,10,11,21,False,4,11
34740,4,19,4,23,False,4,11
34741,5,96,44,140,False,4,11
34742,6,256,133,389,False,4,11
34743,7,388,210,598,False,4,11
34744,8,315,146,461,False,4,11
34745,9,234,144,378,False,4,11
34746,10,237,198,435,False,4,11
34747,11,245,213,458,False,4,11
34748,12,248,210,458,False,4,11
34749,13,256,256,512,False,4,11
34750,14,273,348,621,False,4,11
34751,15,215,452,667,False,4,11
34752,16,176,201,377,False,4,11
34753,17,181,177,358,False,4,11
34754,18,128,152,280,False,4,11
34755,19,94,122,216,False,4,11
34756,20,70,100,170,False,4,11
34757,21,64,74,138,False,4,11
34758,22,46,68,114,False,4,11
34759,23,49,42,91,False,4,11
34760,0,32,36,68,False,5,11
34761,1,28,37,65,False,5,11
34762,2,21,30,51,False,5,11
34763,3,19,21,40,False,5,11
34764,4,11,9,20,False,5,11
34765,5,21,10,31,False,5,11
34766,6,27,25,52,False,5,11
34767,7,36,19,55,False,5,11
34768,8,50,42,92,False,5,11
34769,9,99,83,182,False,5,11
34770,10,155,104,259,False,5,11
34771,11,196,109,305,False,5,11
34772,12,243,172,415,False,5,11
34773,13,264,185,449,False,5,11
34774,14,166,235,401,False,5,11
34775,15,179,215,394,False,5,11
34776,16,149,198,347,False,5,11
34777,17,148,166,314,False,5,11
34778,18,110,129,239,False,5,11
34779,19,99,97,196,False,5,11
34780,20,65,89,154,False,5,11
34781,21,68,76,144,False,5,11
34782,22,55,68,123,False,5,11
34783,23,47,61,108,False,5,11
34784,0,27,34,61,True,6,11
34785,1,28,31,59,True,6,11
34786,2,26,44,70,True,6,11
34787,3,17,21,38,True,6,11
34788,4,14,12,26,True,6,11
34789,5,15,6,21,True,6,11
34790,6,18,24,42,True,6,11
34791,7,30,24,54,True,6,11
34792,8,57,31,88,True,6,11
34793,9,93,60,153,True,6,11
34794,10,132,86,218,True,6,11
34795,11,120,147,267,True,6,11
34796,12,160,154,314,True,6,11
34797,13,183,186,369,True,6,11
34798,14,169,181,350,True,6,11
34799,15,153,181,334,True,6,11
34800,16,171,127,298,True,6,11
34801,17,138,160,298,True,6,11
34802,18,107,125,232,True,6,11
34803,19,102,118,220,True,6,11
34804,20,71,78,149,True,6,11
34805,21,44,76,120,True,6,11
34806,22,21,28,49,True,6,11
34807,23,21,25,46,True,6,11
34808,0,10,16,26,False,0,11
34809,1,8,3,11,False,0,11
34810,2,5,13,18,False,0,11
34811,3,11,5,16,False,0,11
34812,4,15,10,25,False,0,11
34813,5,116,44,160,False,0,11
34814,6,238,143,381,False,0,11
34815,7,426,198,624,False,0,11
34816,8,259,159,418,False,0,11
34817,9,226,156,382,False,0,11
34818,10,267,192,459,False,0,11
34819,11,252,176,428,False,0,11
34820,12,254,227,481,False,0,11
34821,13,212,254,466,False,0,11
34822,14,272,311,583,False,0,11
34823,15,217,326,543,False,0,11
34824,16,159,182,341,False,0,11
34825,17,139,119,258,False,0,11
34826,18,125,117,242,False,0,11
34827,19,107,119,226,False,0,11
34828,20,81,90,171,False,0,11
34829,21,51,74,125,False,0,11
34830,22,23,33,56,False,0,11
34831,23,22,14,36,False,0,11
34832,0,9,13,22,False,1,11
34833,1,7,10,17,False,1,11
34834,2,20,11,31,False,1,11
34835,3,12,12,24,False,1,11
34836,4,18,10,28,False,1,11
34837,5,110,47,157,False,1,11
34838,6,243,123,366,False,1,11
34839,7,420,208,628,False,1,11
34840,8,256,164,420,False,1,11
34841,9,248,148,396,False,1,11
34842,10,241,185,426,False,1,11
34843,11,205,200,405,False,1,11
34844,12,217,189,406,False,1,11
34845,13,246,252,498,False,1,11
34846,14,279,332,611,False,1,11
34847,15,256,363,619,False,1,11
34848,16,173,181,354,False,1,11
34849,17,150,146,296,False,1,11
34850,18,158,142,300,False,1,11
34851,19,107,125,232,False,1,11
34852,20,72,90,162,False,1,11
34853,21,54,78,132,False,1,11
34854,22,27,36,63,False,1,11
34855,23,14,19,33,False,1,11
34856,0,10,17,27,False,2,11
34857,1,14,16,30,False,2,11
34858,2,13,15,28,False,2,11
34859,3,7,4,11,False,2,11
34860,4,13,6,19,False,2,11
34861,5,95,48,143,False,2,11
34862,6,258,134,392,False,2,11
34863,7,388,185,573,False,2,11
34864,8,246,163,409,False,2,11
34865,9,271,167,438,False,2,11
34866,10,258,168,426,False,2,11
34867,11,233,213,446,False,2,11
34868,12,247,227,474,False,2,11
34869,13,269,248,517,False,2,11
34870,14,266,329,595,False,2,11
34871,15,222,322,544,False,2,11
34872,16,201,210,411,False,2,11
34873,17,148,177,325,False,2,11
34874,18,119,153,272,False,2,11
34875,19,113,120,233,False,2,11
34876,20,80,94,174,False,2,11
34877,21,87,57,144,False,2,11
34878,22,49,50,99,False,2,11
34879,23,23,23,46,False,2,11
34880,0,24,39,63,False,3,11
34881,1,8,50,58,False,3,11
34882,2,14,51,65,False,3,11
34883,3,7,41,48,False,3,11
34884,4,15,34,49,False,3,11
34885,5,112,55,167,False,3,11
34886,6,229,117,346,False,3,11
34887,7,382,196,578,False,3,11
34888,8,268,146,414,False,3,11
34889,9,252,181,433,False,3,11
34890,10,314,187,501,False,3,11
34891,11,258,217,475,False,3,11
34892,12,257,251,508,False,3,11
34893,13,251,270,521,False,3,11
34894,14,282,345,627,False,3,11
34895,15,239,371,610,False,3,11
34896,16,162,194,356,False,3,11
34897,17,151,157,308,False,3,11
34898,18,140,132,272,False,3,11
34899,19,133,128,261,False,3,11
34900,20,77,101,178,False,3,11
34901,21,73,97,170,False,3,11
34902,22,29,53,82,False,3,11
34903,23,25,26,51,False,3,11
34904,0,17,23,40,False,4,11
34905,1,15,17,32,False,4,11
34906,2,9,23,32,False,4,11
34907,3,17,14,31,False,4,11
34908,4,18,15,33,False,4,11
34909,5,99,38,137,False,4,11
34910,6,223,105,328,False,4,11
34911,7,332,178,510,False,4,11
34912,8,241,153,394,False,4,11
34913,9,258,195,453,False,4,11
34914,10,308,225,533,False,4,11
34915,11,280,235,515,False,4,11
34916,12,274,275,549,False,4,11
34917,13,296,287,583,False,4,11
34918,14,293,327,620,False,4,11
34919,15,185,294,479,False,4,11
34920,16,179,158,337,False,4,11
34921,17,162,160,322,False,4,11
34922,18,128,132,260,False,4,11
34923,19,88,111,199,False,4,11
34924,20,63,85,148,False,4,11
34925,21,55,89,144,False,4,11
34926,22,46,59,105,False,4,11
34927,23,32,48,80,False,4,11
34928,0,21,29,50,False,5,11
34929,1,21,17,38,False,5,11
34930,2,16,33,49,False,5,11
34931,3,13,16,29,False,5,11
34932,4,9,4,13,False,5,11
34933,5,23,17,40,False,5,11
34934,6,25,14,39,False,5,11
34935,7,35,26,61,False,5,11
34936,8,52,34,86,False,5,11
34937,9,101,65,166,False,5,11
34938,10,164,112,276,False,5,11
34939,11,164,141,305,False,5,11
34940,12,178,148,326,False,5,11
34941,13,177,148,325,False,5,11
34942,14,159,176,335,False,5,11
34943,15,139,174,313,False,5,11
34944,16,118,138,256,False,5,11
34945,17,132,163,295,False,5,11
34946,18,105,93,198,False,5,11
34947,19,64,82,146,False,5,11
34948,20,55,74,129,False,5,11
34949,21,54,63,117,False,5,11
34950,22,55,73,128,False,5,11
34951,23,29,37,66,False,5,11
34952,0,29,28,57,True,6,11
34953,1,12,17,29,True,6,11
34954,2,26,42,68,True,6,11
34955,3,14,26,40,True,6,11
34956,4,16,15,31,True,6,11
34957,5,21,12,33,True,6,11
34958,6,17,14,31,True,6,11
34959,7,22,14,36,True,6,11
34960,8,37,26,63,True,6,11
34961,9,94,46,140,True,6,11
34962,10,115,85,200,True,6,11
34963,11,152,133,285,True,6,11
34964,12,166,153,319,True,6,11
34965,13,187,148,335,True,6,11
34966,14,193,151,344,True,6,11
34967,15,146,158,304,True,6,11
34968,16,112,137,249,True,6,11
34969,17,123,138,261,True,6,11
34970,18,109,113,222,True,6,11
34971,19,102,107,209,True,6,11
34972,20,79,81,160,True,6,11
34973,21,68,76,144,True,6,11
34974,22,28,41,69,True,6,11
34975,23,19,67,86,True,6,11
34976,0,14,11,25,True,0,11
34977,1,6,12,18,True,0,11
34978,2,12,10,22,True,0,11
34979,3,8,8,16,True,0,11
34980,4,12,9,21,True,0,11
34981,5,47,29,76,True,0,11
34982,6,106,65,171,True,0,11
34983,7,135,85,220,True,0,11
34984,8,146,96,242,True,0,11
34985,9,159,133,292,True,0,11
34986,10,215,138,353,True,0,11
34987,11,205,164,369,True,0,11
34988,12,205,194,399,True,0,11
34989,13,222,240,462,True,0,11
34990,14,205,216,421,True,0,11
34991,15,165,191,356,True,0,11
34992,16,126,151,277,True,0,11
34993,17,130,120,250,True,0,11
34994,18,95,120,215,True,0,11
34995,19,85,74,159,True,0,11
34996,20,58,62,120,True,0,11
34997,21,52,51,103,True,0,11
34998,22,30,32,62,True,0,11
34999,23,11,9,20,True,0,11
35000,0,10,14,24,True,1,11
35001,1,5,8,13,True,1,11
35002,2,8,3,11,True,1,11
35003,3,5,5,10,True,1,11
35004,4,6,2,8,True,1,11
35005,5,32,9,41,True,1,11
35006,6,45,35,80,True,1,11
35007,7,43,28,71,True,1,11
35008,8,46,48,94,True,1,11
35009,9,80,68,148,True,1,11
35010,10,115,106,221,True,1,11
35011,11,138,126,264,True,1,11
35012,12,120,120,240,True,1,11
35013,13,132,125,257,True,1,11
35014,14,139,121,260,True,1,11
35015,15,116,131,247,True,1,11
35016,16,77,76,153,True,1,11
35017,17,46,35,81,True,1,11
35018,18,28,30,58,True,1,11
35019,19,45,30,75,True,1,11
35020,20,52,50,102,True,1,11
35021,21,81,89,170,True,1,11
35022,22,70,55,125,True,1,11
35023,23,55,60,115,True,1,11
35024,0,20,18,38,True,2,11
35025,1,6,9,15,True,2,11
35026,2,8,7,15,True,2,11
35027,3,3,8,11,True,2,11
35028,4,5,5,10,True,2,11
35029,5,11,9,20,True,2,11
35030,6,16,12,28,True,2,11
35031,7,12,7,19,True,2,11
35032,8,20,11,31,True,2,11
35033,9,25,28,53,True,2,11
35034,10,42,30,72,True,2,11
35035,11,72,62,134,True,2,11
35036,12,71,91,162,True,2,11
35037,13,116,113,229,True,2,11
35038,14,96,113,209,True,2,11
35039,15,84,103,187,True,2,11
35040,16,78,71,149,True,2,11
35041,17,76,63,139,True,2,11
35042,18,69,72,141,True,2,11
35043,19,84,71,155,True,2,11
35044,20,57,91,148,True,2,11
35045,21,48,56,104,True,2,11
35046,22,27,36,63,True,2,11
35047,23,22,24,46,True,2,11
35048,0,9,22,31,True,3,11
35049,1,13,12,25,True,3,11
35050,2,14,21,35,True,3,11
35051,3,7,6,13,True,3,11
35052,4,10,4,14,True,3,11
35053,5,6,11,17,True,3,11
35054,6,16,14,30,True,3,11
35055,7,17,19,36,True,3,11
35056,8,20,15,35,True,3,11
35057,9,36,29,65,True,3,11
35058,10,58,39,97,True,3,11
35059,11,83,71,154,True,3,11
35060,12,120,106,226,True,3,11
35061,13,104,110,214,True,3,11
35062,14,111,106,217,True,3,11
35063,15,83,110,193,True,3,11
35064,16,97,107,204,True,3,11
35065,17,91,97,188,True,3,11
35066,18,95,72,167,True,3,11
35067,19,100,119,219,True,3,11
35068,20,65,82,147,True,3,11
35069,21,42,67,109,True,3,11
35070,22,33,61,94,True,3,11
35071,23,19,30,49,True,3,11
35072,0,20,19,39,True,4,11
35073,1,19,25,44,True,4,11
35074,2,17,25,42,True,4,11
35075,3,14,19,33,True,4,11
35076,4,10,19,29,True,4,11
35077,5,35,23,58,True,4,11
35078,6,55,43,98,True,4,11
35079,7,81,47,128,True,4,11
35080,8,89,71,160,True,4,11
35081,9,110,75,185,True,4,11
35082,10,154,104,258,True,4,11
35083,11,167,117,284,True,4,11
35084,12,149,143,292,True,4,11
35085,13,157,166,323,True,4,11
35086,14,153,188,341,True,4,11
35087,15,117,159,276,True,4,11
35088,16,109,119,228,True,4,11
35089,17,88,92,180,True,4,11
35090,18,74,86,160,True,4,11
35091,19,87,74,161,True,4,11
35092,20,68,57,125,True,4,11
35093,21,43,65,108,True,4,11
35094,22,34,51,85,True,4,11
35095,23,26,34,60,True,4,11
35096,0,15,19,34,True,5,11
35097,1,15,13,28,True,5,11
35098,2,13,30,43,True,5,11
35099,3,7,7,14,True,5,11
35100,4,9,3,12,True,5,11
35101,5,20,7,27,True,5,11
35102,6,19,15,34,True,5,11
35103,7,23,15,38,True,5,11
35104,8,33,24,57,True,5,11
35105,9,57,31,88,True,5,11
35106,10,85,51,136,True,5,11
35107,11,95,81,176,True,5,11
35108,12,124,111,235,True,5,11
35109,13,112,125,237,True,5,11
35110,14,107,123,230,True,5,11
35111,15,105,133,238,True,5,11
35112,16,99,101,200,True,5,11
35113,17,111,95,206,True,5,11
35114,18,68,99,167,True,5,11
35115,19,59,65,124,True,5,11
35116,20,42,53,95,True,5,11
35117,21,37,63,100,True,5,11
35118,22,28,38,66,True,5,11
35119,23,46,49,95,True,5,11
35120,0,24,29,53,True,6,11
35121,1,22,27,49,True,6,11
35122,2,16,25,41,True,6,11
35123,3,18,25,43,True,6,11
35124,4,6,8,14,True,6,11
35125,5,21,11,32,True,6,11
35126,6,16,7,23,True,6,11
35127,7,12,14,26,True,6,11
35128,8,21,17,38,True,6,11
35129,9,46,34,80,True,6,11
35130,10,67,41,108,True,6,11
35131,11,110,69,179,True,6,11
35132,12,116,106,222,True,6,11
35133,13,123,140,263,True,6,11
35134,14,123,127,250,True,6,11
35135,15,102,140,242,True,6,11
35136,16,107,132,239,True,6,11
35137,17,95,93,188,True,6,11
35138,18,90,113,203,True,6,11
35139,19,98,93,191,True,6,11
35140,20,60,77,137,True,6,11
35141,21,47,61,108,True,6,11
35142,22,23,43,66,True,6,11
35143,23,29,26,55,True,6,11
35144,0,18,20,38,False,0,11
35145,1,7,7,14,False,0,11
35146,2,7,11,18,False,0,11
35147,3,7,9,16,False,0,11
35148,4,9,5,14,False,0,11
35149,5,35,20,55,False,0,11
35150,6,79,46,125,False,0,11
35151,7,105,57,162,False,0,11
35152,8,99,64,163,False,0,11
35153,9,135,94,229,False,0,11
35154,10,156,111,267,False,0,11
35155,11,174,155,329,False,0,11
35156,12,189,171,360,False,0,11
35157,13,194,209,403,False,0,11
35158,14,159,188,347,False,0,11
35159,15,112,143,255,False,0,11
35160,16,115,157,272,False,0,11
35161,17,104,114,218,False,0,11
35162,18,98,88,186,False,0,11
35163,19,85,85,170,False,0,11
35164,20,61,69,130,False,0,11
35165,21,37,41,78,False,0,11
35166,22,29,43,72,False,0,11
35167,23,22,24,46,False,0,11
35168,0,16,17,33,False,1,11
35169,1,12,11,23,False,1,11
35170,2,7,8,15,False,1,11
35171,3,4,6,10,False,1,11
35172,4,6,4,10,False,1,11
35173,5,33,11,44,False,1,11
35174,6,50,31,81,False,1,11
35175,7,44,31,75,False,1,11
35176,8,55,46,101,False,1,11
35177,9,63,53,116,False,1,11
35178,10,86,91,177,False,1,11
35179,11,118,101,219,False,1,11
35180,12,102,111,213,False,1,11
35181,13,92,132,224,False,1,11
35182,14,99,113,212,False,1,11
35183,15,105,96,201,False,1,11
35184,16,100,95,195,False,1,11
35185,17,107,95,202,False,1,11
35186,18,79,93,172,False,1,11
35187,19,77,72,149,False,1,11
35188,20,58,61,119,False,1,11
35189,21,52,51,103,False,1,11
35190,22,51,39,90,False,1,11
35191,23,34,81,115,False,1,11
